FIPS,State,Housing,ChildCare,Food,Transportation,Medical,Other,Taxes,MIDS ChildCare,MIDS Food,MIDS Medical,MIDS Transportation,MIDS Net,MIDS Taxes All,3x EITC Tax,Basic Income Tax,Mids Taxes Universal,MIT LWC,MIDS LWC,3x EITC,Basic Income,MIDS LWC 2
1001,AL,11712,14676,8887,11553,5471,5178,8921,13449,9747.210433,9232,11217,60535,8757,-14795,10677,8757,66398,69292,45740,71212,69292
1003,AL,14628,14676,8887,11553,5471,5178,9373,14742,10065.74672,9232,11289,65135,9863,-12842,12311,9863,69766,74998,52293,77446,74998
1005,AL,8712,14676,8887,11553,5471,5178,8455,14676,9619.795917,9232,11553,58971,8204,-15771,9860,8204,62932,67175,43200,68831,67175
1007,AL,11712,14676,8887,11553,5471,5178,8921,14245,9651.649546,9232,11278,61297,8757,-14795,10677,8757,66398,70054,46502,71974,70054
1009,AL,11712,14676,8887,11553,5471,5178,8921,13001,9046.430598,9232,11280,59449,8204,-15771,9860,8204,66398,67653,43678,69309,67653
1011,AL,8976,14676,8887,11553,5471,5178,8496,14676,9269.406,9232,11553,58884,8204,-15771,9860,8204,63237,67088,43113,68744,67088
1013,AL,9864,14676,8887,11553,5471,5178,8634,14676,9301.259629,9232,11553,59804,8204,-15771,9860,8204,64263,68008,44033,69664,68008
1015,AL,10524,14676,8887,11553,5471,5178,8736,14472,9619.795917,9232,10463,59488,8204,-15771,9860,8204,65025,67692,43717,69348,67692
1017,AL,9204,14676,8887,11553,5471,5178,8531,13686,8823.455196,9232,9983,56106,7651,-16747,9043,7651,63500,63757,39359,65149,63757
1019,AL,10008,14676,8887,11553,5471,5178,8656,14676,9269.406,9232,11553,59916,8204,-15771,9860,8204,64429,68120,44145,69776,68120
1021,AL,9096,14676,8887,11553,5471,5178,8515,14427,8887.162454,9232,11277,58097,8204,-15771,9860,8204,63376,66301,42326,67957,66301
1023,AL,10344,14676,8887,11553,5471,5178,8708,14676,9110.137856,9232,11553,60093,8757,-14795,10677,8757,64817,68850,45298,70770,68850
1025,AL,9480,14676,8887,11553,5471,5178,8574,14676,9333.113258,9232,11553,59452,8204,-15771,9860,8204,63819,67656,43681,69312,67656
1027,AL,9108,14676,8887,11553,5471,5178,8516,14676,9460.527773,9232,11553,59208,8204,-15771,9860,8204,63389,67412,43437,69068,67412
1029,AL,8928,14676,8887,11553,5471,5178,8488,14676,9205.698742,9232,11553,58773,8204,-15771,9860,8204,63181,66977,43002,68633,66977
1031,AL,9732,14676,8887,11553,5471,5178,8613,14358,9428.674144,9232,11162,59091,8204,-15771,9860,8204,64110,67295,43320,68951,67295
1033,AL,10188,14676,8887,11553,5471,5178,8684,14445,9078.284227,9232,10704,58825,8204,-15771,9860,8204,64637,67029,43054,68685,67029
1035,AL,10008,14676,8887,11553,5471,5178,8656,14676,9428.674144,9232,11553,60076,8757,-14795,10677,8757,64429,68833,45281,70753,68833
1037,AL,8460,14676,8887,11553,5471,5178,8416,13353,9524.235031,9232,10180,55926,7098,-17628,8226,7098,62641,63024,38298,64152,63024
1039,AL,9816,14676,8887,11553,5471,5178,8626,14676,9587.942289,9232,11553,60043,8757,-14795,10677,8757,64207,68800,45248,70720,68800
1041,AL,9732,14676,8887,11553,5471,5178,8613,14676,9078.284227,9232,11553,59449,8204,-15771,9860,8204,64110,67653,43678,69309,67653
1043,AL,8724,14676,8887,11553,5471,5178,8457,13683,8504.918907,9232,10455,55777,7098,-17628,8226,7098,62946,62875,38149,64003,62875
1045,AL,9900,14676,8887,11553,5471,5178,8639,15055,8664.187051,9232,11078,59107,8204,-15771,9860,8204,64304,67311,43336,68967,67311
1047,AL,8688,14676,8887,11553,5471,5178,8451,13648,9269.406,9232,9619,55635,7098,-17628,8226,7098,62904,62733,38007,63861,62733
1049,AL,8832,14676,8887,11553,5471,5178,8474,14676,9269.406,9232,11553,58740,8204,-15771,9860,8204,63071,66944,42969,68600,66944
1051,AL,11712,14676,8887,11553,5471,5178,8921,13907,9683.503175,9232,11224,60937,8757,-14795,10677,8757,66398,69694,46142,71614,69694
1053,AL,8460,14676,8887,11553,5471,5178,8416,14676,9396.820515,9232,11553,58496,8204,-15771,9860,8204,62641,66700,42725,68356,66700
1055,AL,8904,14676,8887,11553,5471,5178,8485,13684,8600.479794,9232,10357,55956,7098,-17628,8226,7098,63154,63054,38328,64182,63054
1057,AL,8916,14676,8887,11553,5471,5178,8487,14676,9364.966886,9232,11553,58920,8204,-15771,9860,8204,63168,67124,43149,68780,67124
1059,AL,8568,14676,8887,11553,5471,5178,8433,14676,8664.187051,9232,11553,57871,7651,-16747,9043,7651,62766,65522,41124,66914,65522
1061,AL,9060,14676,8887,11553,5471,5178,8509,14980,9301.259629,9232,10936,58688,8204,-15771,9860,8204,63334,66892,42917,68548,66892
1063,AL,12276,14676,8887,11553,5471,5178,9008,14676,9619.795917,9232,11553,62535,9310,-13819,11494,9310,67049,71845,48716,74029,71845
1065,AL,12276,14676,8887,11553,5471,5178,9008,13313,9619.795917,9232,11254,60873,8757,-14795,10677,8757,67049,69630,46078,71550,69630
1067,AL,10008,14676,8887,11553,5471,5178,8656,13807,9364.966886,9232,10948,58537,8204,-15771,9860,8204,64429,66741,42766,68397,66741
1069,AL,9060,14676,8887,11553,5471,5178,8509,16433,9460.527773,9232,10887,60251,8757,-14795,10677,8757,63334,69008,45456,70928,69008
1071,AL,8460,14676,8887,11553,5471,5178,8416,13652,9205.698742,9232,10390,56117,7651,-16747,9043,7651,62641,63768,39370,65160,63768
1073,AL,11712,14676,8887,11553,5471,5178,8921,14654,8600.479794,9232,11263,60639,8757,-14795,10677,8757,66398,69396,45844,71316,69396
1075,AL,8460,14676,8887,11553,5471,5178,8416,14676,9110.137856,9232,11553,58209,8204,-15771,9860,8204,62641,66413,42438,68069,66413
1077,AL,10188,14676,8887,11553,5471,5178,8684,14509,8441.211649,9232,10704,58252,8204,-15771,9860,8204,64637,66456,42481,68112,66456
1079,AL,9900,14676,8887,11553,5471,5178,8639,13289,9046.430598,9232,11070,57716,7651,-16747,9043,7651,64304,65367,40969,66759,65367
1081,AL,11964,14676,8887,11553,5471,5178,8960,14171,9810.917691,9232,11084,61439,8757,-14795,10677,8757,66689,70196,46644,72116,70196
1083,AL,11376,14676,8887,11553,5471,5178,8868,14339,9428.674144,9232,11537,61090,8757,-14795,10677,8757,66009,69847,46295,71767,69847
1085,AL,11712,14676,8887,11553,5471,5178,8921,13922,9269.406,9232,11240,60553,8757,-14795,10677,8757,66398,69310,45758,71230,69310
1087,AL,8460,14676,8887,11553,5471,5178,8416,14676,10320.57575,9232,11553,59420,8204,-15771,9860,8204,62641,67624,43649,69280,67624
1089,AL,11376,14676,8887,11553,5471,5178,8868,13284,8632.333423,9232,11530,59232,8204,-15771,9860,8204,66009,67436,43461,69092,67436
1091,AL,9036,14676,8887,11553,5471,5178,8505,14676,9587.942289,9232,11553,59263,8204,-15771,9860,8204,63306,67467,43492,69123,67467
1093,AL,9852,14676,8887,11553,5471,5178,8632,14676,9046.430598,9232,11553,59537,8204,-15771,9860,8204,64249,67741,43766,69397,67741
1095,AL,9396,14676,8887,11553,5471,5178,8561,15270,8982.72334,9232,10639,58698,8204,-15771,9860,8204,63722,66902,42927,68558,66902
1097,AL,12384,14676,8887,11553,5471,5178,9025,14616,9492.381402,9232,11054,61956,8757,-14795,10677,8757,67174,70713,47161,72633,70713
1099,AL,10008,14676,8887,11553,5471,5178,8656,14676,9364.966886,9232,11553,60012,8757,-14795,10677,8757,64429,68769,45217,70689,68769
1101,AL,11712,14676,8887,11553,5471,5178,8921,15006,8919.016082,9232,11207,61254,8757,-14795,10677,8757,66398,70011,46459,71931,70011
1103,AL,9900,14676,8887,11553,5471,5178,8639,15996,8568.626165,9232,11030,59904,8204,-15771,9860,8204,64304,68108,44133,69764,68108
1105,AL,9912,14676,8887,11553,5471,5178,8641,14676,9333.113258,9232,11553,59884,8204,-15771,9860,8204,64318,68088,44113,69744,68088
1107,AL,8460,14676,8887,11553,5471,5178,8416,14663,9524.235031,9232,11262,58319,8204,-15771,9860,8204,62641,66523,42548,68179,66523
1109,AL,9972,14676,8887,11553,5471,5178,8651,15509,9619.795917,9232,10156,59667,8204,-15771,9860,8204,64388,67871,43896,69527,67871
1111,AL,9144,14676,8887,11553,5471,5178,8522,14676,8887.162454,9232,11553,58670,8204,-15771,9860,8204,63431,66874,42899,68530,66874
1113,AL,11652,14676,8887,11553,5471,5178,8911,14011,9556.08866,9232,11051,60680,8757,-14795,10677,8757,66328,69437,45885,71357,69437
1115,AL,11712,14676,8887,11553,5471,5178,8921,20189,9556.08866,9232,11271,67139,10416,-11866,13128,10416,66398,77555,55273,80267,77555
1117,AL,11712,14676,8887,11553,5471,5178,8921,18153,9524.235031,9232,11272,65071,9863,-12842,12311,9863,66398,74934,52229,77382,74934
1119,AL,8460,14676,8887,11553,5471,5178,8416,14676,9046.430598,9232,11553,58145,8204,-15771,9860,8204,62641,66349,42374,68005,66349
1121,AL,9276,14676,8887,11553,5471,5178,8543,20802,9205.698742,9232,10111,63804,9310,-13819,11494,9310,63584,73114,49985,75298,73114
1123,AL,9372,14676,8887,11553,5471,5178,8557,14676,9428.674144,9232,11553,59440,8204,-15771,9860,8204,63694,67644,43669,69300,67644
1125,AL,12276,14676,8887,11553,5471,5178,9008,18576,9842.771319,9232,11266,66371,10416,-11866,13128,10416,67049,76787,54505,79499,76787
1127,AL,9384,14676,8887,11553,5471,5178,8559,15275,9110.137856,9232,11273,59452,8204,-15771,9860,8204,63708,67656,43681,69312,67656
1129,AL,10008,14676,8887,11553,5471,5178,8656,14676,9364.966886,9232,11553,60012,8757,-14795,10677,8757,64429,68769,45217,70689,68769
1131,AL,8460,14676,8887,11553,5471,5178,8416,14676,9587.942289,9232,11553,58687,8204,-15771,9860,8204,62641,66891,42916,68547,66891
1133,AL,9300,14676,8887,11553,5471,5178,8546,14676,9173.845113,9232,11553,59113,8204,-15771,9860,8204,63611,67317,43342,68973,67317
2013,AK,10656,18614,10607,9970,6461,5250,7092,18614,15131.40921,21553,9970,81174,11495,-7063,15316,11506,68650,92669,74111,96490,92680
2016,AK,21456,18614,10607,9970,6461,5250,8336,18614,19845.71761,21553,9970,96689,17919,5146,21452,17930,80694,114608,101835,118141,114619
2020,AK,20268,18614,10607,9970,6461,5250,8199,20440,12051.90131,21553,11171,90733,15510,567,19151,15521,79369,106243,91300,109884,106254
2050,AK,17700,18614,10607,9970,6461,5250,7903,18614,12622.18055,21553,9970,85709,13101,-4011,16850,13112,76505,98810,81698,102559,98821
2060,AK,16296,18614,10607,9970,6461,5250,7741,18614,12546.14332,21553,9970,84229,13101,-4011,16850,13112,74939,97330,80218,101079,97341
2068,AK,11268,18614,10607,9970,6461,5250,7162,18614,12470.10608,21553,9970,79125,10692,-8590,14549,10703,69332,89817,70535,93674,89828
2070,AK,15420,18614,10607,9970,6461,5250,7640,18614,12660.19916,21553,9970,83467,12298,-5537,16083,12309,73962,95765,77930,99550,95776
2090,AK,23448,18614,10607,9970,6461,5250,8565,23491,13192.45979,21553,10749,97683,17919,5146,21452,17930,82915,115602,102829,119135,115613
2100,AK,14460,18614,10607,9970,6461,5250,7530,18614,12089.91992,21553,9970,81937,11495,-7063,15316,11506,72892,93432,74874,97253,93443
2105,AK,10896,18614,10607,9970,6461,5250,7119,18614,11481.62207,21553,9970,77765,9889,-10116,13782,9900,68917,87654,67649,91547,87665
2110,AK,19128,18614,10607,9970,6461,5250,8068,20741,11367.56622,21553,11060,89100,14707,-959,18384,14718,78098,103807,88141,107484,103818
2122,AK,12420,18614,10607,9970,6461,5250,7295,18614,15473.57676,21553,9970,83281,12298,-5537,16083,12309,70617,95579,77744,99364,95590
2130,AK,17064,18614,10607,9970,6461,5250,7830,16845,11063.41729,21553,10473,82249,12298,-5537,16083,12309,75796,94547,76712,98332,94558
2150,AK,18084,18614,10607,9970,6461,5250,7947,18614,12584.16193,21553,9970,86055,13904,-2485,17617,13915,76933,99959,83570,103672,99970
2164,AK,11448,18614,10607,9970,6461,5250,7183,18614,12546.14332,21553,9970,79381,10692,-8590,14549,10703,69533,90073,70791,93930,90084
2170,AK,19116,18614,10607,9970,6461,5250,8066,16593,14218.96243,21553,10872,87602,13904,-2485,17617,13915,78084,101506,85117,105219,101517
2180,AK,20328,18614,10607,9970,6461,5250,8206,18614,15131.40921,21553,9970,90846,15510,567,19151,15521,79436,106356,91413,109997,106367
2185,AK,13992,18614,10607,9970,6461,5250,7476,18614,13344.53425,21553,9970,82724,12298,-5537,16083,12309,72370,95022,77187,98807,95033
2188,AK,17052,18614,10607,9970,6461,5250,7828,18614,14142.92519,21553,9970,86582,13904,-2485,17617,13915,75782,100486,84097,104199,100497
2195,AK,12372,18614,10607,9970,6461,5250,7289,18614,11481.62207,21553,9970,79241,10692,-8590,14549,10703,70563,89933,70651,93790,89944
2198,AK,10836,18614,10607,9970,6461,5250,7112,18614,11481.62207,21553,9970,77705,9889,-10116,13782,9900,68850,87594,67589,91487,87605
2220,AK,18960,18614,10607,9970,6461,5250,8048,18614,12051.90131,21553,9970,86399,13904,-2485,17617,13915,77910,100303,83914,104016,100314
2230,AK,16728,18614,10607,9970,6461,5250,7791,18614,11823.78961,21553,9970,83939,12298,-5537,16083,12309,75421,96237,78402,100022,96248
2240,AK,13836,18614,10607,9970,6461,5250,7458,18614,12508.1247,21553,9970,81731,11495,-7063,15316,11506,72196,93226,74668,97047,93237
2261,AK,14496,18614,10607,9970,6461,5250,7534,18614,12508.1247,21553,9970,82391,12298,-5537,16083,12309,72932,94689,76854,98474,94700
2270,AK,10848,18614,10607,9970,6461,5250,7114,18614,15131.40921,21553,9970,81366,11495,-7063,15316,11506,68864,92861,74303,96682,92872
2275,AK,14220,18614,10607,9970,6461,5250,7502,18614,12280.013,21553,9970,81887,11495,-7063,15316,11506,72624,93382,74824,97203,93393
2282,AK,12648,18614,10607,9970,6461,5250,7321,18614,12736.2364,21553,9970,80771,11495,-7063,15316,11506,70871,92266,73708,96087,92277
2290,AK,10608,18614,10607,9970,6461,5250,7086,18614,12660.19916,21553,9970,78655,10692,-8590,14549,10703,68596,89347,70065,93204,89358
4001,AZ,9564,6494,10607,9970,6477,5250,8776,6494,10987.38006,6913,9970,49178,4681,-20045,5149,4681,57138,53859,29133,54327,53859
4003,AZ,14352,6494,10607,9970,6477,5250,9465,6141,10531.15666,6913,9312,52499,5462,-19264,6326,5462,62615,57961,33235,58825,57961
4005,AZ,15552,6494,10607,9970,6477,5250,9638,5645,11215.49175,6913,10086,54661,5982,-18744,7110,5982,63988,60643,35917,61771,60643
4007,AZ,12528,6494,10607,9970,6477,5250,9203,5610,11177.47314,6913,8805,50284,4942,-19784,5542,4942,60529,55226,30500,55826,55226
4009,AZ,11424,6494,10607,9970,6477,5250,9044,6482,10835.30559,6913,9629,50533,4942,-19784,5542,4942,59266,55475,30749,56075,55475
4011,AZ,9516,6494,10607,9970,6477,5250,8769,6494,10607.19389,6913,9970,48750,4422,-20304,4758,4422,57083,53172,28446,53508,53172
4012,AZ,9912,6494,10607,9970,6477,5250,8826,6494,11025.39867,6913,9970,49564,4681,-20045,5149,4681,57536,54245,29519,54713,54245
4013,AZ,16920,6494,10607,9970,6477,5250,9835,8484,10835.30559,6913,9998,58400,7023,-16952,8679,7023,65553,65423,41448,67079,65423
4015,AZ,12180,6494,10607,9970,6477,5250,9152,6193,10911.34282,6913,8614,50061,4942,-19784,5542,4942,60130,55003,30277,55603,55003
4017,AZ,11184,6494,10607,9970,6477,5250,9009,7538,10797.28698,6913,9016,50698,4942,-19784,5542,4942,58991,55640,30914,56240,55640
4019,AZ,15012,6494,10607,9970,6477,5250,9560,6632,10797.28698,6913,9474,54078,5982,-18744,7110,5982,63370,60060,35334,61188,60060
4021,AZ,16920,6494,10607,9970,6477,5250,9835,6660,10417.10081,6913,9994,56154,6502,-17896,7894,6502,65553,62656,38258,64048,62656
4023,AZ,10068,6494,10607,9970,6477,5250,8848,8702,9276.542331,6913,9394,49604,4681,-20045,5149,4681,57714,54285,29559,54753,54285
4025,AZ,13860,6494,10607,9970,6477,5250,9394,7272,11101.4359,6913,9005,53401,5462,-19264,6326,5462,62052,58863,34137,59727,58863
4027,AZ,14364,6494,10607,9970,6477,5250,9467,5749,9428.616796,6913,9334,51039,4942,-19784,5542,4942,62629,55981,31255,56581,55981
5001,AR,8700,10687,8887,11553,5635,5178,7939,10687,8982.72334,9880,11553,54981,7480,-17246,8608,7480,58579,62461,37735,63589,62461
5003,AR,9120,10687,8887,11553,5635,5178,7998,10687,8855.308825,9880,11553,55273,7480,-17246,8608,7480,59058,62753,38027,63881,62753
5005,AR,10488,10687,8887,11553,5635,5178,8189,12910,9014.576969,9880,9736,57207,8073,-16325,9465,8073,60617,65280,40882,66672,65280
5007,AR,12108,10687,8887,11553,5635,5178,8416,14278,8632.333423,9880,11437,61513,9259,-14293,11179,9259,62464,70772,47220,72692,70772
5009,AR,9408,10687,8887,11553,5635,5178,8038,12018,7549.310041,9880,10211,54244,7480,-17246,8608,7480,59386,61724,36998,62852,61724
5011,AR,9768,10687,8887,11553,5635,5178,8088,10687,8950.869711,9880,11553,56017,8073,-16325,9465,8073,59796,64090,39692,65482,64090
5013,AR,8388,10687,8887,11553,5635,5178,7895,11865,8887.162454,9880,10083,54281,7480,-17246,8608,7480,58223,61761,37035,62889,61761
5015,AR,9936,10687,8887,11553,5635,5178,8112,10687,8313.797134,9880,11553,55548,7480,-17246,8608,7480,59988,63028,38302,64156,63028
5017,AR,9924,10687,8887,11553,5635,5178,8110,10687,8982.72334,9880,11553,56205,8073,-16325,9465,8073,59974,64278,39880,65670,64278
5019,AR,9024,10687,8887,11553,5635,5178,7984,13962,8887.162454,9880,10070,57000,8073,-16325,9465,8073,58948,65073,40675,66465,65073
5021,AR,8736,10687,8887,11553,5635,5178,7944,10687,7772.285443,9880,11553,53806,6887,-17839,7751,6887,58620,60693,35967,61557,60693
5023,AR,9192,10687,8887,11553,5635,5178,8008,10687,9014.576969,9880,11553,55505,7480,-17246,8608,7480,59140,62985,38259,64113,62985
5025,AR,9780,10687,8887,11553,5635,5178,8090,12470,8919.016082,9880,10264,56491,8073,-16325,9465,8073,59810,64564,40166,65956,64564
5027,AR,9480,10687,8887,11553,5635,5178,8048,11493,9269.406,9880,10158,55458,7480,-17246,8608,7480,59468,62938,38212,64066,62938
5029,AR,9264,10687,8887,11553,5635,5178,8018,10687,8218.236247,9880,11553,54780,7480,-17246,8608,7480,59222,62260,37534,63388,62260
5031,AR,10356,10687,8887,11553,5635,5178,8171,13781,8696.04068,9880,10489,58379,8666,-15309,10322,8666,60467,67045,43070,68701,67045
5033,AR,9588,10687,8887,11553,5635,5178,8063,12216,8600.479794,9880,10581,56044,8073,-16325,9465,8073,59591,64117,39719,65509,64117
5035,AR,12792,10687,8887,11553,5635,5178,8512,11317,8982.72334,9880,11465,59615,8666,-15309,10322,8666,63244,68281,44306,69937,68281
5037,AR,9852,10687,8887,11553,5635,5178,8100,10687,8823.455196,9880,11553,55973,7480,-17246,8608,7480,59892,63453,38727,64581,63453
5039,AR,9924,10687,8887,11553,5635,5178,8110,10687,8919.016082,9880,11553,56141,8073,-16325,9465,8073,59974,64214,39816,65606,64214
5041,AR,9240,10687,8887,11553,5635,5178,8014,10687,8855.308825,9880,11553,55393,7480,-17246,8608,7480,59194,62873,38147,64001,62873
5043,AR,9684,10687,8887,11553,5635,5178,8077,10687,9078.284227,9880,11553,56060,8073,-16325,9465,8073,59701,64133,39735,65525,64133
5045,AR,12396,10687,8887,11553,5635,5178,8457,13408,9173.845113,9880,11414,61450,9259,-14293,11179,9259,62793,70709,47157,72629,70709
5047,AR,8676,10687,8887,11553,5635,5178,7935,10687,8218.236247,9880,11553,54192,7480,-17246,8608,7480,58551,61672,36946,62800,61672
5049,AR,8388,10687,8887,11553,5635,5178,7895,10687,8281.943505,9880,11553,53968,6887,-17839,7751,6887,58223,60855,36129,61719,60855
5051,AR,12564,10687,8887,11553,5635,5178,8480,13391,8664.187051,9880,10170,59847,8666,-15309,10322,8666,62984,68513,44538,70169,68513
5053,AR,9924,10687,8887,11553,5635,5178,8110,10289,8982.72334,9880,11427,55681,7480,-17246,8608,7480,59974,63161,38435,64289,63161
5055,AR,10260,10687,8887,11553,5635,5178,8157,11544,8919.016082,9880,10425,56206,8073,-16325,9465,8073,60357,64279,39881,65671,64279
5057,AR,8388,10687,8887,11553,5635,5178,7895,10687,8281.943505,9880,11553,53968,6887,-17839,7751,6887,58223,60855,36129,61719,60855
5059,AR,8976,10687,8887,11553,5635,5178,7977,9673,8727.894309,9880,10927,53362,6887,-17839,7751,6887,58893,60249,35523,61113,60249
5061,AR,8844,10687,8887,11553,5635,5178,7959,10687,8504.918907,9880,11553,54647,7480,-17246,8608,7480,58743,62127,37401,63255,62127
5063,AR,8652,10687,8887,11553,5635,5178,7932,10419,8568.626165,9880,10305,53003,6887,-17839,7751,6887,58524,59890,35164,60754,59890
5065,AR,8388,10687,8887,11553,5635,5178,7895,10687,8568.626165,9880,11553,54255,7480,-17246,8608,7480,58223,61735,37009,62863,61735
5067,AR,9924,10687,8887,11553,5635,5178,8110,10687,8791.601567,9880,11553,56014,8073,-16325,9465,8073,59974,64087,39689,65479,64087
5069,AR,9780,10687,8887,11553,5635,5178,8090,11357,8855.308825,9880,10132,55182,7480,-17246,8608,7480,59810,62662,37936,63790,62662
5071,AR,8664,10687,8887,11553,5635,5178,7934,10687,8504.918907,9880,11553,54467,7480,-17246,8608,7480,58538,61947,37221,63075,61947
5073,AR,9924,10687,8887,11553,5635,5178,8110,10687,8982.72334,9880,11553,56205,8073,-16325,9465,8073,59974,64278,39880,65670,64278
5075,AR,8952,10687,8887,11553,5635,5178,7974,10687,8632.333423,9880,11553,54882,7480,-17246,8608,7480,58866,62362,37636,63490,62362
5077,AR,8628,10687,8887,11553,5635,5178,7929,10687,8759.747938,9880,11553,54686,7480,-17246,8608,7480,58497,62166,37440,63294,62166
5079,AR,9780,10687,8887,11553,5635,5178,8090,10566,8855.308825,9880,10226,54486,7480,-17246,8608,7480,59810,61966,37240,63094,61966
5081,AR,9252,10687,8887,11553,5635,5178,8016,10334,8441.211649,9880,10996,54082,7480,-17246,8608,7480,59208,61562,36836,62690,61562
5083,AR,8388,10687,8887,11553,5635,5178,7895,10687,7804.139072,9880,11553,53490,6887,-17839,7751,6887,58223,60377,35651,61241,60377
5085,AR,12396,10687,8887,11553,5635,5178,8457,10747,9078.284227,9880,11424,58703,8666,-15309,10322,8666,62793,67369,43394,69025,67369
5087,AR,12108,10687,8887,11553,5635,5178,8416,9933,8568.626165,9880,11436,57104,8073,-16325,9465,8073,62464,65177,40779,66569,65177
5089,AR,8388,10687,8887,11553,5635,5178,7895,10687,8441.211649,9880,11553,54127,7480,-17246,8608,7480,58223,61607,36881,62735,61607
5091,AR,10524,10687,8887,11553,5635,5178,8194,10984,9014.576969,9880,10994,56575,8073,-16325,9465,8073,60658,64648,40250,66040,64648
5093,AR,8964,10687,8887,11553,5635,5178,7976,11990,8727.894309,9880,10388,55127,7480,-17246,8608,7480,58880,62607,37881,63735,62607
5095,AR,9144,10687,8887,11553,5635,5178,8001,10687,8600.479794,9880,11553,55042,7480,-17246,8608,7480,59085,62522,37796,63650,62522
5097,AR,8388,10687,8887,11553,5635,5178,7895,10687,8504.918907,9880,11553,54191,7480,-17246,8608,7480,58223,61671,36945,62799,61671
5099,AR,8688,10687,8887,11553,5635,5178,7937,10687,8632.333423,9880,11553,54618,7480,-17246,8608,7480,58565,62098,37372,63226,62098
5101,AR,8388,10687,8887,11553,5635,5178,7895,11589,8473.065278,9880,10294,53802,6887,-17839,7751,6887,58223,60689,35963,61553,60689
5103,AR,8664,10687,8887,11553,5635,5178,7934,11142,8982.72334,9880,10003,53850,6887,-17839,7751,6887,58538,60737,36011,61601,60737
5105,AR,12396,10687,8887,11553,5635,5178,8457,10306,9078.284227,9880,11430,58269,8666,-15309,10322,8666,62793,66935,42960,68591,66935
5107,AR,9924,10687,8887,11553,5635,5178,8110,10171,8823.455196,9880,9590,53566,6887,-17839,7751,6887,59974,60453,35727,61317,60453
5109,AR,8388,10687,8887,11553,5635,5178,7895,10687,8600.479794,9880,11553,54286,7480,-17246,8608,7480,58223,61766,37040,62894,61766
5111,AR,9864,10687,8887,11553,5635,5178,8102,10210,8504.918907,9880,10535,54172,7480,-17246,8608,7480,59906,61652,36926,62780,61652
5113,AR,9012,10687,8887,11553,5635,5178,7982,10687,8504.918907,9880,11553,54815,7480,-17246,8608,7480,58934,62295,37569,63423,62295
5115,AR,9648,10687,8887,11553,5635,5178,8072,10317,8919.016082,9880,10706,54649,7480,-17246,8608,7480,59660,62129,37403,63257,62129
5117,AR,9924,10687,8887,11553,5635,5178,8110,10687,8982.72334,9880,11553,56205,8073,-16325,9465,8073,59974,64278,39880,65670,64278
5119,AR,12396,10687,8887,11553,5635,5178,8457,11187,9046.430598,9880,11419,59107,8666,-15309,10322,8666,62793,67773,43798,69429,67773
5121,AR,8592,10687,8887,11553,5635,5178,7924,10687,8568.626165,9880,11553,54459,7480,-17246,8608,7480,58456,61939,37213,63067,61939
5123,AR,9372,10687,8887,11553,5635,5178,8033,9860,8855.308825,9880,9856,53001,6887,-17839,7751,6887,59345,59888,35162,60752,59888
5125,AR,12396,10687,8887,11553,5635,5178,8457,10871,9173.845113,9880,11420,58919,8666,-15309,10322,8666,62793,67585,43610,69241,67585
5127,AR,8400,10687,8887,11553,5635,5178,7897,10687,8345.650763,9880,11553,54044,7480,-17246,8608,7480,58237,61524,36798,62652,61524
5129,AR,8388,10687,8887,11553,5635,5178,7895,10687,8441.211649,9880,11553,54127,7480,-17246,8608,7480,58223,61607,36881,62735,61607
5131,AR,9588,10687,8887,11553,5635,5178,8063,9606,8122.675361,9880,10546,52921,6887,-17839,7751,6887,59591,59808,35082,60672,59808
5133,AR,8640,10687,8887,11553,5635,5178,7930,10687,8473.065278,9880,11553,54411,7480,-17246,8608,7480,58510,61891,37165,63019,61891
5135,AR,8856,10687,8887,11553,5635,5178,7961,10687,8377.504392,9880,11553,54532,7480,-17246,8608,7480,58757,62012,37286,63140,62012
5137,AR,8664,10687,8887,11553,5635,5178,7934,10687,8696.04068,9880,11553,54658,7480,-17246,8608,7480,58538,62138,37412,63266,62138
5139,AR,9264,10687,8887,11553,5635,5178,8018,11091,8919.016082,9880,10273,54605,7480,-17246,8608,7480,59222,62085,37359,63213,62085
5141,AR,8544,10687,8887,11553,5635,5178,7917,10687,9014.576969,9880,11553,54857,7480,-17246,8608,7480,58401,62337,37611,63465,62337
5143,AR,12108,10687,8887,11553,5635,5178,8416,9990,8536.772536,9880,11436,57128,8073,-16325,9465,8073,62464,65201,40803,66593,65201
5145,AR,10344,10687,8887,11553,5635,5178,8169,8837,9046.430598,9880,10950,54236,7480,-17246,8608,7480,60453,61716,36990,62844,61716
5147,AR,9924,10687,8887,11553,5635,5178,8110,10687,8823.455196,9880,11553,56045,8073,-16325,9465,8073,59974,64118,39720,65510,64118
5149,AR,9924,10687,8887,11553,5635,5178,8110,9125,8250.089876,9880,10737,53095,6887,-17839,7751,6887,59974,59982,35256,60846,59982
6001,CA,26448,19074,10607,9970,6215,5250,9588,21650,12926.32948,8005,11014,85293,17962,839,21700,17962,87152,103255,86132,106993,103255
6003,CA,13644,19074,10607,9970,6215,5250,7857,19074,12203.97577,8005,9970,68147,11320,-10539,14296,11320,72617,79467,57608,82443,79467
6005,CA,16692,19074,10607,9970,6215,5250,8269,19074,14066.88796,8005,9970,73058,12598,-8415,16102,12598,76077,85656,64643,89160,85656
6007,CA,14580,19074,10607,9970,6215,5250,7983,17636,11329.5476,8005,9323,66124,10681,-11601,13393,10681,73679,76805,54523,79517,76805
6009,CA,16404,19074,10607,9970,6215,5250,8230,19074,13686.7018,8005,9970,72390,12598,-8415,16102,12598,75750,84988,63975,88492,84988
6011,CA,14364,19074,10607,9970,6215,5250,7954,19074,15207.44644,8005,9970,71870,11959,-9477,15199,11959,73434,83829,62393,87069,83829
6013,CA,26448,19074,10607,9970,6215,5250,9588,21332,12584.16193,8005,10930,84549,17962,839,21700,17962,87152,102511,85388,106249,102511
6015,CA,15384,19074,10607,9970,6215,5250,8092,16953,12318.03162,8005,8763,66673,10681,-11601,13393,10681,74592,77354,55072,80066,77354
6017,CA,18960,19074,10607,9970,6215,5250,8576,19234,14523.11135,8005,10043,76015,14006,-6010,17888,14006,78652,90021,70005,93903,90021
6019,CA,13944,19074,10607,9970,6215,5250,7897,17241,10265.02635,8005,10086,64790,10042,-12663,12490,10042,72957,74832,52127,77280,74832
6021,CA,14268,19074,10607,9970,6215,5250,7941,19074,11101.4359,8005,9970,67668,10681,-11601,13393,10681,73325,78349,56067,81061,78349
6023,CA,17436,19074,10607,9970,6215,5250,8370,17345,11215.49175,8005,9392,68643,11320,-10539,14296,11320,76922,79963,58104,82939,79963
6025,CA,14304,19074,10607,9970,6215,5250,7946,16738,9618.709876,8005,9941,63857,9403,-13726,11587,9403,73366,73260,50131,75444,73260
6027,CA,17016,19074,10607,9970,6215,5250,8313,19074,11025.39867,8005,9970,70340,11959,-9477,15199,11959,76445,82299,60863,85539,82299
6029,CA,14340,19074,10607,9970,6215,5250,7951,16815,10645.21251,8005,10167,65222,10042,-12663,12490,10042,73407,75264,52559,77712,75264
6031,CA,15168,19074,10607,9970,6215,5250,8063,16689,10379.0822,8005,10207,65698,10042,-12663,12490,10042,74347,75740,53035,78188,75740
6033,CA,15504,19074,10607,9970,6215,5250,8108,17519,13230.47841,8005,8424,67933,10681,-11601,13393,10681,74728,78614,56332,81326,78614
6035,CA,15852,19074,10607,9970,6215,5250,8155,16968,12812.27363,8005,9042,67929,10681,-11601,13393,10681,75123,78610,56328,81322,78610
6037,CA,22680,19074,10607,9970,6215,5250,9079,20966,11709.73376,8005,11060,79671,14995,-4298,18841,14995,82875,94666,75373,98512,94666
6039,CA,13680,19074,10607,9970,6215,5250,7862,16416,12660.19916,8005,9725,65736,10042,-12663,12490,10042,72658,75778,53073,78226,75778
6041,CA,31884,19074,10607,9970,6215,5250,10323,23622,14218.96243,8005,10921,93901,21918,7688,25512,21918,93323,115819,101589,119413,115819
6043,CA,11568,19074,10607,9970,6215,5250,7576,19074,10721.24974,8005,9970,64588,10042,-12663,12490,10042,70260,74630,51925,77078,74630
6045,CA,15324,19074,10607,9970,6215,5250,8084,17817,13306.51564,8005,9456,69159,11320,-10539,14296,11320,74524,80479,58620,83455,80479
6047,CA,14052,19074,10607,9970,6215,5250,7912,16283,10759.26836,8005,10108,64457,10042,-12663,12490,10042,73080,74499,51794,76947,74499
6049,CA,11268,19074,10607,9970,6215,5250,7536,19074,11025.39867,8005,9970,64592,10042,-12663,12490,10042,69920,74634,51929,77082,74634
6051,CA,18708,19074,10607,9970,6215,5250,8542,19074,10873.32421,8005,9970,71880,11959,-9477,15199,11959,78366,83839,62403,87079,83839
6053,CA,21600,19074,10607,9970,6215,5250,8933,19778,11443.60345,8005,10660,76736,14006,-6010,17888,14006,81649,90742,70726,94624,90742
6055,CA,24216,19074,10607,9970,6215,5250,9286,20568,13724.72042,8005,10819,82582,16973,-873,20747,16973,84618,99555,81709,103329,99555
6057,CA,18516,19074,10607,9970,6215,5250,8516,18564,15283.48368,8005,9510,75129,13237,-7352,17005,13237,78148,88366,67777,92134,88366
6059,CA,27600,19074,10607,9970,6215,5250,9744,22450,11861.80823,8005,11011,86178,18951,2551,22653,18951,88460,105129,88729,108831,105129
6061,CA,18960,19074,10607,9970,6215,5250,8576,19615,12622.18055,8005,10048,74500,13237,-7352,17005,13237,78652,87737,67148,91505,87737
6063,CA,13944,19074,10607,9970,6215,5250,7897,19074,11481.62207,8005,9970,67725,10681,-11601,13393,10681,72957,78406,56124,81118,78406
6065,CA,18984,19074,10607,9970,6215,5250,8579,18849,10797.28698,8005,10480,72366,12598,-8415,16102,12598,78679,84964,63951,88468,84964
6067,CA,18960,19074,10607,9970,6215,5250,8576,18484,11101.4359,8005,10060,71860,11959,-9477,15199,11959,78652,83819,62383,87059,83819
6069,CA,21144,19074,10607,9970,6215,5250,8871,19563,13572.64595,8005,11350,78885,14995,-4298,18841,14995,81131,93880,74587,97726,93880
6071,CA,18984,19074,10607,9970,6215,5250,8579,18269,10531.15666,8005,10492,71531,11959,-9477,15199,11959,78679,83490,62054,86730,83490
6073,CA,23628,19074,10607,9970,6215,5250,9207,21309,12051.90131,8005,10802,81047,15984,-2585,19794,15984,83951,97031,78462,100841,97031
6075,CA,31884,19074,10607,9970,6215,5250,10323,24475,14903.29752,8005,11310,95828,22907,9400,26465,22907,93323,118735,105228,122293,118735
6077,CA,16440,19074,10607,9970,6215,5250,8235,18039,10835.30559,8005,10267,68837,11320,-10539,14296,11320,75791,80157,58298,83133,80157
6079,CA,21480,19074,10607,9970,6215,5250,8916,19698,12698.21778,8005,9867,76998,14006,-6010,17888,14006,81512,91004,70988,94886,91004
6081,CA,31884,19074,10607,9970,6215,5250,10323,23415,13154.44117,8005,10960,92668,21918,7688,25512,21918,93323,114586,100356,118180,114586
6083,CA,20400,19074,10607,9970,6215,5250,8770,20811,11633.69653,8005,10823,76924,14006,-6010,17888,14006,80286,90930,70914,94812,90930
6085,CA,27900,19074,10607,9970,6215,5250,9784,23252,12736.2364,8005,11630,88773,19940,4263,23606,19940,88800,108713,93036,112379,108713
6087,CA,24696,19074,10607,9970,6215,5250,9351,21213,13154.44117,8005,10738,83057,16973,-873,20747,16973,85163,100030,82184,103804,100030
6089,CA,16620,19074,10607,9970,6215,5250,8259,17365,10721.24974,8005,9340,67301,10681,-11601,13393,10681,75995,77982,55700,80694,77982
6091,CA,15300,19074,10607,9970,6215,5250,8081,19074,11899.82684,8005,9970,69499,11320,-10539,14296,11320,74497,80819,58960,83795,80819
6093,CA,13800,19074,10607,9970,6215,5250,7878,19074,11595.67791,8005,9970,67695,10681,-11601,13393,10681,72794,78376,56094,81088,78376
6095,CA,20568,19074,10607,9970,6215,5250,8793,19167,11139.45452,8005,10826,74955,13237,-7352,17005,13237,80477,88192,67603,91960,88192
6097,CA,22116,19074,10607,9970,6215,5250,9002,20062,12926.32948,8005,10424,78784,14995,-4298,18841,14995,82234,93779,74486,97625,93779
6099,CA,16092,19074,10607,9970,6215,5250,8188,17301,10835.30559,8005,10105,67589,10681,-11601,13393,10681,75396,78270,55988,80982,78270
6101,CA,13704,19074,10607,9970,6215,5250,7865,17215,9618.709876,8005,9844,63636,9403,-13726,11587,9403,72685,73039,49910,75223,73039
6103,CA,14220,19074,10607,9970,6215,5250,7935,16870,11367.56622,8005,9392,65105,10042,-12663,12490,10042,73271,75147,52442,77595,75147
6105,CA,16680,19074,10607,9970,6215,5250,8267,19074,11329.5476,8005,9970,70309,11959,-9477,15199,11959,76063,82268,60832,85508,82268
6107,CA,13248,19074,10607,9970,6215,5250,7803,16194,10341.06358,8005,10197,63235,9403,-13726,11587,9403,72167,72638,49509,74822,72638
6109,CA,16692,19074,10607,9970,6215,5250,8269,17403,13686.7018,8005,9027,70064,11959,-9477,15199,11959,76077,82023,60587,85263,82023
6111,CA,24516,19074,10607,9970,6215,5250,9327,21282,12356.05024,8005,11359,82769,16973,-873,20747,16973,84959,99742,81896,103516,99742
6113,CA,19524,19074,10607,9970,6215,5250,8652,19484,11595.67791,8005,10057,73916,12598,-8415,16102,12598,79292,86514,65501,90018,86514
6115,CA,13704,19074,10607,9970,6215,5250,7865,17018,10036.91465,8005,9847,63861,9403,-13726,11587,9403,72685,73264,50135,75448,73264
8001,CO,16908,9869,10607,9970,6020,5250,10632,10839,10645.21251,8965,10580,63187,9266,-13863,11450,9266,69256,72453,49324,74637,72453
8003,CO,9552,9869,10607,9970,6020,5250,9444,9869,11557.6593,8965,9970,55164,7110,-17616,8238,7110,60712,62274,37548,63402,62274
8005,CO,16908,9869,10607,9970,6020,5250,10632,11533,11443.60345,8965,10596,64696,9805,-12900,12253,9805,69256,74501,51796,76949,74501
8007,CO,11472,9869,10607,9970,6020,5250,9754,9869,11443.60345,8965,9970,56970,7649,-16749,9041,7649,62942,64619,40221,66011,64619
8009,CO,11268,9869,10607,9970,6020,5250,9721,9869,9884.840189,8965,9970,55207,7110,-17616,8238,7110,62705,62317,37591,63445,62317
8011,CO,9516,9869,10607,9970,6020,5250,9439,9869,10455.11943,8965,9970,54025,7110,-17616,8238,7110,60671,61135,36409,62263,61135
8013,CO,20832,9869,10607,9970,6020,5250,11266,11840,12888.31086,8965,10470,70245,11422,-10014,14662,11422,73814,81667,60231,84907,81667
8014,CO,16908,9869,10607,9970,6020,5250,10632,11528,13420.57149,8965,10567,66639,10344,-11938,13056,10344,69256,76983,54701,79695,76983
8015,CO,12324,9869,10607,9970,6020,5250,9892,9869,11367.56622,8965,9970,57746,7649,-16749,9041,7649,63932,65395,40997,66787,65395
8017,CO,10476,9869,10607,9970,6020,5250,9594,9869,10607.19389,8965,9970,55137,7110,-17616,8238,7110,61786,62247,37521,63375,62247
8019,CO,16908,9869,10607,9970,6020,5250,10632,10346,11785.77099,8965,10512,63767,9266,-13863,11450,9266,69256,73033,49904,75217,73033
8021,CO,9516,9869,10607,9970,6020,5250,9439,9869,11595.67791,8965,9970,55166,7110,-17616,8238,7110,60671,62276,37550,63404,62276
8023,CO,11268,9869,10607,9970,6020,5250,9721,9869,11747.75238,8965,9970,57070,7649,-16749,9041,7649,62705,64719,40321,66111,64719
8025,CO,9564,9869,10607,9970,6020,5250,9446,9869,11063.41729,8965,9970,54681,7110,-17616,8238,7110,60726,61791,37065,62919,61791
8027,CO,9948,9869,10607,9970,6020,5250,9508,9869,10379.0822,8965,9970,54381,7110,-17616,8238,7110,61172,61491,36765,62619,61491
8029,CO,11364,9869,10607,9970,6020,5250,9737,9869,11443.60345,8965,9970,56862,7649,-16749,9041,7649,62817,64511,40113,65903,64511
8031,CO,16908,9869,10607,9970,6020,5250,10632,11460,11823.78961,8965,10633,65040,9805,-12900,12253,9805,69256,74845,52140,77293,74845
8033,CO,11268,9869,10607,9970,6020,5250,9721,9869,12432.08747,8965,9970,57754,7649,-16749,9041,7649,62705,65403,41005,66795,65403
8035,CO,16908,9869,10607,9970,6020,5250,10632,12103,11709.73376,8965,10552,65488,9805,-12900,12253,9805,69256,75293,52588,77741,75293
8037,CO,18540,9869,10607,9970,6020,5250,10896,13783,11291.52898,8965,11511,69340,10883,-10976,13859,10883,71152,80223,58364,83199,80223
8039,CO,16908,9869,10607,9970,6020,5250,10632,11212,12165.95716,8965,10517,65018,9805,-12900,12253,9805,69256,74823,52118,77271,74823
8041,CO,14268,9869,10607,9970,6020,5250,10206,10601,10987.38006,8965,10103,60174,8727,-14825,10647,8727,66190,68901,45349,70821,68901
8043,CO,11448,9869,10607,9970,6020,5250,9751,9457,10835.30559,8965,8168,54124,7110,-17616,8238,7110,62915,61234,36508,62362,61234
8045,CO,16800,9869,10607,9970,6020,5250,10615,11789,12165.95716,8965,10648,65618,9805,-12900,12253,9805,69131,75423,52718,77871,75423
8047,CO,16908,9869,10607,9970,6020,5250,10632,10191,11747.75238,8965,10497,63559,9266,-13863,11450,9266,69256,72825,49696,75009,72825
8049,CO,14952,9869,10607,9970,6020,5250,10316,9869,11899.82684,8965,9970,60906,8727,-14825,10647,8727,66984,69633,46081,71553,69633
8051,CO,13344,9869,10607,9970,6020,5250,10057,9869,11823.78961,8965,9970,59222,8188,-15787,9844,8188,65117,67410,43435,69066,67410
8053,CO,14172,9869,10607,9970,6020,5250,10190,9869,12964.34809,8965,9970,61190,8727,-14825,10647,8727,66078,69917,46365,71837,69917
8055,CO,10416,9869,10607,9970,6020,5250,9584,9869,10721.24974,8965,9970,55191,7110,-17616,8238,7110,61716,62301,37575,63429,62301
8057,CO,10392,9869,10607,9970,6020,5250,9580,9869,12964.34809,8965,9970,57410,7649,-16749,9041,7649,61688,65059,40661,66451,65059
8059,CO,16908,9869,10607,9970,6020,5250,10632,11329,11785.77099,8965,10578,64815,9805,-12900,12253,9805,69256,74620,51915,77068,74620
8061,CO,9516,9869,10607,9970,6020,5250,9439,9869,10531.15666,8965,9970,54101,7110,-17616,8238,7110,60671,61211,36485,62339,61211
8063,CO,9516,9869,10607,9970,6020,5250,9439,9869,10569.17528,8965,9970,54139,7110,-17616,8238,7110,60671,61249,36523,62377,61249
8065,CO,14664,9869,10607,9970,6020,5250,10270,9869,12698.21778,8965,9970,61416,8727,-14825,10647,8727,66650,70143,46591,72063,70143
8067,CO,15000,9869,10607,9970,6020,5250,10324,11172,13458.5901,8965,9936,63782,9266,-13863,11450,9266,67040,73048,49919,75232,73048
8069,CO,15840,9869,10607,9970,6020,5250,10460,10817,11899.82684,8965,10016,62788,9266,-13863,11450,9266,68016,72054,48925,74238,72054
8071,CO,11424,9869,10607,9970,6020,5250,9747,9869,10645.21251,8965,9970,56123,7649,-16749,9041,7649,62887,63772,39374,65164,63772
8073,CO,10284,9869,10607,9970,6020,5250,9563,9869,11557.6593,8965,9970,55896,7110,-17616,8238,7110,61563,63006,38280,64134,63006
8075,CO,9612,9869,10607,9970,6020,5250,9454,9012,10607.19389,8965,9750,53196,6571,-18155,7435,6571,60782,59767,35041,60631,59767
8077,CO,13524,9869,10607,9970,6020,5250,10086,10208,11139.45452,8965,9663,58749,8188,-15787,9844,8188,65326,66937,42962,68593,66937
8079,CO,11796,9869,10607,9970,6020,5250,9807,9869,12660.19916,8965,9970,58510,8188,-15787,9844,8188,63319,66698,42723,68354,66698
8081,CO,13044,9869,10607,9970,6020,5250,10008,10160,11823.78961,8965,10109,59352,8188,-15787,9844,8188,64768,67540,43565,69196,67540
8083,CO,11268,9869,10607,9970,6020,5250,9721,9869,11329.5476,8965,9970,56652,7649,-16749,9041,7649,62705,64301,39903,65693,64301
8085,CO,12876,9869,10607,9970,6020,5250,9981,10035,11709.73376,8965,9448,58284,8188,-15787,9844,8188,64573,66472,42497,68128,66472
8087,CO,10248,9869,10607,9970,6020,5250,9557,9571,10607.19389,8965,9780,54421,7110,-17616,8238,7110,61521,61531,36805,62659,61531
8089,CO,9516,9869,10607,9970,6020,5250,9439,9869,10341.06358,8965,9970,53911,6571,-18155,7435,6571,60671,60482,35756,61346,60482
8091,CO,17928,9869,10607,9970,6020,5250,10797,9869,11861.80823,8965,9970,63844,9266,-13863,11450,9266,70441,73110,49981,75294,73110
8093,CO,16908,9869,10607,9970,6020,5250,10632,9816,11443.60345,8965,10479,62862,9266,-13863,11450,9266,69256,72128,48999,74312,72128
8095,CO,9864,9869,10607,9970,6020,5250,9495,9869,11025.39867,8965,9970,54943,7110,-17616,8238,7110,61075,62053,37327,63181,62053
8097,CO,21156,9869,10607,9970,6020,5250,11318,12925,12318.03162,8965,10644,71258,11422,-10014,14662,11422,74190,82680,61244,85920,82680
8099,CO,9552,9869,10607,9970,6020,5250,9444,9869,10417.10081,8965,9970,54023,7110,-17616,8238,7110,60712,61133,36407,62261,61133
8101,CO,11892,9869,10607,9970,6020,5250,9822,9228,10265.02635,8965,9329,54929,7110,-17616,8238,7110,63430,62039,37313,63167,62039
8103,CO,12684,9869,10607,9970,6020,5250,9950,9869,11975.86407,8965,9970,58714,8188,-15787,9844,8188,64350,66902,42927,68558,66902
8105,CO,10152,9869,10607,9970,6020,5250,9541,9869,11861.80823,8965,9970,56068,7649,-16749,9041,7649,61409,63717,39319,65109,63717
8107,CO,17736,9869,10607,9970,6020,5250,10766,12131,14637.1672,8965,10548,69267,10883,-10976,13859,10883,70218,80150,58291,83126,80150
8109,CO,9708,9869,10607,9970,6020,5250,9470,9869,11747.75238,8965,9970,55510,7110,-17616,8238,7110,60894,62620,37894,63748,62620
8111,CO,14892,9869,10607,9970,6020,5250,10307,9869,12812.27363,8965,9970,61758,8727,-14825,10647,8727,66915,70485,46933,72405,70485
8113,CO,19512,9869,10607,9970,6020,5250,11053,9869,11633.69653,8965,9970,65200,9805,-12900,12253,9805,72281,75005,52300,77453,75005
8115,CO,10872,9869,10607,9970,6020,5250,9658,9869,11177.47314,8965,9970,56103,7649,-16749,9041,7649,62246,63752,39354,65144,63752
8117,CO,19428,9869,10607,9970,6020,5250,11039,13016,14599.14859,8965,10780,72037,11961,-9052,15465,11961,72183,83998,62985,87502,83998
8119,CO,14916,9869,10607,9970,6020,5250,10311,9915,12356.05024,8965,10079,61481,8727,-14825,10647,8727,66943,70208,46656,72128,70208
8121,CO,9636,9869,10607,9970,6020,5250,9458,9869,11101.4359,8965,9970,54791,7110,-17616,8238,7110,60810,61901,37175,63029,61901
8123,CO,12480,9869,10607,9970,6020,5250,9917,10270,11177.47314,8965,10291,58434,8188,-15787,9844,8188,64113,66622,42647,68278,66622
8125,CO,10092,9869,10607,9970,6020,5250,9532,9869,10607.19389,8965,9970,54753,7110,-17616,8238,7110,61340,61863,37137,62991,61863
9001,CT,21335,8386,10321,9258,7242,4819,11818,11440,12059.88353,10121,10355,70129,10773,-10663,14013,10773,73179,80902,59466,84142,80902
9003,CT,17484,8386,10321,9258,7242,4819,11182,9302,10728.11725,10121,9832,62286,8536,-14593,10720,8536,68692,70822,47693,73006,70822
9005,CT,14868,8386,10321,9258,7242,4819,10750,7745,11504.98092,10121,9890,58948,7430,-16545,9086,7430,65644,66378,42403,68034,66378
9007,CT,18739,8386,10321,9258,7242,4819,11389,8536,12207.85756,10121,9797,64220,9089,-13616,11537,9089,70154,73309,50604,75757,73309
9009,CT,17409,8386,10321,9258,7242,4819,11169,9805,10802.10427,10121,9753,62708,8536,-14593,10720,8536,68604,71244,48115,73428,71244
9011,CT,15961,8386,10321,9258,7242,4819,10930,8272,12022.89002,10121,9746,60943,7983,-15569,9903,7983,66917,68926,45374,70846,68926
9013,CT,17484,8386,10321,9258,7242,4819,11182,8073,11541.97442,10121,9802,61841,7983,-15569,9903,7983,68692,69824,46272,71744,69824
9015,CT,14016,8386,10321,9258,7242,4819,10609,7736,10321.18867,10121,9851,56865,6877,-17521,8269,6877,64651,63742,39344,65134,63742
10001,DE,15288,18562,8887,11553,6665,5178,9764,15393,8887.162454,11200,11742,67688,9208,-13074,11920,9208,75897,76896,54614,79608,76896
10003,DE,16968,18562,8887,11553,6665,5178,10023,26310,9715.356804,11200,12210,81581,15439,-3130,19249,15439,77836,97020,78451,100830,97020
10005,DE,13656,18562,8887,11553,6665,5178,9512,15716,9683.503175,11200,11369,66803,9208,-13074,11920,9208,74013,76011,53729,78723,76011
12001,FL,13932,12273,8887,11553,7376,5178,7049,13732,10129.45398,8500,10889,62360,6146,-17406,8066,6146,66248,68506,44954,70426,68506
12003,FL,11712,12273,8887,11553,7376,5178,6794,12912,8823.455196,8500,11528,58653,5693,-18282,7349,5693,63773,64346,40371,66002,64346
12005,FL,14088,12273,8887,11553,7376,5178,7067,13407,9683.503175,8500,11181,62038,6146,-17406,8066,6146,66422,68184,44632,70104,68184
12007,FL,11268,12273,8887,11553,7376,5178,6743,12273,8345.650763,8500,11553,57118,5240,-19158,6632,5240,63278,62358,37960,63750,62358
12009,FL,14316,12273,8887,11553,7376,5178,7094,12758,9205.698742,8500,10948,60905,6146,-17406,8066,6146,66677,67051,43499,68971,67051
12011,FL,21564,12273,8887,11553,7376,5178,7929,16183,9938.332206,8500,11616,72979,8411,-13025,11651,8411,74760,81390,59954,84630,81390
12013,FL,9516,12273,8887,11553,7376,5178,6541,12273,9492.381402,8500,11553,56512,4787,-19939,5915,4787,61324,61299,36573,62427,61299
12015,FL,14640,12273,8887,11553,7376,5178,7131,12484,9556.08866,8500,10166,60523,5693,-18282,7349,5693,67038,66216,42241,67872,66216
12017,FL,11868,12273,8887,11553,7376,5178,6812,11556,9683.503175,8500,9649,56434,4787,-19939,5915,4787,63947,61221,36495,62349,61221
12019,FL,14796,12273,8887,11553,7376,5178,7149,12679,9587.942289,8500,11528,62269,6146,-17406,8066,6146,67212,68415,44863,70335,68415
12021,FL,15768,12273,8887,11553,7376,5178,7261,16616,9874.624948,8500,11314,67250,7505,-14777,10217,7505,68296,74755,52473,77467,74755
12023,FL,13812,12273,8887,11553,7376,5178,7036,12496,8982.72334,8500,10367,59335,5693,-18282,7349,5693,66115,65028,41053,66684,65028
12027,FL,10704,12273,8887,11553,7376,5178,6678,12971,8791.601567,8500,10459,56604,5240,-19158,6632,5240,62649,61844,37446,63236,61844
12029,FL,11160,12273,8887,11553,7376,5178,6730,12273,8887.162454,8500,11553,57551,5240,-19158,6632,5240,63157,62791,38393,64183,62791
12031,FL,14796,12273,8887,11553,7376,5178,7149,13099,9428.674144,8500,11527,62528,6146,-17406,8066,6146,67212,68674,45122,70594,68674
12033,FL,13428,12273,8887,11553,7376,5178,6991,11974,9173.845113,8500,11186,59439,5693,-18282,7349,5693,65686,65132,41157,66788,65132
12035,FL,15612,12273,8887,11553,7376,5178,7243,11975,9970.185835,8500,10777,62012,6146,-17406,8066,6146,68122,68158,44606,70078,68158
12037,FL,12432,12273,8887,11553,7376,5178,6877,12273,8791.601567,8500,11553,58728,5693,-18282,7349,5693,64576,64421,40446,66077,64421
12039,FL,14004,12273,8887,11553,7376,5178,7058,11739,8727.894309,8500,11135,59284,5693,-18282,7349,5693,66329,64977,41002,66633,64977
12041,FL,13932,12273,8887,11553,7376,5178,7049,13247,9715.356804,8500,10936,61509,6146,-17406,8066,6146,66248,67655,44103,69575,67655
12043,FL,11616,12273,8887,11553,7376,5178,6783,12273,9842.771319,8500,11553,58963,5693,-18282,7349,5693,63666,64656,40681,66312,64656
12045,FL,12504,12273,8887,11553,7376,5178,6885,12421,9619.795917,8500,11194,59416,5693,-18282,7349,5693,64656,65109,41134,66765,65109
12047,FL,9516,12273,8887,11553,7376,5178,6541,12273,8759.747938,8500,11553,55780,4787,-19939,5915,4787,61324,60567,35841,61695,60567
12049,FL,10128,12273,8887,11553,7376,5178,6611,12171,8409.358021,8500,11151,55538,5240,-19158,6632,5240,62006,60778,36380,62170,60778
12051,FL,12312,12273,8887,11553,7376,5178,6863,12346,8759.747938,8500,10894,57990,5693,-18282,7349,5693,64442,63683,39708,65339,63683
12053,FL,15228,12273,8887,11553,7376,5178,7199,11352,9205.698742,8500,11058,60522,6146,-17406,8066,6146,67694,66668,43116,68588,66668
12055,FL,12324,12273,8887,11553,7376,5178,6864,12078,9205.698742,8500,9686,56972,5240,-19158,6632,5240,64455,62212,37814,63604,62212
12057,FL,15228,12273,8887,11553,7376,5178,7199,13849,9460.527773,8500,10990,63205,6599,-16530,8783,6599,67694,69804,46675,71988,69804
12059,FL,10476,12273,8887,11553,7376,5178,6651,12273,10002.03946,8500,11553,57982,5240,-19158,6632,5240,62394,63222,38824,64614,63222
12061,FL,13944,12273,8887,11553,7376,5178,7051,13316,10097.60035,8500,10509,61545,6146,-17406,8066,6146,66262,67691,44139,69611,67691
12063,FL,9516,12273,8887,11553,7376,5178,6541,12273,9333.113258,8500,11553,56353,4787,-19939,5915,4787,61324,61140,36414,62268,61140
12065,FL,14004,12273,8887,11553,7376,5178,7058,12127,9205.698742,8500,11143,60158,5693,-18282,7349,5693,66329,65851,41876,67507,65851
12067,FL,9516,12273,8887,11553,7376,5178,6541,12273,8855.308825,8500,11553,55875,4787,-19939,5915,4787,61324,60662,35936,61790,60662
12069,FL,15732,12273,8887,11553,7376,5178,7257,12599,9237.552371,8500,11676,62923,6599,-16530,8783,6599,68256,69522,46393,71706,69522
12071,FL,14544,12273,8887,11553,7376,5178,7120,14002,9524.235031,8500,10969,62718,6599,-16530,8783,6599,66931,69317,46188,71501,69317
12073,FL,14004,12273,8887,11553,7376,5178,7058,13724,9556.08866,8500,11102,62065,6146,-17406,8066,6146,66329,68211,44659,70131,68211
12075,FL,10644,12273,8887,11553,7376,5178,6671,12273,8887.162454,8500,11553,57035,5240,-19158,6632,5240,62582,62275,37877,63667,62275
12077,FL,11268,12273,8887,11553,7376,5178,6743,12273,9428.674144,8500,11553,58201,5240,-19158,6632,5240,63278,63441,39043,64833,63441
12079,FL,11616,12273,8887,11553,7376,5178,6783,12273,9173.845113,8500,11553,58294,5693,-18282,7349,5693,63666,63987,40012,65643,63987
12081,FL,16260,12273,8887,11553,7376,5178,7318,14309,9970.185835,8500,10640,64858,6599,-16530,8783,6599,68845,71457,48328,73641,71457
12083,FL,12720,12273,8887,11553,7376,5178,6910,11808,8919.016082,8500,10047,57172,5240,-19158,6632,5240,64897,62412,38014,63804,62412
12085,FL,15276,12273,8887,11553,7376,5178,7204,15124,10957.64833,8500,10828,65864,6599,-16530,8783,6599,67747,72463,49334,74647,72463
12086,FL,19200,12273,8887,11553,7376,5178,7656,15923,10097.60035,8500,11620,70518,7958,-13901,10934,7958,72123,78476,56617,81452,78476
12087,FL,21384,12273,8887,11553,7376,5178,7908,16621,11562.86728,8500,11642,74888,8864,-12149,12368,8864,74559,83752,62739,87256,83752
12089,FL,14796,12273,8887,11553,7376,5178,7149,13640,10225.01487,8500,11528,63867,6599,-16530,8783,6599,67212,70466,47337,72650,70466
12091,FL,15720,12273,8887,11553,7376,5178,7255,13043,9747.210433,8500,11369,63557,6599,-16530,8783,6599,68242,70156,47027,72340,70156
12093,FL,11340,12273,8887,11553,7376,5178,6751,12616,8855.308825,8500,10365,56854,5240,-19158,6632,5240,63358,62094,37696,63486,62094
12095,FL,15732,12273,8887,11553,7376,5178,7257,14026,9269.406,8500,11694,64399,7052,-15653,9500,7052,68256,71451,48746,73899,71451
12097,FL,15732,12273,8887,11553,7376,5178,7257,13319,8791.601567,8500,11684,63204,6599,-16530,8783,6599,68256,69803,46674,71987,69803
12099,FL,19476,12273,8887,11553,7376,5178,7688,15875,10161.30761,8500,11611,70801,7958,-13901,10934,7958,72431,78759,56900,81735,78759
12101,FL,15228,12273,8887,11553,7376,5178,7199,12847,9492.381402,8500,11029,62275,6146,-17406,8066,6146,67694,68421,44869,70341,68421
12103,FL,15228,12273,8887,11553,7376,5178,7199,14394,9619.795917,8500,10958,63878,6599,-16530,8783,6599,67694,70477,47348,72661,70477
12105,FL,13128,12273,8887,11553,7376,5178,6957,12556,8919.016082,8500,11082,59363,5693,-18282,7349,5693,65352,65056,41081,66712,65056
12107,FL,9732,12273,8887,11553,7376,5178,6566,12432,8919.016082,8500,9890,54651,4787,-19939,5915,4787,61565,59438,34712,60566,59438
12109,FL,14796,12273,8887,11553,7376,5178,7149,14440,10830.23381,8500,11527,65272,6599,-16530,8783,6599,67212,71871,48742,74055,71871
12111,FL,15276,12273,8887,11553,7376,5178,7204,12387,9460.527773,8500,10859,61660,6146,-17406,8066,6146,67747,67806,44254,69726,67806
12113,FL,13428,12273,8887,11553,7376,5178,6991,12201,10129.45398,8500,11197,60634,5693,-18282,7349,5693,65686,66327,42352,67983,66327
12115,FL,16260,12273,8887,11553,7376,5178,7318,13849,10193.16124,8500,10651,64631,6599,-16530,8783,6599,68845,71230,48101,73414,71230
12117,FL,15732,12273,8887,11553,7376,5178,7257,13760,9301.259629,8500,11688,64159,6599,-16530,8783,6599,68256,70758,47629,72942,70758
12119,FL,12612,12273,8887,11553,7376,5178,6897,10863,9619.795917,8500,9368,56141,4787,-19939,5915,4787,64776,60928,36202,62056,60928
12121,FL,11100,12273,8887,11553,7376,5178,6723,12273,8791.601567,8500,11553,57396,5240,-19158,6632,5240,63090,62636,38238,64028,62636
12123,FL,11268,12273,8887,11553,7376,5178,6743,12273,8982.72334,8500,11553,57755,5240,-19158,6632,5240,63278,62995,38597,64387,62995
12125,FL,9912,12273,8887,11553,7376,5178,6586,12273,9715.356804,8500,11553,57131,5240,-19158,6632,5240,61765,62371,37973,63763,62371
12127,FL,14388,12273,8887,11553,7376,5178,7102,12576,9683.503175,8500,10768,61093,6146,-17406,8066,6146,66757,67239,43687,69159,67239
12129,FL,12288,12273,8887,11553,7376,5178,6860,12656,9078.284227,8500,11135,58835,5693,-18282,7349,5693,64415,64528,40553,66184,64528
12131,FL,14076,12273,8887,11553,7376,5178,7066,13180,10734.67293,8500,11381,63050,6146,-17406,8066,6146,66409,69196,45644,71116,69196
12133,FL,10140,12273,8887,11553,7376,5178,6613,12273,8759.747938,8500,11553,56404,5240,-19158,6632,5240,62020,61644,37246,63036,61644
13001,GA,9504,30988,8887,11553,6130,5178,7195,30988,8409.358021,8272,11553,73904,12571,-8018,16339,12571,79435,86475,65886,90243,86475
13003,GA,9504,30988,8887,11553,6130,5178,7195,30988,8218.236247,8272,11553,73713,12571,-8018,16339,12571,79435,86284,65695,90052,86284
13005,GA,9504,30988,8887,11553,6130,5178,7195,30988,8281.943505,8272,11553,73777,12571,-8018,16339,12571,79435,86348,65759,90116,86348
13007,GA,11628,30988,8887,11553,6130,5178,7482,33550,8919.016082,8272,10414,77961,13274,-6742,17156,13274,81846,91235,71219,95117,91235
13009,GA,11040,30988,8887,11553,6130,5178,7403,32497,9078.284227,8272,9897,75962,12571,-8018,16339,12571,81179,88533,67944,92301,88533
13011,GA,11568,30988,8887,11553,6130,5178,7474,30988,9014.576969,8272,11553,76574,13274,-6742,17156,13274,81778,89848,69832,93730,89848
13013,GA,14244,30988,8887,11553,6130,5178,7836,30106,8473.065278,8272,11813,78086,14197,-5096,18043,14197,84816,92283,72990,96129,92283
13015,GA,14244,30988,8887,11553,6130,5178,7836,31528,8887.162454,8272,11822,79931,14197,-5096,18043,14197,84816,94128,74835,97974,94128
13017,GA,9912,30988,8887,11553,6130,5178,7250,29752,8600.479794,8272,9904,71618,11425,-10011,14665,11425,79898,83043,61607,86283,83043
13019,GA,9504,30988,8887,11553,6130,5178,7195,30988,8727.894309,8272,11553,74223,12571,-8018,16339,12571,79435,86794,66205,90562,86794
13021,GA,12096,30988,8887,11553,6130,5178,7546,31089,8536.772536,8272,10975,76147,13274,-6742,17156,13274,82378,89421,69405,93303,89421
13023,GA,11244,30988,8887,11553,6130,5178,7430,30988,8791.601567,8272,11553,76027,13274,-6742,17156,13274,81410,89301,69285,93183,89301
13025,GA,10008,30988,8887,11553,6130,5178,7263,32682,9141.991484,8272,11061,76343,13274,-6742,17156,13274,80007,89617,69601,93499,89617
13027,GA,11052,30988,8887,11553,6130,5178,7404,30523,8855.308825,8272,10620,74500,12571,-8018,16339,12571,81192,87071,66482,90839,87071
13029,GA,13764,30988,8887,11553,6130,5178,7771,33917,10002.03946,8272,11453,82587,15120,-3449,18930,15120,84271,97707,79138,101517,97707
13031,GA,12600,30988,8887,11553,6130,5178,7614,33329,9205.698742,8272,10429,79013,14197,-5096,18043,14197,82950,93210,73917,97056,93210
13033,GA,11916,30988,8887,11553,6130,5178,7521,30945,8345.650763,8272,11263,75919,13274,-6742,17156,13274,82173,89193,69177,93075,89193
13035,GA,11880,30988,8887,11553,6130,5178,7516,29990,11116.91647,8272,11809,78246,13274,-6742,17156,13274,82132,91520,71504,95402,91520
13037,GA,9504,30988,8887,11553,6130,5178,7195,30988,8919.016082,8272,11553,74414,12571,-8018,16339,12571,79435,86985,66396,90753,86985
13039,GA,13560,30988,8887,11553,6130,5178,7743,33614,9237.552371,8272,11664,81526,15120,-3449,18930,15120,84039,96646,78077,100456,96646
13043,GA,9504,30988,8887,11553,6130,5178,7195,30988,8791.601567,8272,11553,74287,12571,-8018,16339,12571,79435,86858,66269,90626,86858
13045,GA,14244,30988,8887,11553,6130,5178,7836,30947,9173.845113,8272,11821,79636,14197,-5096,18043,14197,84816,93833,74540,97679,93833
13047,GA,11076,30988,8887,11553,6130,5178,7408,30793,8441.211649,8272,11142,74901,12571,-8018,16339,12571,81220,87472,66883,91240,87472
13049,GA,10704,30988,8887,11553,6130,5178,7357,30988,9651.649546,8272,11553,76347,12571,-8018,16339,12571,80797,88918,68329,92686,88918
13051,GA,13764,30988,8887,11553,6130,5178,7771,34755,9396.820515,8272,11445,82811,16043,-1803,19817,16043,84271,98854,81008,102628,98854
13053,GA,11652,30988,8887,11553,6130,5178,7486,36068,9524.235031,8272,11031,81725,15120,-3449,18930,15120,81874,96845,78276,100655,96845
13055,GA,10248,30988,8887,11553,6130,5178,7296,29255,8536.772536,8272,10014,71504,11425,-10011,14665,11425,80280,82929,61493,86169,82929
13057,GA,14244,30988,8887,11553,6130,5178,7836,33781,9333.113258,8272,11809,82617,16043,-1803,19817,16043,84816,98660,80814,102434,98660
13059,GA,11736,30988,8887,11553,6130,5178,7497,34377,8982.72334,8272,11209,79755,14197,-5096,18043,14197,81969,93952,74659,97798,93952
13061,GA,9876,30988,8887,11553,6130,5178,7245,30988,9237.552371,8272,11553,75105,12571,-8018,16339,12571,79857,87676,67087,91444,87676
13063,GA,14244,30988,8887,11553,6130,5178,7836,32560,7613.017299,8272,11834,79701,15120,-3449,18930,15120,84816,94821,76252,98631,94821
13065,GA,11004,30988,8887,11553,6130,5178,7398,30988,8727.894309,8272,11553,75723,12571,-8018,16339,12571,81138,88294,67705,92062,88294
13067,GA,14244,30988,8887,11553,6130,5178,7836,36079,9333.113258,8272,11835,84941,16966,-157,20704,16966,84816,101907,84784,105645,101907
13069,GA,11100,30988,8887,11553,6130,5178,7411,31093,8377.504392,8272,10386,74406,12571,-8018,16339,12571,81247,86977,66388,90745,86977
13071,GA,11244,30988,8887,11553,6130,5178,7430,31305,8441.211649,8272,10529,74969,12571,-8018,16339,12571,81410,87540,66951,91308,87540
13073,GA,11916,30988,8887,11553,6130,5178,7521,32916,9269.406,8272,11273,78825,14197,-5096,18043,14197,82173,93022,73729,96868,93022
13075,GA,11580,30988,8887,11553,6130,5178,7476,30988,8791.601567,8272,11553,76363,13274,-6742,17156,13274,81792,89637,69621,93519,89637
13077,GA,14244,30988,8887,11553,6130,5178,7836,31415,9428.674144,8272,11805,80342,14197,-5096,18043,14197,84816,94539,75246,98385,94539
13079,GA,12096,30988,8887,11553,6130,5178,7546,33022,8632.333423,8272,11006,78206,14197,-5096,18043,14197,82378,92403,73110,96249,92403
13081,GA,9600,30988,8887,11553,6130,5178,7208,30115,8759.747938,8272,10248,72173,11998,-9015,15502,11998,79544,84171,63158,87675,84171
13083,GA,11076,30988,8887,11553,6130,5178,7408,30103,8823.455196,8272,11144,74596,12571,-8018,16339,12571,81220,87167,66578,90935,87167
13085,GA,14244,30988,8887,11553,6130,5178,7836,33449,9046.430598,8272,11809,81998,15120,-3449,18930,15120,84816,97118,78549,100928,97118
13087,GA,10152,30988,8887,11553,6130,5178,7283,30500,9237.552371,8272,10009,73348,11998,-9015,15502,11998,80171,85346,64333,88850,85346
13089,GA,14244,30988,8887,11553,6130,5178,7836,36896,9205.698742,8272,11864,85660,16966,-157,20704,16966,84816,102626,85503,106364,102626
13091,GA,11244,30988,8887,11553,6130,5178,7430,30988,8600.479794,8272,11553,75835,13274,-6742,17156,13274,81410,89109,69093,92991,89109
13093,GA,11244,30988,8887,11553,6130,5178,7430,30988,8823.455196,8272,11553,76058,13274,-6742,17156,13274,81410,89332,69316,93214,89332
13095,GA,11628,30988,8887,11553,6130,5178,7482,31239,8759.747938,8272,10256,75333,12571,-8018,16339,12571,81846,87904,67315,91672,87904
13097,GA,14244,30988,8887,11553,6130,5178,7836,32626,8568.626165,8272,11813,80701,15120,-3449,18930,15120,84816,95821,77252,99631,95821
13099,GA,11244,30988,8887,11553,6130,5178,7430,30988,9205.698742,8272,11553,76441,13274,-6742,17156,13274,81410,89715,69699,93597,89715
13101,GA,11052,30988,8887,11553,6130,5178,7404,33919,8919.016082,8272,10626,77967,13274,-6742,17156,13274,81192,91241,71225,95123,91241
13103,GA,13764,30988,8887,11553,6130,5178,7771,33919,8887.162454,8272,11450,81470,15120,-3449,18930,15120,84271,96590,78021,100400,96590
13105,GA,11244,30988,8887,11553,6130,5178,7430,30988,8887.162454,8272,11553,76122,13274,-6742,17156,13274,81410,89396,69380,93278,89396
13107,GA,10620,30988,8887,11553,6130,5178,7346,30988,8154.52899,8272,11553,74766,12571,-8018,16339,12571,80702,87337,66748,91105,87337
13109,GA,9612,30988,8887,11553,6130,5178,7210,30988,9046.430598,8272,11553,74649,12571,-8018,16339,12571,79558,87220,66631,90988,87220
13111,GA,9600,30988,8887,11553,6130,5178,7208,30988,9524.235031,8272,11553,75115,12571,-8018,16339,12571,79544,87686,67097,91454,87686
13113,GA,14244,30988,8887,11553,6130,5178,7836,35675,9683.503175,8272,11819,84872,16966,-157,20704,16966,84816,101838,84715,105576,101838
13115,GA,10068,30988,8887,11553,6130,5178,7271,30412,8632.333423,8272,10997,73559,11998,-9015,15502,11998,80075,85557,64544,89061,85557
13117,GA,14244,30988,8887,11553,6130,5178,7836,36355,10734.67293,8272,11811,86595,16966,-157,20704,16966,84816,103561,86438,107299,103561
13119,GA,10476,30988,8887,11553,6130,5178,7327,30988,9269.406,8272,11553,75736,12571,-8018,16339,12571,80539,88307,67718,92075,88307
13121,GA,14244,30988,8887,11553,6130,5178,7836,40054,9842.771319,8272,11870,89460,18812,3135,22478,18812,84816,108272,92595,111938,108272
13123,GA,10392,30988,8887,11553,6130,5178,7315,30988,8887.162454,8272,11553,75270,12571,-8018,16339,12571,80443,87841,67252,91609,87841
13125,GA,9504,30988,8887,11553,6130,5178,7195,30988,8600.479794,8272,11553,74095,12571,-8018,16339,12571,79435,86666,66077,90434,86666
13127,GA,10008,30988,8887,11553,6130,5178,7263,34102,9906.478577,8272,11015,78482,13274,-6742,17156,13274,80007,91756,71740,95638,91756
13129,GA,11412,30988,8887,11553,6130,5178,7453,30450,8759.747938,8272,11355,75427,12571,-8018,16339,12571,81601,87998,67409,91766,87998
13131,GA,9528,30988,8887,11553,6130,5178,7198,30988,8536.772536,8272,11553,74056,12571,-8018,16339,12571,79462,86627,66038,90395,86627
13133,GA,10932,30988,8887,11553,6130,5178,7388,30988,9141.991484,8272,11553,76065,12571,-8018,16339,12571,81056,88636,68047,92404,88636
13135,GA,14244,30988,8887,11553,6130,5178,7836,34831,8791.601567,8272,11826,83143,16043,-1803,19817,16043,84816,99186,81340,102960,99186
13137,GA,11244,30988,8887,11553,6130,5178,7430,30697,9046.430598,8272,10622,75059,12571,-8018,16339,12571,81410,87630,67041,91398,87630
13139,GA,12696,30988,8887,11553,6130,5178,7627,32822,8919.016082,8272,11831,79718,14197,-5096,18043,14197,83059,93915,74622,97761,93915
13141,GA,9504,30988,8887,11553,6130,5178,7195,32095,9173.845113,8272,10017,74240,11998,-9015,15502,11998,79435,86238,65225,89742,86238
13143,GA,10728,30988,8887,11553,6130,5178,7361,30525,8791.601567,8272,11812,75307,12571,-8018,16339,12571,80825,87878,67289,91646,87878
13145,GA,11652,30988,8887,11553,6130,5178,7486,32100,9779.064062,8272,11078,78059,13274,-6742,17156,13274,81874,91333,71317,95215,91333
13147,GA,10752,30988,8887,11553,6130,5178,7364,30988,8791.601567,8272,11553,75535,12571,-8018,16339,12571,80852,88106,67517,91874,88106
13149,GA,14244,30988,8887,11553,6130,5178,7836,31933,9173.845113,8272,11807,80608,15120,-3449,18930,15120,84816,95728,77159,99538,95728
13151,GA,14244,30988,8887,11553,6130,5178,7836,32129,8600.479794,8272,11815,80238,15120,-3449,18930,15120,84816,95358,76789,99168,95358
13153,GA,11700,30988,8887,11553,6130,5178,7492,30958,8791.601567,8272,11573,76472,13274,-6742,17156,13274,81928,89746,69730,93628,89746
13155,GA,9504,30988,8887,11553,6130,5178,7195,30988,8568.626165,8272,11553,74064,12571,-8018,16339,12571,79435,86635,66046,90403,86635
13157,GA,11616,30988,8887,11553,6130,5178,7481,32364,9938.332206,8272,11649,79017,13274,-6742,17156,13274,81833,92291,72275,96173,92291
13159,GA,14244,30988,8887,11553,6130,5178,7836,30169,8600.479794,8272,11800,78263,14197,-5096,18043,14197,84816,92460,73167,96306,92460
13161,GA,10392,30988,8887,11553,6130,5178,7315,30988,8441.211649,8272,11553,74824,12571,-8018,16339,12571,80443,87395,66806,91163,87395
13163,GA,9504,30988,8887,11553,6130,5178,7195,30988,8759.747938,8272,11553,74255,12571,-8018,16339,12571,79435,86826,66237,90594,86826
13165,GA,10764,30988,8887,11553,6130,5178,7365,30988,8823.455196,8272,11553,75578,12571,-8018,16339,12571,80865,88149,67560,91917,88149
13167,GA,9504,30988,8887,11553,6130,5178,7195,28655,8504.918907,8272,10336,70449,11425,-10011,14665,11425,79435,81874,60438,85114,81874
13169,GA,12096,30988,8887,11553,6130,5178,7546,32125,7549.310041,8272,11029,76249,13274,-6742,17156,13274,82378,89523,69507,93405,89523
13171,GA,11244,30988,8887,11553,6130,5178,7430,31202,8791.601567,8272,11813,76501,13274,-6742,17156,13274,81410,89775,69759,93657,89775
13173,GA,11052,30988,8887,11553,6130,5178,7404,31775,8791.601567,8272,10603,75671,12571,-8018,16339,12571,81192,88242,67653,92010,88242
13175,GA,10560,30988,8887,11553,6130,5178,7338,30939,8791.601567,8272,10276,74018,12571,-8018,16339,12571,80634,86589,66000,90357,86589
13177,GA,11628,30988,8887,11553,6130,5178,7482,32059,9524.235031,8272,10364,77025,13274,-6742,17156,13274,81846,90299,70283,94181,90299
13179,GA,12648,30988,8887,11553,6130,5178,7620,33964,8727.894309,8272,11414,80203,15120,-3449,18930,15120,83004,95323,76754,99133,95323
13181,GA,11244,30988,8887,11553,6130,5178,7430,32730,9173.845113,8272,11265,77863,13274,-6742,17156,13274,81410,91137,71121,95019,91137
13183,GA,10440,30988,8887,11553,6130,5178,7322,34344,8568.626165,8272,11425,78228,14197,-5096,18043,14197,80498,92425,73132,96271,92425
13185,GA,11052,30988,8887,11553,6130,5178,7404,31327,8982.72334,8272,10551,75362,12571,-8018,16339,12571,81192,87933,67344,91701,87933
13187,GA,12072,30988,8887,11553,6130,5178,7542,30988,9556.08866,8272,11553,77619,13274,-6742,17156,13274,82350,90893,70877,94775,90893
13189,GA,11916,30988,8887,11553,6130,5178,7521,30788,8664.187051,8272,11256,76074,13274,-6742,17156,13274,82173,89348,69332,93230,89348
13191,GA,10008,30988,8887,11553,6130,5178,7263,34452,9237.552371,8272,11056,78203,13274,-6742,17156,13274,80007,91477,71461,95359,91477
13193,GA,9504,30988,8887,11553,6130,5178,7195,30988,8823.455196,8272,11553,74318,12571,-8018,16339,12571,79435,86889,66300,90657,86889
13195,GA,11736,30988,8887,11553,6130,5178,7497,31145,9333.113258,8272,11233,76896,13274,-6742,17156,13274,81969,90170,70154,94052,90170
13197,GA,11652,30988,8887,11553,6130,5178,7486,32106,8536.772536,8272,11044,76789,13274,-6742,17156,13274,81874,90063,70047,93945,90063
13199,GA,9780,30988,8887,11553,6130,5178,7232,29914,9715.356804,8272,11806,74665,11998,-9015,15502,11998,79748,86663,65650,90167,86663
13201,GA,10944,30988,8887,11553,6130,5178,7390,30988,9046.430598,8272,11553,75981,12571,-8018,16339,12571,81070,88552,67963,92320,88552
13205,GA,10296,30988,8887,11553,6130,5178,7302,30988,8791.601567,8272,11553,75079,12571,-8018,16339,12571,80334,87650,67061,91418,87650
13207,GA,11508,30988,8887,11553,6130,5178,7466,32552,8887.162454,8272,10996,77393,13274,-6742,17156,13274,81710,90667,70651,94549,90667
13209,GA,9504,30988,8887,11553,6130,5178,7195,31243,8377.504392,8272,10193,72767,11998,-9015,15502,11998,79435,84765,63752,88269,84765
13211,GA,12360,30988,8887,11553,6130,5178,7581,31492,8919.016082,8272,11802,78023,13274,-6742,17156,13274,82677,91297,71281,95179,91297
13213,GA,10080,30988,8887,11553,6130,5178,7273,31631,9173.845113,8272,10977,75312,12571,-8018,16339,12571,80089,87883,67294,91651,87883
13215,GA,11652,30988,8887,11553,6130,5178,7486,31735,9842.771319,8272,11007,77687,13274,-6742,17156,13274,81874,90961,70945,94843,90961
13217,GA,14244,30988,8887,11553,6130,5178,7836,30301,8473.065278,8272,11813,78281,14197,-5096,18043,14197,84816,92478,73185,96324,92478
13219,GA,11736,30988,8887,11553,6130,5178,7497,33756,9747.210433,8272,11261,79950,14197,-5096,18043,14197,81969,94147,74854,97993,94147
13221,GA,11736,30988,8887,11553,6130,5178,7497,31539,9333.113258,8272,11249,77308,13274,-6742,17156,13274,81969,90582,70566,94464,90582
13223,GA,14244,30988,8887,11553,6130,5178,7836,30290,8632.333423,8272,11807,78424,14197,-5096,18043,14197,84816,92621,73328,96467,92621
13225,GA,10476,30988,8887,11553,6130,5178,7327,30818,8313.797134,8272,11572,74629,12571,-8018,16339,12571,80539,87200,66611,90968,87200
13227,GA,14244,30988,8887,11553,6130,5178,7836,32234,9333.113258,8272,11812,81073,15120,-3449,18930,15120,84816,96193,77624,100003,96193
13229,GA,9504,30988,8887,11553,6130,5178,7195,30765,8281.943505,8272,10208,72210,11998,-9015,15502,11998,79435,84208,63195,87712,84208
13231,GA,14244,30988,8887,11553,6130,5178,7836,31831,8791.601567,8272,11803,80119,15120,-3449,18930,15120,84816,95239,76670,99049,95239
13233,GA,10452,30988,8887,11553,6130,5178,7323,30030,8696.04068,8272,10671,73299,11998,-9015,15502,11998,80511,85297,64284,88801,85297
13235,GA,11244,30988,8887,11553,6130,5178,7430,29760,8727.894309,8272,11572,74754,12571,-8018,16339,12571,81410,87325,66736,91093,87325
13237,GA,14232,30988,8887,11553,6130,5178,7834,30988,8823.455196,8272,11553,79046,14197,-5096,18043,14197,84802,93243,73950,97089,93243
13239,GA,11244,30988,8887,11553,6130,5178,7430,30988,9428.674144,8272,11553,76664,13274,-6742,17156,13274,81410,89938,69922,93820,89938
13241,GA,11856,30988,8887,11553,6130,5178,7513,30988,8919.016082,8272,11553,76766,13274,-6742,17156,13274,82105,90040,70024,93922,90040
13243,GA,10080,30988,8887,11553,6130,5178,7273,30988,9396.820515,8272,11553,75468,12571,-8018,16339,12571,80089,88039,67450,91807,88039
13245,GA,11916,30988,8887,11553,6130,5178,7521,31788,8632.333423,8272,11260,77046,13274,-6742,17156,13274,82173,90320,70304,94202,90320
13247,GA,14244,30988,8887,11553,6130,5178,7836,32186,8441.211649,8272,11813,80134,15120,-3449,18930,15120,84816,95254,76685,99064,95254
13249,GA,10644,30988,8887,11553,6130,5178,7349,31652,8855.308825,8272,10395,74996,12571,-8018,16339,12571,80729,87567,66978,91335,87567
13251,GA,10140,30988,8887,11553,6130,5178,7281,30988,8823.455196,8272,11553,74954,12571,-8018,16339,12571,80157,87525,66936,91293,87525
13253,GA,10476,30988,8887,11553,6130,5178,7327,30988,9237.552371,8272,11553,75705,12571,-8018,16339,12571,80539,88276,67687,92044,88276
13255,GA,14244,30988,8887,11553,6130,5178,7836,30562,8855.308825,8272,11823,78934,14197,-5096,18043,14197,84816,93131,73838,96977,93131
13257,GA,11352,30988,8887,11553,6130,5178,7445,30962,8950.869711,8272,10541,75257,12571,-8018,16339,12571,81533,87828,67239,91596,87828
13259,GA,10620,30988,8887,11553,6130,5178,7346,30988,9428.674144,8272,11553,76040,12571,-8018,16339,12571,80702,88611,68022,92379,88611
13261,GA,10428,30988,8887,11553,6130,5178,7320,30587,8982.72334,8272,10334,73782,11998,-9015,15502,11998,80484,85780,64767,89284,85780
13263,GA,10668,30988,8887,11553,6130,5178,7352,30988,9460.527773,8272,11553,76120,12571,-8018,16339,12571,80756,88691,68102,92459,88691
13265,GA,12252,30988,8887,11553,6130,5178,7567,30988,9587.942289,8272,11553,77831,13274,-6742,17156,13274,82555,91105,71089,94987,91105
13267,GA,10572,30988,8887,11553,6130,5178,7340,30988,8281.943505,8272,11553,74845,12571,-8018,16339,12571,80648,87416,66827,91184,87416
13269,GA,11004,30988,8887,11553,6130,5178,7398,30988,8823.455196,8272,11553,75818,12571,-8018,16339,12571,81138,88389,67800,92157,88389
13271,GA,9504,30988,8887,11553,6130,5178,7195,30988,8473.065278,8272,11553,73968,12571,-8018,16339,12571,79435,86539,65950,90307,86539
13273,GA,11628,30988,8887,11553,6130,5178,7482,27777,8919.016082,8272,10375,72150,11998,-9015,15502,11998,81846,84148,63135,87652,84148
13275,GA,11688,30988,8887,11553,6130,5178,7490,30825,9301.259629,8272,10049,75314,12571,-8018,16339,12571,81914,87885,67296,91653,87885
13277,GA,9936,30988,8887,11553,6130,5178,7254,31796,8982.72334,8272,10524,74689,12571,-8018,16339,12571,79926,87260,66671,91028,87260
13279,GA,9912,30988,8887,11553,6130,5178,7250,30432,8568.626165,8272,10138,72501,11998,-9015,15502,11998,79898,84499,63486,88003,84499
13281,GA,10188,30988,8887,11553,6130,5178,7288,30988,9301.259629,8272,11553,75480,12571,-8018,16339,12571,80212,88051,67462,91819,88051
13283,GA,9504,30988,8887,11553,6130,5178,7195,30988,8536.772536,8272,11553,74032,12571,-8018,16339,12571,79435,86603,66014,90371,86603
13285,GA,11472,30988,8887,11553,6130,5178,7461,30167,9396.820515,8272,11089,75575,12571,-8018,16339,12571,81669,88146,67557,91914,88146
13287,GA,9504,30988,8887,11553,6130,5178,7195,30988,8696.04068,8272,11553,74191,12571,-8018,16339,12571,79435,86762,66173,90530,86762
13289,GA,12096,30988,8887,11553,6130,5178,7546,32322,8632.333423,8272,11019,77520,13274,-6742,17156,13274,82378,90794,70778,94676,90794
13291,GA,11244,30988,8887,11553,6130,5178,7430,30988,9587.942289,8272,11553,76823,13274,-6742,17156,13274,81410,90097,70081,93979,90097
13293,GA,11244,30988,8887,11553,6130,5178,7430,28931,8568.626165,8272,10226,72420,11998,-9015,15502,11998,81410,84418,63405,87922,84418
13295,GA,11076,30988,8887,11553,6130,5178,7408,29037,9046.430598,8272,11132,73741,11998,-9015,15502,11998,81220,85739,64726,89243,85739
13297,GA,14244,30988,8887,11553,6130,5178,7836,31123,9237.552371,8272,11815,79869,14197,-5096,18043,14197,84816,94066,74773,97912,94066
13299,GA,9564,30988,8887,11553,6130,5178,7203,29967,8250.089876,8272,10148,71379,11998,-9015,15502,11998,79503,83377,62364,86881,83377
13301,GA,11244,30988,8887,11553,6130,5178,7430,30988,8727.894309,8272,11553,75963,13274,-6742,17156,13274,81410,89237,69221,93119,89237
13303,GA,9972,30988,8887,11553,6130,5178,7258,30988,8536.772536,8272,11553,74500,12571,-8018,16339,12571,79966,87071,66482,90839,87071
13305,GA,9540,30988,8887,11553,6130,5178,7200,31872,8473.065278,8272,10382,73717,12571,-8018,16339,12571,79476,86288,65699,90056,86288
13307,GA,9504,30988,8887,11553,6130,5178,7195,30988,8887.162454,8272,11553,74382,12571,-8018,16339,12571,79435,86953,66364,90721,86953
13309,GA,11004,30988,8887,11553,6130,5178,7398,30988,8568.626165,8272,11553,75564,12571,-8018,16339,12571,81138,88135,67546,91903,88135
13311,GA,10704,30988,8887,11553,6130,5178,7357,30988,9046.430598,8272,11553,75741,12571,-8018,16339,12571,80797,88312,67723,92080,88312
13313,GA,10740,30988,8887,11553,6130,5178,7362,31444,8186.382618,8272,10956,74776,12571,-8018,16339,12571,80838,87347,66758,91115,87347
13315,GA,9504,30988,8887,11553,6130,5178,7195,30988,8727.894309,8272,11553,74223,12571,-8018,16339,12571,79435,86794,66205,90562,86794
13317,GA,11244,30988,8887,11553,6130,5178,7430,30988,9428.674144,8272,11553,76664,13274,-6742,17156,13274,81410,89938,69922,93820,89938
13319,GA,9504,30988,8887,11553,6130,5178,7195,30988,8664.187051,8272,11553,74159,12571,-8018,16339,12571,79435,86730,66141,90498,86730
13321,GA,11628,30988,8887,11553,6130,5178,7482,32762,8409.358021,8272,10363,76612,13274,-6742,17156,13274,81846,89886,69870,93768,89886
15001,HI,15372,10381,10607,9970,4796,5250,10128,10453,11519.64068,8473,9980,61048,9608,-13497,11975,10055,66504,70656,47551,73023,71103
15003,HI,32184,10381,10607,9970,4796,5250,12603,14714,11747.75238,8473,11530,83899,17586,187,21807,18033,85791,101485,84086,105706,101932
15005,HI,10128,10381,10607,9970,4796,5250,9356,9043,11785.77099,8473,10894,55574,7757,-16523,9331,8203,60488,63331,39051,64905,63777
15007,HI,26076,10381,10607,9970,4796,5250,11703,11933,10873.32421,8473,10926,73531,13316,-7250,17267,13763,78783,86847,66281,90798,87294
15009,HI,20868,10381,10607,9970,4796,5250,10937,13221,12508.1247,8473,11010,71330,12080,-9332,15503,12527,72809,83410,61998,86833,83857
16001,ID,12708,22807,10607,9970,5274,5250,8665,19786,11101.4359,8809,9923,67577,10566,-11716,13278,10566,75281,78143,55861,80855,78143
16003,ID,11268,22807,10607,9970,5274,5250,8448,22807,12241.99439,8809,9970,70346,11167,-10692,14143,11167,73624,81513,59654,84489,81513
16005,ID,11268,22807,10607,9970,5274,5250,8448,27114,10341.06358,8809,9781,72563,12369,-8644,15873,12369,73624,84932,63919,88436,84932
16007,ID,11268,22807,10607,9970,5274,5250,8448,22807,10759.26836,8809,9970,68863,11167,-10692,14143,11167,73624,80030,58171,83006,80030
16009,ID,10260,22807,10607,9970,5274,5250,8295,22807,11253.51037,8809,9970,68350,10566,-11716,13278,10566,72463,78916,56634,81628,78916
16011,ID,11268,22807,10607,9970,5274,5250,8448,19806,10379.0822,8809,10170,65683,9965,-12740,12413,9965,73624,75648,52943,78096,75648
16013,ID,15504,22807,10607,9970,5274,5250,9088,30327,15625.65122,8809,9962,85478,15603,-2966,19413,15603,78500,101081,82512,104891,101081
16015,ID,12708,22807,10607,9970,5274,5250,8665,20501,10721.24974,8809,9931,67920,10566,-11716,13278,10566,75281,78486,56204,81198,78486
16017,ID,12048,22807,10607,9970,5274,5250,8565,19051,12013.88269,8809,9107,66279,9965,-12740,12413,9965,74521,76244,53539,78692,76244
16019,ID,11172,22807,10607,9970,5274,5250,8433,19099,10074.93327,8809,10249,64655,9965,-12740,12413,9965,73513,74620,51915,77068,74620
16021,ID,9516,22807,10607,9970,5274,5250,8183,22807,12013.88269,8809,9970,68366,10566,-11716,13278,10566,71607,78932,56650,81644,78932
16023,ID,11100,22807,10607,9970,5274,5250,8422,25767,10265.02635,8809,10188,71379,11768,-9668,15008,11768,73430,83147,61711,86387,83147
16025,ID,10560,22807,10607,9970,5274,5250,8340,18893,10379.0822,8809,9964,63855,9965,-12740,12413,9965,72808,73820,51115,76268,73820
16027,ID,12708,22807,10607,9970,5274,5250,8665,19068,9960.877421,8809,9926,65722,10566,-11716,13278,10566,75281,76288,54006,79000,76288
16029,ID,10692,22807,10607,9970,5274,5250,8360,22807,10303.04497,8809,9970,67831,11167,-10692,14143,11167,72960,78998,57139,81974,78998
16031,ID,11268,22807,10607,9970,5274,5250,8448,19512,11253.51037,8809,9882,65974,9965,-12740,12413,9965,73624,75939,53234,78387,75939
16033,ID,11268,22807,10607,9970,5274,5250,8448,22807,10607.19389,8809,9970,68711,11167,-10692,14143,11167,73624,79878,58019,82854,79878
16035,ID,10524,22807,10607,9970,5274,5250,8335,22807,11291.52898,8809,9970,68652,10566,-11716,13278,10566,72767,79218,56936,81930,79218
16037,ID,10512,22807,10607,9970,5274,5250,8333,22807,12051.90131,8809,9970,69400,10566,-11716,13278,10566,72753,79966,57684,82678,79966
16039,ID,10932,22807,10607,9970,5274,5250,8397,24789,10683.23113,8809,9789,70252,11768,-9668,15008,11768,73237,82020,60584,85260,82020
16041,ID,11004,22807,10607,9970,5274,5250,8408,22326,10531.15666,8809,10403,68323,11167,-10692,14143,11167,73320,79490,57631,82466,79490
16043,ID,9612,22807,10607,9970,5274,5250,8197,21035,10987.38006,8809,9685,65378,9965,-12740,12413,9965,71717,75343,52638,77791,75343
16045,ID,11304,22807,10607,9970,5274,5250,8453,27747,10683.23113,8809,9918,73712,12369,-8644,15873,12369,73665,86081,65068,89585,86081
16047,ID,10752,22807,10607,9970,5274,5250,8370,22807,10265.02635,8809,9970,67853,11167,-10692,14143,11167,73030,79020,57161,81996,79020
16049,ID,10704,22807,10607,9970,5274,5250,8362,22807,11595.67791,8809,9970,69136,11167,-10692,14143,11167,72974,80303,58444,83279,80303
16051,ID,11172,22807,10607,9970,5274,5250,8433,23540,12051.90131,8809,10215,71037,11167,-10692,14143,11167,73513,82204,60345,85180,82204
16053,ID,11208,22807,10607,9970,5274,5250,8438,27669,10303.04497,8809,9785,73024,12369,-8644,15873,12369,73554,85393,64380,88897,85393
16055,ID,12864,22807,10607,9970,5274,5250,8689,19742,11101.4359,8809,9627,67393,10566,-11716,13278,10566,75461,77959,55677,80671,77959
16057,ID,11580,22807,10607,9970,5274,5250,8495,29779,11139.45452,8809,9364,75921,12970,-7619,16738,12970,73983,88891,68302,92659,88891
16059,ID,11268,22807,10607,9970,5274,5250,8448,22807,12584.16193,8809,9970,70688,11167,-10692,14143,11167,73624,81855,59996,84831,81855
16061,ID,11268,22807,10607,9970,5274,5250,8448,22807,11139.45452,8809,9970,69243,11167,-10692,14143,11167,73624,80410,58551,83386,80410
16063,ID,10380,22807,10607,9970,5274,5250,8313,21283,10341.06358,8809,9963,66026,10566,-11716,13278,10566,72601,76592,54310,79304,76592
16065,ID,11532,22807,10607,9970,5274,5250,8487,21164,11557.6593,8809,9682,67994,10566,-11716,13278,10566,73927,78560,56278,81272,78560
16067,ID,11268,22807,10607,9970,5274,5250,8448,21013,10150.9705,8809,9882,66374,10566,-11716,13278,10566,73624,76940,54658,79652,76940
16069,ID,10236,22807,10607,9970,5274,5250,8291,19904,13572.64595,8809,9432,67204,9965,-12740,12413,9965,72435,77169,54464,79617,77169
16071,ID,10992,22807,10607,9970,5274,5250,8406,22807,10341.06358,8809,9970,68169,11167,-10692,14143,11167,73306,79336,57477,82312,79336
16073,ID,12708,22807,10607,9970,5274,5250,8665,22577,10797.28698,8809,9925,70066,11167,-10692,14143,11167,75281,81233,59374,84209,81233
16075,ID,11004,22807,10607,9970,5274,5250,8408,26444,12318.03162,8809,9019,72844,11768,-9668,15008,11768,73320,84612,63176,87852,84612
16077,ID,11268,22807,10607,9970,5274,5250,8448,22807,10341.06358,8809,9970,68445,11167,-10692,14143,11167,73624,79612,57753,82588,79612
16079,ID,9840,22807,10607,9970,5274,5250,8232,22807,11253.51037,8809,9970,67930,10566,-11716,13278,10566,71980,78496,56214,81208,78496
16081,ID,11136,22807,10607,9970,5274,5250,8428,25219,10721.24974,8809,11040,72176,12369,-8644,15873,12369,73472,84545,63532,88049,84545
16083,ID,10428,22807,10607,9970,5274,5250,8321,20404,10188.98912,8809,9776,64855,9965,-12740,12413,9965,72657,74820,52115,77268,74820
16085,ID,12168,22807,10607,9970,5274,5250,8584,22807,10797.28698,8809,9970,69801,11167,-10692,14143,11167,74660,80968,59109,83944,80968
16087,ID,11268,22807,10607,9970,5274,5250,8448,22807,10150.9705,8809,9970,68255,11167,-10692,14143,11167,73624,79422,57563,82398,79422
17001,IL,10524,10892,9078,11236,6174,4891,9676,10406,8036.942611,6888,10816,51561,5966,-18760,6830,5966,62471,57527,32801,58391,57527
17003,IL,10572,10892,9078,11236,6174,4891,9684,11530,8329.786674,6888,10829,53041,5966,-18760,6830,5966,62527,59007,34281,59871,59007
17005,IL,10272,10892,9078,11236,6174,4891,9635,11732,8297.248444,6888,11175,53256,6494,-18232,7622,6494,62178,59750,35024,60878,59750
17007,IL,12348,10892,9078,11236,6174,4891,9978,9615,7613.945631,6888,11059,52416,5966,-18760,6830,5966,64597,58382,33656,59246,58382
17009,IL,11628,10892,9078,11236,6174,4891,9859,10892,7971.866152,6888,11236,53507,6494,-18232,7622,6494,63758,60001,35275,61129,60001
17011,IL,11028,10892,9078,11236,6174,4891,9760,11614,9240.857091,6888,11045,54707,6494,-18232,7622,6494,63059,61201,36475,62329,61201
17013,IL,12732,10892,9078,11236,6174,4891,10041,10866,8752.783653,6888,11180,55309,6494,-18232,7622,6494,65044,61803,37077,62931,61803
17015,IL,9516,10892,9078,11236,6174,4891,9510,10892,8069.48084,6888,11236,51492,5966,-18760,6830,5966,61297,57458,32732,58322,57458
17017,IL,9732,10892,9078,11236,6174,4891,9546,10892,8557.554278,6888,11236,52197,5966,-18760,6830,5966,61549,58163,33437,59027,58163
17019,IL,13332,10892,9078,11236,6174,4891,10140,9561,8948.013028,6888,10810,54430,6494,-18232,7622,6494,65743,60924,36198,62052,60924
17021,IL,10044,10892,9078,11236,6174,4891,9597,12055,7613.945631,6888,10592,52083,5966,-18760,6830,5966,61912,58049,33323,58913,58049
17023,IL,10416,10892,9078,11236,6174,4891,9659,10892,8102.019069,6888,11236,52425,5966,-18760,6830,5966,62346,58391,33665,59255,58391
17025,IL,9516,10892,9078,11236,6174,4891,9510,10892,7939.327923,6888,11236,51362,5966,-18760,6830,5966,61297,57328,32602,58192,57328
17027,IL,12732,10892,9078,11236,6174,4891,10041,11334,7548.869173,6888,11175,54569,7022,-17376,8414,7022,65044,61591,37193,62983,61591
17029,IL,11796,10892,9078,11236,6174,4891,9887,11237,8069.48084,6888,10041,52922,5966,-18760,6830,5966,63954,58888,34162,59752,58888
17031,IL,14976,10892,9078,11236,6174,4891,10412,12133,8622.630736,6888,12131,59642,8078,-15474,9998,8078,67659,67720,44168,69640,67720
17033,IL,11100,10892,9078,11236,6174,4891,9772,10892,8394.863132,6888,11236,53402,6494,-18232,7622,6494,63143,59896,35170,61024,59896
17035,IL,10356,10892,9078,11236,6174,4891,9649,10134,8036.942611,6888,10136,50443,5438,-19288,6038,5438,62276,55881,31155,56481,55881
17037,IL,14904,10892,9078,11236,6174,4891,10400,10738,9175.780633,6888,11989,58586,7550,-16425,9206,7550,67575,66136,42161,67792,66136
17039,IL,10008,10892,9078,11236,6174,4891,9591,11978,8655.168965,6888,11923,54343,6494,-18232,7622,6494,61870,60837,36111,61965,60837
17041,IL,10368,10892,9078,11236,6174,4891,9651,10892,8525.016049,6888,11236,52800,5966,-18760,6830,5966,62290,58766,34040,59630,58766
17043,IL,14976,10892,9078,11236,6174,4891,10412,12776,8980.551257,6888,12038,60550,8078,-15474,9998,8078,67659,68628,45076,70548,68628
17045,IL,10512,10892,9078,11236,6174,4891,9674,10892,8459.93959,6888,11236,52879,5966,-18760,6830,5966,62457,58845,34119,59709,58845
17047,IL,9516,10892,9078,11236,6174,4891,9510,10892,8817.860111,6888,11236,52241,5966,-18760,6830,5966,61297,58207,33481,59071,58207
17049,IL,11268,10892,9078,11236,6174,4891,9799,12444,7711.560319,6888,11265,54468,6494,-18232,7622,6494,63338,60962,36236,62090,60962
17051,IL,9516,10892,9078,11236,6174,4891,9510,10892,7223.486881,6888,11236,50646,5966,-18760,6830,5966,61297,56612,31886,57476,56612
17053,IL,13332,10892,9078,11236,6174,4891,10140,10480,8720.245424,6888,10863,55174,6494,-18232,7622,6494,65743,61668,36942,62796,61668
17055,IL,9516,10892,9078,11236,6174,4891,9510,10892,8882.93657,6888,11236,52306,5966,-18760,6830,5966,61297,58272,33546,59136,58272
17057,IL,9864,10892,9078,11236,6174,4891,9567,9211,7646.48386,6888,10530,49030,5438,-19288,6038,5438,61702,54468,29742,55068,54468
17059,IL,11268,10892,9078,11236,6174,4891,9799,10892,7971.866152,6888,11236,53147,6494,-18232,7622,6494,63338,59641,34915,60769,59641
17061,IL,9516,10892,9078,11236,6174,4891,9510,10892,8167.095528,6888,11236,51590,5966,-18760,6830,5966,61297,57556,32830,58420,57556
17063,IL,16032,10892,9078,11236,6174,4891,10586,11261,8850.398341,6888,11994,59916,8078,-15474,9998,8078,68889,67994,44442,69914,67994
17065,IL,9516,10892,9078,11236,6174,4891,9510,10892,8069.48084,6888,11236,51492,5966,-18760,6830,5966,61297,57458,32732,58322,57458
17067,IL,9516,10892,9078,11236,6174,4891,9510,10802,7874.251465,6888,10660,50632,5438,-19288,6038,5438,61297,56070,31344,56670,56070
17069,IL,9516,10892,9078,11236,6174,4891,9510,10892,7874.251465,6888,11236,51297,5966,-18760,6830,5966,61297,57263,32537,58127,57263
17071,IL,9540,10892,9078,11236,6174,4891,9514,10250,7841.713236,6888,10606,50016,5438,-19288,6038,5438,61325,55454,30728,56054,55454
17073,IL,11052,10892,9078,11236,6174,4891,9764,10569,7744.098548,6888,11006,52150,5966,-18760,6830,5966,63087,58116,33390,58980,58116
17075,IL,10764,10892,9078,11236,6174,4891,9716,10892,8915.474799,6888,11236,53586,5966,-18760,6830,5966,62751,59552,34826,60416,59552
17077,IL,10836,10892,9078,11236,6174,4891,9728,14522,8557.554278,6888,10014,55708,7022,-17376,8414,7022,62835,62730,38332,64122,62730
17079,IL,11268,10892,9078,11236,6174,4891,9799,10892,8232.171986,6888,11236,53407,6494,-18232,7622,6494,63338,59901,35175,61029,59901
17081,IL,10308,10892,9078,11236,6174,4891,9641,11571,7939.327923,6888,10526,52123,5966,-18760,6830,5966,62220,58089,33363,58953,58089
17083,IL,12732,10892,9078,11236,6174,4891,10041,12761,8915.474799,6888,11177,57364,7022,-17376,8414,7022,65044,64386,39988,65778,64386
17085,IL,10152,10892,9078,11236,6174,4891,9615,10892,9696.3923,6888,11236,53755,5966,-18760,6830,5966,62038,59721,34995,60585,59721
17087,IL,9516,10892,9078,11236,6174,4891,9510,10892,8199.633757,6888,11236,51623,5966,-18760,6830,5966,61297,57589,32863,58453,57589
17089,IL,14976,10892,9078,11236,6174,4891,10412,11039,8427.401361,6888,12004,58226,7550,-16425,9206,7550,67659,65776,41801,67432,65776
17091,IL,12804,10892,9078,11236,6174,4891,10053,10171,8720.245424,6888,11075,54549,6494,-18232,7622,6494,65128,61043,36317,62171,61043
17093,IL,17664,10892,9078,11236,6174,4891,10856,11232,8036.942611,6888,11967,60679,8078,-15474,9998,8078,70791,68757,45205,70677,68757
17095,IL,9516,10892,9078,11236,6174,4891,9510,11402,8232.171986,6888,10157,51087,5438,-19288,6038,5438,61297,56525,31799,57125,56525
17097,IL,14976,10892,9078,11236,6174,4891,10412,9084,9240.857091,6888,12005,57085,7022,-17376,8414,7022,67659,64107,39709,65499,64107
17099,IL,12576,10892,9078,11236,6174,4891,10015,12529,8102.019069,6888,11035,56021,7022,-17376,8414,7022,64862,63043,38645,64435,63043
17101,IL,11268,10892,9078,11236,6174,4891,9799,10892,8752.783653,6888,11236,53928,6494,-18232,7622,6494,63338,60422,35696,61550,60422
17103,IL,10884,10892,9078,11236,6174,4891,9736,10248,7744.098548,6888,10883,51538,5966,-18760,6830,5966,62891,57504,32778,58368,57504
17105,IL,11040,10892,9078,11236,6174,4891,9762,10017,7646.48386,6888,10791,51274,5966,-18760,6830,5966,63073,57240,32514,58104,57240
17107,IL,10668,10892,9078,11236,6174,4891,9700,9991,7679.02209,6888,10059,50176,5438,-19288,6038,5438,62639,55614,30888,56214,55614
17109,IL,10644,10892,9078,11236,6174,4891,9696,11953,8004.404382,6888,9723,52103,5966,-18760,6830,5966,62611,58069,33343,58933,58069
17111,IL,14976,10892,9078,11236,6174,4891,10412,10299,8850.398341,6888,11974,57879,7550,-16425,9206,7550,67659,65429,41454,67085,65429
17113,IL,14604,10892,9078,11236,6174,4891,10350,10170,8817.860111,6888,11946,57317,7022,-17376,8414,7022,67225,64339,39941,65731,64339
17115,IL,11424,10892,9078,11236,6174,4891,9825,10088,8102.019069,6888,10649,52043,5966,-18760,6830,5966,63520,58009,33283,58873,58009
17117,IL,11112,10892,9078,11236,6174,4891,9774,11116,9143.242403,6888,11176,54326,6494,-18232,7622,6494,63157,60820,36094,61948,60820
17119,IL,12732,10892,9078,11236,6174,4891,10041,10502,8459.93959,6888,11167,54640,6494,-18232,7622,6494,65044,61134,36408,62262,61134
17121,IL,10872,10892,9078,11236,6174,4891,9734,10948,8687.707195,6888,10492,52779,5966,-18760,6830,5966,62877,58745,34019,59609,58745
17123,IL,11244,10892,9078,11236,6174,4891,9795,11430,8362.324903,6888,11064,53880,6494,-18232,7622,6494,63310,60374,35648,61502,60374
17125,IL,9516,10892,9078,11236,6174,4891,9510,10892,8394.863132,6888,11236,51818,5966,-18760,6830,5966,61297,57784,33058,58648,57784
17127,IL,10032,10892,9078,11236,6174,4891,9595,10771,8102.019069,6888,10578,51261,5966,-18760,6830,5966,61898,57227,32501,58091,57227
17129,IL,11664,10892,9078,11236,6174,4891,9865,11624,8557.554278,6888,11104,54728,6494,-18232,7622,6494,63800,61222,36496,62350,61222
17131,IL,11052,10892,9078,11236,6174,4891,9764,10300,8427.401361,6888,11012,52571,5966,-18760,6830,5966,63087,58537,33811,59401,58537
17133,IL,12732,10892,9078,11236,6174,4891,10041,11481,9501.162924,6888,11173,56667,7022,-17376,8414,7022,65044,63689,39291,65081,63689
17135,IL,10176,10892,9078,11236,6174,4891,9619,10892,7451.254485,6888,11236,51534,5966,-18760,6830,5966,62066,57500,32774,58364,57500
17137,IL,9732,10892,9078,11236,6174,4891,9546,10269,7679.02209,6888,10696,50155,5438,-19288,6038,5438,61549,55593,30867,56193,55593
17139,IL,10716,10892,9078,11236,6174,4891,9708,10892,8167.095528,6888,11236,52790,5966,-18760,6830,5966,62695,58756,34030,59620,58756
17141,IL,11772,10892,9078,11236,6174,4891,9883,12958,7613.945631,6888,11244,55366,7022,-17376,8414,7022,63926,62388,37990,63780,62388
17143,IL,11244,10892,9078,11236,6174,4891,9795,10888,8492.477819,6888,11036,53439,6494,-18232,7622,6494,63310,59933,35207,61061,59933
17145,IL,9612,10892,9078,11236,6174,4891,9526,10892,8687.707195,6888,11236,52207,5966,-18760,6830,5966,61409,58173,33447,59037,58173
17147,IL,13332,10892,9078,11236,6174,4891,10140,11158,8655.168965,6888,10867,55792,7022,-17376,8414,7022,65743,62814,38416,64206,62814
17149,IL,10020,10892,9078,11236,6174,4891,9593,10892,7874.251465,6888,11236,51801,5966,-18760,6830,5966,61884,57767,33041,58631,57767
17151,IL,11268,10892,9078,11236,6174,4891,9799,10892,8036.942611,6888,11236,53212,6494,-18232,7622,6494,63338,59706,34980,60834,59706
17153,IL,9516,10892,9078,11236,6174,4891,9510,10892,8199.633757,6888,11236,51623,5966,-18760,6830,5966,61297,57589,32863,58453,57589
17155,IL,9756,10892,9078,11236,6174,4891,9550,11304,8167.095528,6888,11050,52056,5966,-18760,6830,5966,61577,58022,33296,58886,58022
17157,IL,10548,10892,9078,11236,6174,4891,9680,10892,7321.101569,6888,11236,51776,5966,-18760,6830,5966,62499,57742,33016,58606,57742
17159,IL,10908,10892,9078,11236,6174,4891,9740,10892,8752.783653,6888,11236,53568,5966,-18760,6830,5966,62919,59534,34808,60398,59534
17161,IL,11052,10892,9078,11236,6174,4891,9764,10107,8394.863132,6888,10979,52312,5966,-18760,6830,5966,63087,58278,33552,59142,58278
17163,IL,12732,10892,9078,11236,6174,4891,10041,10917,8492.477819,6888,11164,55085,6494,-18232,7622,6494,65044,61579,36853,62707,61579
17165,IL,11004,10892,9078,11236,6174,4891,9756,10892,7679.02209,6888,11236,52590,5966,-18760,6830,5966,63031,58556,33830,59420,58556
17167,IL,11664,10892,9078,11236,6174,4891,9865,10112,8817.860111,6888,11082,53455,5966,-18760,6830,5966,63800,59421,34695,60285,59421
17169,IL,11268,10892,9078,11236,6174,4891,9799,10892,7971.866152,6888,11236,53147,6494,-18232,7622,6494,63338,59641,34915,60769,59641
17171,IL,10608,10892,9078,11236,6174,4891,9690,11039,7874.251465,6888,10754,52054,5966,-18760,6830,5966,62569,58020,33294,58884,58020
17173,IL,9516,10892,9078,11236,6174,4891,9510,10892,8329.786674,6888,11236,51753,5966,-18760,6830,5966,61297,57719,32993,58583,57719
17175,IL,11244,10892,9078,11236,6174,4891,9795,10570,8329.786674,6888,11071,52993,5966,-18760,6830,5966,63310,58959,34233,59823,58959
17177,IL,9756,10892,9078,11236,6174,4891,9550,11719,8167.095528,6888,10593,52014,5966,-18760,6830,5966,61577,57980,33254,58844,57980
17179,IL,11244,10892,9078,11236,6174,4891,9795,11648,8492.477819,6888,11047,54211,6494,-18232,7622,6494,63310,60705,35979,61833,60705
17181,IL,10104,10892,9078,11236,6174,4891,9607,10892,8329.786674,6888,11236,52341,5966,-18760,6830,5966,61982,58307,33581,59171,58307
17183,IL,10836,10892,9078,11236,6174,4891,9728,12318,7646.48386,6888,10574,53153,6494,-18232,7622,6494,62835,59647,34921,60775,59647
17185,IL,9744,10892,9078,11236,6174,4891,9548,10892,8817.860111,6888,11236,52469,5966,-18760,6830,5966,61563,58435,33709,59299,58435
17187,IL,12156,10892,9078,11236,6174,4891,9946,10892,8069.48084,6888,11236,54132,6494,-18232,7622,6494,64373,60626,35900,61754,60626
17189,IL,10272,10892,9078,11236,6174,4891,9635,10892,8199.633757,6888,11236,52379,5966,-18760,6830,5966,62178,58345,33619,59209,58345
17191,IL,10368,10892,9078,11236,6174,4891,9651,10892,8394.863132,6888,11236,52670,5966,-18760,6830,5966,62290,58636,33910,59500,58636
17193,IL,9564,10892,9078,11236,6174,4891,9518,10892,8427.401361,6888,11236,51898,5966,-18760,6830,5966,61353,57864,33138,58728,57864
17195,IL,10224,10892,9078,11236,6174,4891,9627,10443,8036.942611,6888,10873,51357,5966,-18760,6830,5966,62122,57323,32597,58187,57323
17197,IL,14976,10892,9078,11236,6174,4891,10412,11416,8752.783653,6888,11989,58912,7550,-16425,9206,7550,67659,66462,42487,68118,66462
17199,IL,11016,10892,9078,11236,6174,4891,9758,12484,8036.942611,6888,10039,53355,6494,-18232,7622,6494,63045,59849,35123,60977,59849
17201,IL,12348,10892,9078,11236,6174,4891,9978,11168,8167.095528,6888,11056,54518,6494,-18232,7622,6494,64597,61012,36286,62140,61012
17203,IL,11244,10892,9078,11236,6174,4891,9795,10640,9273.39532,6888,11062,53999,5966,-18760,6830,5966,63310,59965,35239,60829,59965
18001,IN,9960,5216,9078,11236,5992,4891,8056,4911,8427.401361,9744,11149,49083,5090,-19636,5558,5090,54429,54173,29447,54641,54173
18003,IN,10248,5216,9078,11236,5992,4891,8099,5777,8362.324903,9744,11072,50094,5350,-19376,5950,5350,54760,55444,30718,56044,55444
18005,IN,13044,5216,9078,11236,5992,4891,8516,5090,8199.633757,9744,11312,52281,5869,-18857,6733,5869,57973,58150,33424,59014,58150
18007,IN,12252,5216,9078,11236,5992,4891,8398,4882,8232.171986,9744,10845,50845,5350,-19376,5950,5350,57063,56195,31469,56795,56195
18009,IN,9360,5216,9078,11236,5992,4891,7966,5216,7939.327923,9744,11236,48386,5090,-19636,5558,5090,53739,53476,28750,53944,53476
18011,IN,12432,5216,9078,11236,5992,4891,8424,6019,8329.786674,9744,11219,52635,5869,-18857,6733,5869,57269,58504,33778,59368,58504
18013,IN,12432,5216,9078,11236,5992,4891,8424,5007,8394.863132,9744,11220,51689,5869,-18857,6733,5869,57269,57558,32832,58422,57558
18015,IN,10740,5216,9078,11236,5992,4891,8172,5347,8882.93657,9744,10838,50443,5350,-19376,5950,5350,55325,55793,31067,56393,55793
18017,IN,9360,5216,9078,11236,5992,4891,7966,4527,7353.639798,9744,10784,46660,4831,-19895,5167,4831,53739,51491,26765,51827,51491
18019,IN,11712,5216,9078,11236,5992,4891,8317,5070,8102.019069,9744,11027,50546,5350,-19376,5950,5350,56442,55896,31170,56496,55896
18021,IN,10908,5216,9078,11236,5992,4891,8197,5297,7093.333964,9744,10664,48598,5350,-19376,5950,5350,55518,53948,29222,54548,53948
18023,IN,10224,5216,9078,11236,5992,4891,8095,5010,7190.948652,9744,11305,48365,5350,-19376,5950,5350,54732,53715,28989,54315,53715
18025,IN,9360,5216,9078,11236,5992,4891,7966,5216,8492.477819,9744,11236,48939,5090,-19636,5558,5090,53739,54029,29303,54497,54029
18027,IN,10788,5216,9078,11236,5992,4891,8179,4747,8850.398341,9744,11252,50272,5350,-19376,5950,5350,55380,55622,30896,56222,55622
18029,IN,12216,5216,9078,11236,5992,4891,8392,6066,7744.098548,9744,11261,51923,5869,-18857,6733,5869,57021,57792,33066,58656,57792
18031,IN,10356,5216,9078,11236,5992,4891,8115,5152,7353.639798,9744,11053,48550,5350,-19376,5950,5350,54884,53900,29174,54500,53900
18033,IN,10692,5216,9078,11236,5992,4891,8165,5401,8622.630736,9744,11005,50355,5350,-19376,5950,5350,55270,55705,30979,56305,55705
18035,IN,10524,5216,9078,11236,5992,4891,8140,5042,8004.404382,9744,9967,48173,5090,-19636,5558,5090,55077,53263,28537,53731,53263
18037,IN,11064,5216,9078,11236,5992,4891,8220,5289,8948.013028,9744,11306,51242,5350,-19376,5950,5350,55697,56592,31866,57192,56592
18039,IN,11532,5216,9078,11236,5992,4891,8290,5280,7776.636777,9744,11245,50469,5350,-19376,5950,5350,56235,55819,31093,56419,55819
18041,IN,9900,5216,9078,11236,5992,4891,8047,5260,8232.171986,9744,9889,47916,4831,-19895,5167,4831,54360,52747,28021,53083,52747
18043,IN,11712,5216,9078,11236,5992,4891,8317,4723,8394.863132,9744,11029,50494,5350,-19376,5950,5350,56442,55844,31118,56444,55844
18045,IN,10620,5216,9078,11236,5992,4891,8154,5216,8329.786674,9744,11236,50037,5350,-19376,5950,5350,55187,55387,30661,55987,55387
18047,IN,12216,5216,9078,11236,5992,4891,8392,5216,8850.398341,9744,11236,52153,5869,-18857,6733,5869,57021,58022,33296,58886,58022
18049,IN,9756,5216,9078,11236,5992,4891,8025,5216,8557.554278,9744,11236,49401,5090,-19636,5558,5090,54194,54491,29765,54959,54491
18051,IN,10056,5216,9078,11236,5992,4891,8070,5216,8915.474799,9744,11236,50058,5350,-19376,5950,5350,54539,55408,30682,56008,55408
18053,IN,9936,5216,9078,11236,5992,4891,8052,5744,7809.175006,9744,9926,48050,5090,-19636,5558,5090,54401,53140,28414,53608,53140
18055,IN,9360,5216,9078,11236,5992,4891,7966,5216,8590.092507,9744,11236,49037,5090,-19636,5558,5090,53739,54127,29401,54595,54127
18057,IN,12432,5216,9078,11236,5992,4891,8424,5019,9989.236362,9744,11219,53295,5869,-18857,6733,5869,57269,59164,34438,60028,59164
18059,IN,12432,5216,9078,11236,5992,4891,8424,5268,8134.557298,9744,11219,51689,5869,-18857,6733,5869,57269,57558,32832,58422,57558
18061,IN,11712,5216,9078,11236,5992,4891,8317,4421,8329.786674,9744,11042,50140,5350,-19376,5950,5350,56442,55490,30764,56090,55490
18063,IN,12432,5216,9078,11236,5992,4891,8424,4996,8590.092507,9744,11219,51872,5869,-18857,6733,5869,57269,57741,33015,58605,57741
18065,IN,9552,5216,9078,11236,5992,4891,7995,4606,7516.330944,9744,10431,46740,4831,-19895,5167,4831,53960,51571,26845,51907,51571
18067,IN,10656,5216,9078,11236,5992,4891,8160,5645,8004.404382,9744,10421,49361,5350,-19376,5950,5350,55229,54711,29985,55311,54711
18069,IN,9924,5216,9078,11236,5992,4891,8050,5028,7483.792714,9744,10976,48047,5090,-19636,5558,5090,54387,53137,28411,53605,53137
18071,IN,10920,5216,9078,11236,5992,4891,8199,4788,7321.101569,9744,10951,48615,5350,-19376,5950,5350,55532,53965,29239,54565,53965
18073,IN,10332,5216,9078,11236,5992,4891,8111,4775,8850.398341,9744,11960,50553,5350,-19376,5950,5350,54856,55903,31177,56503,55903
18075,IN,10452,5216,9078,11236,5992,4891,8129,5216,8167.095528,9744,11236,49706,5350,-19376,5950,5350,54994,55056,30330,55656,55056
18077,IN,10260,5216,9078,11236,5992,4891,8100,5136,7483.792714,9744,10582,48097,5090,-19636,5558,5090,54773,53187,28461,53655,53187
18079,IN,10464,5216,9078,11236,5992,4891,8131,5169,8362.324903,9744,10845,49476,5350,-19376,5950,5350,55008,54826,30100,55426,54826
18081,IN,12432,5216,9078,11236,5992,4891,8424,5405,8492.477819,9744,11219,52184,5869,-18857,6733,5869,57269,58053,33327,58917,58053
18083,IN,9372,5216,9078,11236,5992,4891,7968,5458,8850.398341,9744,10617,48932,5090,-19636,5558,5090,53753,54022,29296,54490,54022
18085,IN,10464,5216,9078,11236,5992,4891,8131,5238,7874.251465,9744,11184,49395,5350,-19376,5950,5350,55008,54745,30019,55345,54745
18087,IN,9876,5216,9078,11236,5992,4891,8043,5216,8850.398341,9744,11236,49813,5350,-19376,5950,5350,54332,55163,30437,55763,55163
18089,IN,12072,5216,9078,11236,5992,4891,8371,4751,8102.019069,9744,11998,51558,5869,-18857,6733,5869,56856,57427,32701,58291,57427
18091,IN,11424,5216,9078,11236,5992,4891,8274,5012,7906.789694,9744,10664,49642,5350,-19376,5950,5350,56111,54992,30266,55592,54992
18093,IN,10212,5216,9078,11236,5992,4891,8093,4760,7386.178027,9744,10572,47566,5090,-19636,5558,5090,54718,52656,27930,53124,52656
18095,IN,10836,5216,9078,11236,5992,4891,8186,5048,8167.095528,9744,11217,49903,5350,-19376,5950,5350,55435,55253,30527,55853,55253
18097,IN,12432,5216,9078,11236,5992,4891,8424,6765,8329.786674,9744,11218,53380,6388,-18338,7516,6388,57269,59768,35042,60896,59768
18099,IN,10056,5216,9078,11236,5992,4891,8070,4863,7483.792714,9744,11015,48053,5090,-19636,5558,5090,54539,53143,28417,53611,53143
18101,IN,11064,5216,9078,11236,5992,4891,8220,5216,8199.633757,9744,11236,50351,5350,-19376,5950,5350,55697,55701,30975,56301,55701
18103,IN,10404,5216,9078,11236,5992,4891,8122,4948,7256.02511,9744,10706,47949,5090,-19636,5558,5090,54939,53039,28313,53507,53039
18105,IN,13044,5216,9078,11236,5992,4891,8516,5518,9110.704174,9744,10496,52804,5869,-18857,6733,5869,57973,58673,33947,59537,58673
18107,IN,11652,5216,9078,11236,5992,4891,8308,5616,8622.630736,9744,10929,51455,5350,-19376,5950,5350,56373,56805,32079,57405,56805
18109,IN,12432,5216,9078,11236,5992,4891,8424,4865,8720.245424,9744,11219,51871,5869,-18857,6733,5869,57269,57740,33014,58604,57740
18111,IN,12072,5216,9078,11236,5992,4891,8371,4894,8199.633757,9744,11945,51745,5869,-18857,6733,5869,56856,57614,32888,58478,57614
18113,IN,9516,5216,9078,11236,5992,4891,7989,5071,8459.93959,9744,11053,48735,5090,-19636,5558,5090,53918,53825,29099,54293,53825
18115,IN,12216,5216,9078,11236,5992,4891,8392,5245,8720.245424,9744,11262,52079,5869,-18857,6733,5869,57021,57948,33222,58812,57948
18117,IN,10236,5216,9078,11236,5992,4891,8097,5216,8102.019069,9744,11236,49425,5350,-19376,5950,5350,54746,54775,30049,55375,54775
18119,IN,9624,5216,9078,11236,5992,4891,8006,4920,9208.318862,9744,10548,48935,4831,-19895,5167,4831,54043,53766,29040,54102,53766
18121,IN,10212,5216,9078,11236,5992,4891,8093,5216,7939.327923,9744,11236,49238,5350,-19376,5950,5350,54718,54588,29862,55188,54588
18123,IN,10656,5216,9078,11236,5992,4891,8160,5216,8492.477819,9744,11236,50235,5350,-19376,5950,5350,55229,55585,30859,56185,55585
18125,IN,11064,5216,9078,11236,5992,4891,8220,6764,8622.630736,9744,11305,52391,5869,-18857,6733,5869,55697,58260,33534,59124,58260
18127,IN,12072,5216,9078,11236,5992,4891,8371,5236,8687.707195,9744,11967,52598,5869,-18857,6733,5869,56856,58467,33741,59331,58467
18129,IN,11292,5216,9078,11236,5992,4891,8254,4683,9240.857091,9744,10940,50791,5350,-19376,5950,5350,55959,56141,31415,56741,56141
18131,IN,9756,5216,9078,11236,5992,4891,8025,5216,7744.098548,9744,11236,48587,5090,-19636,5558,5090,54194,53677,28951,54145,53677
18133,IN,11064,5216,9078,11236,5992,4891,8220,5957,7451.254485,9744,11219,50325,5350,-19376,5950,5350,55697,55675,30949,56275,55675
18135,IN,10464,5216,9078,11236,5992,4891,8131,5216,6963.181047,9744,11236,48514,5350,-19376,5950,5350,55008,53864,29138,54464,53864
18137,IN,9420,5216,9078,11236,5992,4891,7975,5216,9143.242403,9744,11236,49650,5090,-19636,5558,5090,53808,54740,30014,55208,54740
18139,IN,9648,5216,9078,11236,5992,4891,8009,5216,8069.48084,9744,11236,48804,5090,-19636,5558,5090,54070,53894,29168,54362,53894
18141,IN,10740,5216,9078,11236,5992,4891,8172,5666,8232.171986,9744,10810,50083,5350,-19376,5950,5350,55325,55433,30707,56033,55433
18143,IN,10632,5216,9078,11236,5992,4891,8156,4811,8655.168965,9744,11030,49763,5350,-19376,5950,5350,55201,55113,30387,55713,55113
18145,IN,12432,5216,9078,11236,5992,4891,8424,5214,7613.945631,9744,11219,51114,5869,-18857,6733,5869,57269,56983,32257,57847,56983
18147,IN,9360,5216,9078,11236,5992,4891,7966,5216,8980.551257,9744,11236,49428,5090,-19636,5558,5090,53739,54518,29792,54986,54518
18149,IN,9936,5216,9078,11236,5992,4891,8052,5216,9143.242403,9744,11236,50166,5350,-19376,5950,5350,54401,55516,30790,56116,55516
18151,IN,10104,5216,9078,11236,5992,4891,8077,5824,7679.02209,9744,10948,49189,5350,-19376,5950,5350,54594,54539,29813,55139,54539
18153,IN,11028,5216,9078,11236,5992,4891,8215,5450,9013.089487,9744,10675,50802,5350,-19376,5950,5350,55656,56152,31426,56752,56152
18155,IN,11064,5216,9078,11236,5992,4891,8220,5216,8329.786674,9744,11236,50481,5350,-19376,5950,5350,55697,55831,31105,56431,55831
18157,IN,12252,5216,9078,11236,5992,4891,8398,4877,8427.401361,9744,10808,50999,5350,-19376,5950,5350,57063,56349,31623,56949,56349
18159,IN,10656,5216,9078,11236,5992,4891,8160,5216,8915.474799,9744,11236,50658,5350,-19376,5950,5350,55229,56008,31282,56608,56008
18161,IN,11064,5216,9078,11236,5992,4891,8220,6147,8622.630736,9744,11262,51731,5869,-18857,6733,5869,55697,57600,32874,58464,57600
18163,IN,11292,5216,9078,11236,5992,4891,8254,5490,8427.401361,9744,10913,50757,5350,-19376,5950,5350,55959,56107,31381,56707,56107
18165,IN,10908,5216,9078,11236,5992,4891,8197,5847,7874.251465,9744,10677,49941,5350,-19376,5950,5350,55518,55291,30565,55891,55291
18167,IN,10908,5216,9078,11236,5992,4891,8197,6174,8102.019069,9744,10617,50436,5350,-19376,5950,5350,55518,55786,31060,56386,55786
18169,IN,9360,5216,9078,11236,5992,4891,7966,4733,8459.93959,9744,10668,47856,4831,-19895,5167,4831,53739,52687,27961,53023,52687
18171,IN,10224,5216,9078,11236,5992,4891,8095,5216,8329.786674,9744,11236,49641,5350,-19376,5950,5350,54732,54991,30265,55591,54991
18173,IN,11292,5216,9078,11236,5992,4891,8254,5908,9338.471779,9744,10939,52113,5350,-19376,5950,5350,55959,57463,32737,58063,57463
18175,IN,10572,5216,9078,11236,5992,4891,8147,5464,9631.315841,9744,11038,51341,5350,-19376,5950,5350,55132,56691,31965,57291,56691
18177,IN,10104,5216,9078,11236,5992,4891,8077,4716,7809.175006,9744,9905,47169,4831,-19895,5167,4831,54594,52000,27274,52336,52000
18179,IN,10248,5216,9078,11236,5992,4891,8099,5047,8329.786674,9744,11074,49334,5350,-19376,5950,5350,54760,54684,29958,55284,54684
18181,IN,10212,5216,9078,11236,5992,4891,8093,5216,8362.324903,9744,11236,49661,5350,-19376,5950,5350,54718,55011,30285,55611,55011
18183,IN,10248,5216,9078,11236,5992,4891,8099,4522,7483.792714,9744,11078,47966,5090,-19636,5558,5090,54760,53056,28330,53524,53056
19001,IA,10356,5420,9078,11236,5733,4891,10564,5420,8817.860111,9348,11236,50069,6563,-18163,7163,6563,57278,56632,31906,57232,56632
19003,IA,9324,5420,9078,11236,5733,4891,10371,5420,8297.248444,9348,11236,48516,6257,-18469,6725,6257,56053,54773,30047,55241,54773
19005,IA,10236,5420,9078,11236,5733,4891,10541,5420,8167.095528,9348,11236,49298,6563,-18163,7163,6563,57135,55861,31135,56461,55861
19007,IA,8808,5420,9078,11236,5733,4891,10274,5420,7516.330944,9348,11236,47219,5955,-18771,6291,5955,55440,53174,28448,53510,53174
19009,IA,8652,5420,9078,11236,5733,4891,10245,5420,8557.554278,9348,11236,48105,5955,-18771,6291,5955,55255,54060,29334,54396,54060
19011,IA,9024,5420,9078,11236,5733,4891,10315,5828,8590.092507,9348,11327,49008,6257,-18469,6725,6257,55697,55265,30539,55733,55265
19013,IA,11484,5420,9078,11236,5733,4891,10775,5499,8362.324903,9348,11016,50600,6563,-18163,7163,6563,58617,57163,32437,57763,57163
19015,IA,9876,5420,9078,11236,5733,4891,10474,5288,8459.93959,9348,11082,48945,6257,-18469,6725,6257,56708,55202,30476,55670,55202
19017,IA,10656,5420,9078,11236,5733,4891,10620,6916,8752.783653,9348,11026,51590,6563,-18163,7163,6563,57634,58153,33427,58753,58153
19019,IA,9000,5420,9078,11236,5733,4891,10310,5420,8752.783653,9348,11236,48648,5955,-18771,6291,5955,55668,54603,29877,54939,54603
19021,IA,9216,5420,9078,11236,5733,4891,10350,5488,8297.248444,9348,11125,48365,6257,-18469,6725,6257,55924,54622,29896,55090,54622
19023,IA,10236,5420,9078,11236,5733,4891,10541,5420,8394.863132,9348,11236,49526,6563,-18163,7163,6563,57135,56089,31363,56689,56089
19025,IA,9408,5420,9078,11236,5733,4891,10386,5420,8167.095528,9348,11236,48470,6257,-18469,6725,6257,56152,54727,30001,55195,54727
19027,IA,8652,5420,9078,11236,5733,4891,10245,5420,8850.398341,9348,11236,48397,5955,-18771,6291,5955,55255,54352,29626,54688,54352
19029,IA,9408,5420,9078,11236,5733,4891,10386,5420,8232.171986,9348,11236,48535,6257,-18469,6725,6257,56152,54792,30066,55260,54792
19031,IA,9864,5420,9078,11236,5733,4891,10472,5420,8622.630736,9348,11236,49382,6257,-18469,6725,6257,56694,55639,30913,56107,55639
19033,IA,10452,5420,9078,11236,5733,4891,10582,5936,8362.324903,9348,10611,49600,6563,-18163,7163,6563,57392,56163,31437,56763,56163
19035,IA,8652,5420,9078,11236,5733,4891,10245,5420,8492.477819,9348,11236,48039,5955,-18771,6291,5955,55255,53994,29268,54330,53994
19037,IA,10236,5420,9078,11236,5733,4891,10541,5420,8459.93959,9348,11236,49591,6563,-18163,7163,6563,57135,56154,31428,56754,56154
19039,IA,9576,5420,9078,11236,5733,4891,10418,5420,8687.707195,9348,11236,49159,6257,-18469,6725,6257,56352,55416,30690,55884,55416
19041,IA,9384,5420,9078,11236,5733,4891,10382,5601,8622.630736,9348,10865,48712,6257,-18469,6725,6257,56124,54969,30243,55437,54969
19043,IA,9792,5420,9078,11236,5733,4891,10458,5420,8394.863132,9348,11236,49082,6257,-18469,6725,6257,56608,55339,30613,55807,55339
19045,IA,9492,5420,9078,11236,5733,4891,10402,5231,8036.942611,9348,10947,47946,5955,-18771,6291,5955,56252,53901,29175,54237,53901
19047,IA,8964,5420,9078,11236,5733,4891,10303,5420,8427.401361,9348,11236,48286,5955,-18771,6291,5955,55625,54241,29515,54577,54241
19049,IA,13080,5420,9078,11236,5733,4891,11074,5029,9013.089487,9348,11905,53266,7174,-17552,8038,7174,60512,60440,35714,61304,60440
19051,IA,9300,5420,9078,11236,5733,4891,10366,5308,7776.636777,9348,10686,47309,5955,-18771,6291,5955,56024,53264,28538,53600,53264
19053,IA,10236,5420,9078,11236,5733,4891,10541,5420,8069.48084,9348,11236,49200,6563,-18163,7163,6563,57135,55763,31037,56363,55763
19055,IA,10104,5420,9078,11236,5733,4891,10517,5420,8492.477819,9348,11236,49491,6563,-18163,7163,6563,56979,56054,31328,56654,56054
19057,IA,10188,5420,9078,11236,5733,4891,10532,4985,8134.557298,9348,10511,48057,6257,-18469,6725,6257,57078,54314,29588,54782,54314
19059,IA,10164,5420,9078,11236,5733,4891,10528,5623,8655.168965,9348,10765,49447,6257,-18469,6725,6257,57050,55704,30978,56172,55704
19061,IA,11664,5420,9078,11236,5733,4891,10809,5135,8752.783653,9348,11185,50976,6563,-18163,7163,6563,58831,57539,32813,58139,57539
19063,IA,9360,5420,9078,11236,5733,4891,10377,5420,9045.627716,9348,11236,49301,6257,-18469,6725,6257,56095,55558,30832,56026,55558
19065,IA,8928,5420,9078,11236,5733,4891,10297,5420,8557.554278,9348,11236,48381,5955,-18771,6291,5955,55583,54336,29610,54672,54336
19067,IA,9792,5420,9078,11236,5733,4891,10458,5420,8427.401361,9348,11236,49114,6257,-18469,6725,6257,56608,55371,30645,55839,55371
19069,IA,9696,5420,9078,11236,5733,4891,10440,5420,8394.863132,9348,11236,48986,6257,-18469,6725,6257,56494,55243,30517,55711,55243
19071,IA,9660,5420,9078,11236,5733,4891,10434,5420,8590.092507,9348,11236,49145,6257,-18469,6725,6257,56452,55402,30676,55870,55402
19073,IA,8820,5420,9078,11236,5733,4891,10276,5420,8655.168965,9348,11236,48370,5955,-18771,6291,5955,55454,54325,29599,54661,54325
19075,IA,11484,5420,9078,11236,5733,4891,10775,5402,8297.248444,9348,11035,50457,6563,-18163,7163,6563,58617,57020,32294,57620,57020
19077,IA,13080,5420,9078,11236,5733,4891,11074,5273,8687.707195,9348,11878,53158,7174,-17552,8038,7174,60512,60332,35606,61196,60332
19079,IA,9744,5420,9078,11236,5733,4891,10449,5420,8427.401361,9348,11236,49066,6257,-18469,6725,6257,56551,55323,30597,55791,55323
19081,IA,8652,5420,9078,11236,5733,4891,10245,5420,8459.93959,9348,11236,48007,5955,-18771,6291,5955,55255,53962,29236,54298,53962
19083,IA,8676,5420,9078,11236,5733,4891,10249,5420,8394.863132,9348,11236,47966,5955,-18771,6291,5955,55283,53921,29195,54257,53921
19085,IA,12708,5420,9078,11236,5733,4891,11004,5376,8752.783653,9348,11493,52570,7174,-17552,8038,7174,60070,59744,35018,60608,59744
19087,IA,9948,5420,9078,11236,5733,4891,10487,5420,7353.639798,9348,11236,48197,6257,-18469,6725,6257,56793,54454,29728,54922,54454
19089,IA,8652,5420,9078,11236,5733,4891,10245,5420,8297.248444,9348,11236,47844,5955,-18771,6291,5955,55255,53799,29073,54135,53799
19091,IA,9792,5420,9078,11236,5733,4891,10458,5420,8167.095528,9348,11236,48854,6257,-18469,6725,6257,56608,55111,30385,55579,55111
19093,IA,9228,5420,9078,11236,5733,4891,10353,5420,8525.016049,9348,11236,48648,6257,-18469,6725,6257,55939,54905,30179,55373,54905
19095,IA,10236,5420,9078,11236,5733,4891,10541,5420,8850.398341,9348,11236,49981,6563,-18163,7163,6563,57135,56544,31818,57144,56544
19097,IA,10236,5420,9078,11236,5733,4891,10541,5420,8525.016049,9348,11236,49656,6563,-18163,7163,6563,57135,56219,31493,56819,56219
19099,IA,9972,5420,9078,11236,5733,4891,10492,5243,8948.013028,9348,10813,49216,6257,-18469,6725,6257,56822,55473,30747,55941,55473
19101,IA,9552,5420,9078,11236,5733,4891,10413,5825,7809.175006,9348,10554,47979,6257,-18469,6725,6257,56323,54236,29510,54704,54236
19103,IA,15048,5420,9078,11236,5733,4891,11442,6050,9143.242403,9348,11251,55731,7786,-16940,8914,7786,62848,63517,38791,64645,63517
19105,IA,9576,5420,9078,11236,5733,4891,10418,5400,8720.245424,9348,11330,49265,6257,-18469,6725,6257,56352,55522,30796,55990,55522
19107,IA,9672,5420,9078,11236,5733,4891,10436,5420,8687.707195,9348,11236,49255,6257,-18469,6725,6257,56466,55512,30786,55980,55512
19109,IA,9228,5420,9078,11236,5733,4891,10353,5420,8915.474799,9348,11236,49038,6257,-18469,6725,6257,55939,55295,30569,55763,55295
19111,IA,9696,5420,9078,11236,5733,4891,10440,6103,7256.02511,9348,10618,47912,6257,-18469,6725,6257,56494,54169,29443,54637,54169
19113,IA,10644,5420,9078,11236,5733,4891,10618,4881,8720.245424,9348,11331,49815,6563,-18163,7163,6563,57620,56378,31652,56978,56378
19115,IA,9240,5420,9078,11236,5733,4891,10355,5420,8622.630736,9348,11236,48758,6257,-18469,6725,6257,55953,55015,30289,55483,55015
19117,IA,9132,5420,9078,11236,5733,4891,10335,5420,8134.557298,9348,11236,48162,6257,-18469,6725,6257,55825,54419,29693,54887,54419
19119,IA,8652,5420,9078,11236,5733,4891,10245,5420,8720.245424,9348,11236,48267,5955,-18771,6291,5955,55255,54222,29496,54558,54222
19121,IA,13080,5420,9078,11236,5733,4891,11074,5612,8687.707195,9348,11887,53506,7174,-17552,8038,7174,60512,60680,35954,61544,60680
19123,IA,8976,5420,9078,11236,5733,4891,10306,5200,8525.016049,9348,10890,47830,5955,-18771,6291,5955,55640,53785,29059,54121,53785
19125,IA,10476,5420,9078,11236,5733,4891,10586,5420,8817.860111,9348,11236,50189,6563,-18163,7163,6563,57420,56752,32026,57352,56752
19127,IA,9684,5420,9078,11236,5733,4891,10438,5418,7874.251465,9348,11189,48405,6257,-18469,6725,6257,56480,54662,29936,55130,54662
19129,IA,12708,5420,9078,11236,5733,4891,11004,6195,8752.783653,9348,11494,53389,7174,-17552,8038,7174,60070,60563,35837,61427,60563
19131,IA,10236,5420,9078,11236,5733,4891,10541,5420,8394.863132,9348,11236,49526,6563,-18163,7163,6563,57135,56089,31363,56689,56089
19133,IA,9276,5420,9078,11236,5733,4891,10362,5420,8525.016049,9348,11236,48696,6257,-18469,6725,6257,55996,54953,30227,55421,54953
19135,IA,8844,5420,9078,11236,5733,4891,10281,5420,7906.789694,9348,11236,47646,5955,-18771,6291,5955,55483,53601,28875,53937,53601
19137,IA,10104,5420,9078,11236,5733,4891,10517,5420,8264.710215,9348,11236,49264,6563,-18163,7163,6563,56979,55827,31101,56427,55827
19139,IA,11736,5420,9078,11236,5733,4891,10822,5319,7874.251465,9348,11270,50438,6563,-18163,7163,6563,58916,57001,32275,57601,57001
19141,IA,10068,5420,9078,11236,5733,4891,10510,5420,8492.477819,9348,11236,49455,6563,-18163,7163,6563,56936,56018,31292,56618,56018
19143,IA,9180,5420,9078,11236,5733,4891,10344,5420,8557.554278,9348,11236,48633,6257,-18469,6725,6257,55882,54890,30164,55358,54890
19145,IA,9456,5420,9078,11236,5733,4891,10395,5420,8590.092507,9348,11236,48941,6257,-18469,6725,6257,56209,55198,30472,55666,55198
19147,IA,10236,5420,9078,11236,5733,4891,10541,5420,8785.321882,9348,11236,49916,6563,-18163,7163,6563,57135,56479,31753,57079,56479
19149,IA,10392,5420,9078,11236,5733,4891,10571,5169,8492.477819,9348,11292,49585,6563,-18163,7163,6563,57321,56148,31422,56748,56148
19151,IA,8652,5420,9078,11236,5733,4891,10245,5420,8232.171986,9348,11236,47779,5955,-18771,6291,5955,55255,53734,29008,54070,53734
19153,IA,13080,5420,9078,11236,5733,4891,11074,5057,8622.630736,9348,11932,52931,7174,-17552,8038,7174,60512,60105,35379,60969,60105
19155,IA,12708,5420,9078,11236,5733,4891,11004,5291,8199.633757,9348,11507,51945,7174,-17552,8038,7174,60070,59119,34393,59983,59119
19157,IA,10164,5420,9078,11236,5733,4891,10528,5420,8199.633757,9348,11236,49259,6563,-18163,7163,6563,57050,55822,31096,56422,55822
19159,IA,8712,5420,9078,11236,5733,4891,10256,5420,8069.48084,9348,11236,47676,5955,-18771,6291,5955,55326,53631,28905,53967,53631
19161,IA,9000,5420,9078,11236,5733,4891,10310,5420,8427.401361,9348,11236,48322,5955,-18771,6291,5955,55668,54277,29551,54613,54277
19163,IA,11052,5420,9078,11236,5733,4891,10694,6254,8687.707195,9348,10978,51211,6563,-18163,7163,6563,58104,57774,33048,58374,57774
19165,IA,9000,5420,9078,11236,5733,4891,10310,5420,8297.248444,9348,11236,48192,5955,-18771,6291,5955,55668,54147,29421,54483,54147
19167,IA,9528,5420,9078,11236,5733,4891,10409,5420,8264.710215,9348,11236,48688,6257,-18469,6725,6257,56295,54945,30219,55413,54945
19169,IA,12168,5420,9078,11236,5733,4891,10903,5050,8785.321882,9348,11118,51360,6563,-18163,7163,6563,59429,57923,33197,58523,57923
19171,IA,8952,5420,9078,11236,5733,4891,10301,5420,8329.786674,9348,11236,48177,5955,-18771,6291,5955,55611,54132,29406,54468,54132
19173,IA,10236,5420,9078,11236,5733,4891,10541,5420,8362.324903,9348,11236,49493,6563,-18163,7163,6563,57135,56056,31330,56656,56056
19175,IA,9324,5420,9078,11236,5733,4891,10371,5420,8232.171986,9348,11236,48451,6257,-18469,6725,6257,56053,54708,29982,55176,54708
19177,IA,9756,5420,9078,11236,5733,4891,10452,5420,7613.945631,9348,11236,48265,6257,-18469,6725,6257,56566,54522,29796,54990,54522
19179,IA,9960,5420,9078,11236,5733,4891,10490,5081,7679.02209,9348,10611,47570,5955,-18771,6291,5955,56808,53525,28799,53861,53525
19181,IA,13080,5420,9078,11236,5733,4891,11074,6136,8882.93657,9348,11890,54228,7786,-16940,8914,7786,60512,62014,37288,63142,62014
19183,IA,11400,5420,9078,11236,5733,4891,10759,4841,8394.863132,9348,11254,50129,6563,-18163,7163,6563,58517,56692,31966,57292,56692
19185,IA,10236,5420,9078,11236,5733,4891,10541,5420,7516.330944,9348,11236,48647,6563,-18163,7163,6563,57135,55210,30484,55810,55210
19187,IA,9876,5420,9078,11236,5733,4891,10474,5552,7874.251465,9348,10404,47945,6257,-18469,6725,6257,56708,54202,29476,54670,54202
19189,IA,10236,5420,9078,11236,5733,4891,10541,5420,8655.168965,9348,11236,49786,6563,-18163,7163,6563,57135,56349,31623,56949,56349
19191,IA,9084,5420,9078,11236,5733,4891,10326,5420,9013.089487,9348,11236,48992,6257,-18469,6725,6257,55768,55249,30523,55717,55249
19193,IA,10968,5420,9078,11236,5733,4891,10678,5268,8622.630736,9348,11306,50404,6563,-18163,7163,6563,58004,56967,32241,57567,56967
19195,IA,8796,5420,9078,11236,5733,4891,10272,7579,8394.863132,9348,10686,49694,6563,-18163,7163,6563,55426,56257,31531,56857,56257
19197,IA,8652,5420,9078,11236,5733,4891,10245,5420,8264.710215,9348,11236,47812,5955,-18771,6291,5955,55255,53767,29041,54103,53767
20001,KS,10284,13500,9078,11236,5853,4891,9084,13500,9240.857091,7500,11236,56652,6968,-17430,8360,6968,63926,63620,39222,65012,63620
20003,KS,11004,13500,9078,11236,5853,4891,9201,13500,9598.777612,7500,11236,57730,6968,-17430,8360,6968,64763,64698,40300,66090,64698
20005,KS,11004,13500,9078,11236,5853,4891,9201,12454,9208.318862,7500,10759,55816,6423,-18303,7551,6423,64763,62239,37513,63367,62239
20007,KS,9816,13500,9078,11236,5853,4891,9007,13500,9598.777612,7500,11236,56542,6968,-17430,8360,6968,63381,63510,39112,64902,63510
20009,KS,9852,13500,9078,11236,5853,4891,9013,11590,9045.627716,7500,10835,53713,5878,-18848,6742,5878,63423,59591,34865,60455,59591
20011,KS,9456,13500,9078,11236,5853,4891,8949,13500,8720.245424,7500,11236,55303,6423,-18303,7551,6423,62963,61726,37000,62854,61726
20013,KS,10224,13500,9078,11236,5853,4891,9074,13500,8492.477819,7500,11236,55843,6968,-17430,8360,6968,63856,62811,38413,64203,62811
20015,KS,12252,13500,9078,11236,5853,4891,9405,13872,9696.3923,7500,11187,59399,7513,-16462,9169,7513,66215,66912,42937,68568,66912
20017,KS,10596,13500,9078,11236,5853,4891,9135,13500,8817.860111,7500,11236,56541,6968,-17430,8360,6968,64289,63509,39111,64901,63509
20019,KS,10464,13500,9078,11236,5853,4891,9113,13500,9110.704174,7500,11236,56702,6968,-17430,8360,6968,64135,63670,39272,65062,63670
20021,KS,10128,13500,9078,11236,5853,4891,9058,13500,9468.624695,7500,11236,56724,6968,-17430,8360,6968,63744,63692,39294,65084,63692
20023,KS,9300,13500,9078,11236,5853,4891,8923,13500,9794.006987,7500,11236,56221,6423,-18303,7551,6423,62781,62644,37918,63772,62644
20025,KS,9708,13500,9078,11236,5853,4891,8990,13500,8882.93657,7500,11236,55718,6423,-18303,7551,6423,63256,62141,37415,63269,62141
20027,KS,10740,13500,9078,11236,5853,4891,9158,13500,8882.93657,7500,11236,56750,6968,-17430,8360,6968,64456,63718,39320,65110,63718
20029,KS,11004,13500,9078,11236,5853,4891,9201,13500,9078.165945,7500,11236,57209,6968,-17430,8360,6968,64763,64177,39779,65569,64177
20031,KS,10092,13500,9078,11236,5853,4891,9052,13500,8492.477819,7500,11236,55711,6968,-17430,8360,6968,63702,62679,38281,64071,62679
20033,KS,9708,13500,9078,11236,5853,4891,8990,13500,9533.701154,7500,11236,56369,6423,-18303,7551,6423,63256,62792,38066,63920,62792
20035,KS,10260,13500,9078,11236,5853,4891,9080,12214,9110.704174,7500,10646,54621,6423,-18303,7551,6423,63898,61044,36318,62172,61044
20037,KS,11832,13500,9078,11236,5853,4891,9336,12219,8069.48084,7500,10184,54696,6423,-18303,7551,6423,65726,61119,36393,62247,61119
20039,KS,9300,13500,9078,11236,5853,4891,8923,13500,9436.086466,7500,11236,55863,6423,-18303,7551,6423,62781,62286,37560,63414,62286
20041,KS,10308,13500,9078,11236,5853,4891,9088,13500,9078.165945,7500,11236,56513,6968,-17430,8360,6968,63954,63481,39083,64873,63481
20043,KS,11460,13500,9078,11236,5853,4891,9276,12686,8557.554278,7500,10979,56073,6968,-17430,8360,6968,65294,63041,38643,64433,63041
20045,KS,13692,13500,9078,11236,5853,4891,9640,16256,10021.77459,7500,11136,63497,8603,-14526,10787,8603,67890,72100,48971,74284,72100
20047,KS,9300,13500,9078,11236,5853,4891,8923,13500,9045.627716,7500,11236,55473,6423,-18303,7551,6423,62781,61896,37170,63024,61896
20049,KS,11004,13500,9078,11236,5853,4891,9201,13500,9501.162924,7500,11236,57632,6968,-17430,8360,6968,64763,64600,40202,65992,64600
20051,KS,10512,13500,9078,11236,5853,4891,9121,13788,9468.624695,7500,10982,57141,6968,-17430,8360,6968,64191,64109,39711,65501,64109
20053,KS,9576,13500,9078,11236,5853,4891,8968,13500,8557.554278,7500,11236,55261,6423,-18303,7551,6423,63102,61684,36958,62812,61684
20055,KS,9996,13500,9078,11236,5853,4891,9037,13926,8492.477819,7500,11738,56544,6968,-17430,8360,6968,63591,63512,39114,64904,63512
20057,KS,10020,13500,9078,11236,5853,4891,9041,13478,9013.089487,7500,11907,56809,6968,-17430,8360,6968,63619,63777,39379,65169,63777
20059,KS,11712,13500,9078,11236,5853,4891,9317,13651,9305.933549,7500,11121,58180,6968,-17430,8360,6968,65587,65148,40750,66540,65148
20061,KS,13584,13500,9078,11236,5853,4891,9622,15978,8915.474799,7500,11414,62282,8603,-14526,10787,8603,67764,70885,47756,73069,70885
20063,KS,9480,13500,9078,11236,5853,4891,8953,13500,9598.777612,7500,11236,56206,6423,-18303,7551,6423,62991,62629,37903,63757,62629
20065,KS,11004,13500,9078,11236,5853,4891,9201,13500,9468.624695,7500,11236,57600,6968,-17430,8360,6968,64763,64568,40170,65960,64568
20067,KS,10740,13500,9078,11236,5853,4891,9158,13500,8590.092507,7500,11236,56457,6968,-17430,8360,6968,64456,63425,39027,64817,63425
20069,KS,9996,13500,9078,11236,5853,4891,9037,13500,8655.168965,7500,11236,55778,6968,-17430,8360,6968,63591,62746,38348,64138,62746
20071,KS,9300,13500,9078,11236,5853,4891,8923,13500,9631.315841,7500,11236,56058,6423,-18303,7551,6423,62781,62481,37755,63609,62481
20073,KS,10416,13500,9078,11236,5853,4891,9105,13500,8915.474799,7500,11236,56458,6968,-17430,8360,6968,64079,63426,39028,64818,63426
20075,KS,10152,13500,9078,11236,5853,4891,9062,13500,8687.707195,7500,11236,55967,6968,-17430,8360,6968,63772,62935,38537,64327,62935
20077,KS,11004,13500,9078,11236,5853,4891,9201,13500,8948.013028,7500,11236,57079,6968,-17430,8360,6968,64763,64047,39649,65439,64047
20079,KS,12252,13500,9078,11236,5853,4891,9405,12781,9436.086466,7500,11184,58044,6968,-17430,8360,6968,66215,65012,40614,66404,65012
20081,KS,9756,13500,9078,11236,5853,4891,8998,13500,8622.630736,7500,11236,55506,6423,-18303,7551,6423,63312,61929,37203,63057,61929
20083,KS,9300,13500,9078,11236,5853,4891,8923,13500,8655.168965,7500,11236,55082,6423,-18303,7551,6423,62781,61505,36779,62633,61505
20085,KS,12084,13500,9078,11236,5853,4891,9378,13053,9013.089487,7500,10992,57533,6968,-17430,8360,6968,66020,64501,40103,65893,64501
20087,KS,12084,13500,9078,11236,5853,4891,9378,13709,9338.471779,7500,10995,58518,7513,-16462,9169,7513,66020,66031,42056,67687,66031
20089,KS,10188,13500,9078,11236,5853,4891,9068,13500,9013.089487,7500,11236,56328,6968,-17430,8360,6968,63814,63296,38898,64688,63296
20091,KS,14016,13500,9078,11236,5853,4891,9693,17337,9468.624695,7500,11347,64559,9148,-13557,11596,9148,68267,73707,51002,76155,73707
20093,KS,10740,13500,9078,11236,5853,4891,9158,13150,8427.401361,7500,11677,56386,6968,-17430,8360,6968,64456,63354,38956,64746,63354
20095,KS,9300,13500,9078,11236,5853,4891,8923,12416,8948.013028,7500,11189,54244,6423,-18303,7551,6423,62781,60667,35941,61795,60667
20097,KS,11004,13500,9078,11236,5853,4891,9201,13500,9045.627716,7500,11236,57177,6968,-17430,8360,6968,64763,64145,39747,65537,64145
20099,KS,9300,13500,9078,11236,5853,4891,8923,11496,9501.162924,7500,10588,53277,5878,-18848,6742,5878,62781,59155,34429,60019,59155
20101,KS,10032,13500,9078,11236,5853,4891,9043,13500,8492.477819,7500,11236,55651,6968,-17430,8360,6968,63633,62619,38221,64011,62619
20103,KS,14016,13500,9078,11236,5853,4891,9693,15220,8850.398341,7500,11351,61828,8603,-14526,10787,8603,68267,70431,47302,72615,70431
20105,KS,9300,13500,9078,11236,5853,4891,8923,13500,8362.324903,7500,11236,54789,6423,-18303,7551,6423,62781,61212,36486,62340,61212
20107,KS,14016,13500,9078,11236,5853,4891,9693,13159,9110.704174,7500,11340,60017,7513,-16462,9169,7513,68267,67530,43555,69186,67530
20109,KS,9300,13500,9078,11236,5853,4891,8923,13500,9403.548237,7500,11236,55831,6423,-18303,7551,6423,62781,62254,37528,63382,62254
20111,KS,10272,13500,9078,11236,5853,4891,9082,12998,8069.48084,7500,10419,54150,6423,-18303,7551,6423,63912,60573,35847,61701,60573
20113,KS,9840,13500,9078,11236,5853,4891,9011,12882,9566.239383,7500,11238,55917,6423,-18303,7551,6423,63409,62340,37614,63468,62340
20115,KS,9300,13500,9078,11236,5853,4891,8923,13500,8915.474799,7500,11236,55342,6423,-18303,7551,6423,62781,61765,37039,62893,61765
20117,KS,9948,13500,9078,11236,5853,4891,9029,13500,9305.933549,7500,11236,56381,6968,-17430,8360,6968,63535,63349,38951,64741,63349
20119,KS,9300,13500,9078,11236,5853,4891,8923,13500,8720.245424,7500,11236,55147,6423,-18303,7551,6423,62781,61570,36844,62698,61570
20121,KS,14016,13500,9078,11236,5853,4891,9693,15026,10086.85105,7500,11345,62865,8058,-15494,9978,8058,68267,70923,47371,72843,70923
20123,KS,11004,13500,9078,11236,5853,4891,9201,13500,8980.551257,7500,11236,57112,6968,-17430,8360,6968,64763,64080,39682,65472,64080
20125,KS,10056,13500,9078,11236,5853,4891,9047,11816,9501.162924,7500,10161,53925,5878,-18848,6742,5878,63661,59803,35077,60667,59803
20127,KS,9360,13500,9078,11236,5853,4891,8933,13500,8948.013028,7500,11236,55435,6423,-18303,7551,6423,62851,61858,37132,62986,61858
20129,KS,9300,13500,9078,11236,5853,4891,8923,13500,9013.089487,7500,11236,55440,6423,-18303,7551,6423,62781,61863,37137,62991,61863
20131,KS,11004,13500,9078,11236,5853,4891,9201,13500,8525.016049,7500,11236,56656,6968,-17430,8360,6968,64763,63624,39226,65016,63624
20133,KS,9900,13500,9078,11236,5853,4891,9021,13500,8850.398341,7500,11236,55877,6968,-17430,8360,6968,63479,62845,38447,64237,62845
20135,KS,9300,13500,9078,11236,5853,4891,8923,13500,8817.860111,7500,11236,55245,6423,-18303,7551,6423,62781,61668,36942,62796,61668
20137,KS,10668,13500,9078,11236,5853,4891,9146,13500,9403.548237,7500,11236,57199,6968,-17430,8360,6968,64372,64167,39769,65559,64167
20139,KS,12084,13500,9078,11236,5853,4891,9378,12983,8980.551257,7500,10986,57425,6968,-17430,8360,6968,66020,64393,39995,65785,64393
20141,KS,10896,13500,9078,11236,5853,4891,9184,13500,9468.624695,7500,11236,57492,6968,-17430,8360,6968,64638,64460,40062,65852,64460
20143,KS,11004,13500,9078,11236,5853,4891,9201,12448,8427.401361,7500,11099,55370,6968,-17430,8360,6968,64763,62338,37940,63730,62338
20145,KS,9636,13500,9078,11236,5853,4891,8978,13500,9240.857091,7500,11236,56004,6423,-18303,7551,6423,63172,62427,37701,63555,62427
20147,KS,10872,13500,9078,11236,5853,4891,9180,13500,9598.777612,7500,11236,57598,6968,-17430,8360,6968,64610,64566,40168,65958,64566
20149,KS,13584,13500,9078,11236,5853,4891,9622,13494,8036.942611,7500,11119,58625,7513,-16462,9169,7513,67764,66138,42163,67794,66138
20151,KS,9660,13500,9078,11236,5853,4891,8982,13500,8655.168965,7500,11236,55442,6423,-18303,7551,6423,63200,61865,37139,62993,61865
20153,KS,9300,13500,9078,11236,5853,4891,8923,13500,9436.086466,7500,11236,55863,6423,-18303,7551,6423,62781,62286,37560,63414,62286
20155,KS,11268,13500,9078,11236,5853,4891,9244,12472,8459.93959,7500,10631,55222,6423,-18303,7551,6423,65070,61645,36919,62773,61645
20157,KS,9300,13500,9078,11236,5853,4891,8923,13500,9175.780633,7500,11236,55603,6423,-18303,7551,6423,62781,62026,37300,63154,62026
20159,KS,10104,13500,9078,11236,5853,4891,9054,13500,8687.707195,7500,11236,55919,6968,-17430,8360,6968,63716,62887,38489,64279,62887
20161,KS,13584,13500,9078,11236,5853,4891,9622,16140,10379.69511,7500,11095,63590,8603,-14526,10787,8603,67764,72193,49064,74377,72193
20163,KS,9300,13500,9078,11236,5853,4891,8923,13500,9338.471779,7500,11236,55765,6423,-18303,7551,6423,62781,62188,37462,63316,62188
20165,KS,10068,13500,9078,11236,5853,4891,9049,13500,9175.780633,7500,11236,56371,6968,-17430,8360,6968,63675,63339,38941,64731,63339
20167,KS,10752,13500,9078,11236,5853,4891,9160,13500,9338.471779,7500,11236,57217,6968,-17430,8360,6968,64470,64185,39787,65577,64185
20169,KS,10476,13500,9078,11236,5853,4891,9115,13360,8362.324903,7500,11092,55681,6968,-17430,8360,6968,64149,62649,38251,64041,62649
20171,KS,11004,13500,9078,11236,5853,4891,9201,13500,8590.092507,7500,11236,56721,6968,-17430,8360,6968,64763,63689,39291,65081,63689
20173,KS,12252,13500,9078,11236,5853,4891,9405,13939,8980.551257,7500,11188,58751,7513,-16462,9169,7513,66215,66264,42289,67920,66264
20175,KS,10968,13500,9078,11236,5853,4891,9195,13780,9078.165945,7500,11758,57975,6968,-17430,8360,6968,64721,64943,40545,66335,64943
20177,KS,12084,13500,9078,11236,5853,4891,9378,13826,8720.245424,7500,10938,57959,7513,-16462,9169,7513,66020,65472,41497,67128,65472
20179,KS,9300,13500,9078,11236,5853,4891,8923,13500,9501.162924,7500,11236,55928,6423,-18303,7551,6423,62781,62351,37625,63479,62351
20181,KS,9948,13500,9078,11236,5853,4891,9029,13500,9826.545216,7500,11236,56902,6968,-17430,8360,6968,63535,63870,39472,65262,63870
20183,KS,11004,13500,9078,11236,5853,4891,9201,13500,9240.857091,7500,11236,57372,6968,-17430,8360,6968,64763,64340,39942,65732,64340
20185,KS,9300,13500,9078,11236,5853,4891,8923,13500,8720.245424,7500,11236,55147,6423,-18303,7551,6423,62781,61570,36844,62698,61570
20187,KS,10080,13500,9078,11236,5853,4891,9050,13500,8720.245424,7500,11236,55927,6968,-17430,8360,6968,63688,62895,38497,64287,62895
20189,KS,11892,13500,9078,11236,5853,4891,9346,13500,9013.089487,7500,11236,58032,7513,-16462,9169,7513,65796,65545,41570,67201,65545
20191,KS,10704,13500,9078,11236,5853,4891,9152,12486,9240.857091,7500,11186,56007,6423,-18303,7551,6423,64414,62430,37704,63558,62430
20193,KS,10704,13500,9078,11236,5853,4891,9152,13500,9371.010008,7500,11236,57202,6968,-17430,8360,6968,64414,64170,39772,65562,64170
20195,KS,11568,13500,9078,11236,5853,4891,9293,13500,9501.162924,7500,11236,58196,6968,-17430,8360,6968,65419,65164,40766,66556,65164
20197,KS,12084,13500,9078,11236,5853,4891,9378,12411,8850.398341,7500,11000,56737,6968,-17430,8360,6968,66020,63705,39307,65097,63705
20199,KS,9300,13500,9078,11236,5853,4891,8923,13500,9598.777612,7500,11236,56026,6423,-18303,7551,6423,62781,62449,37723,63577,62449
20201,KS,9300,13500,9078,11236,5853,4891,8923,13500,9859.083446,7500,11236,56286,6423,-18303,7551,6423,62781,62709,37983,63837,62709
20203,KS,10284,13500,9078,11236,5853,4891,9084,13500,8590.092507,7500,11236,56001,6968,-17430,8360,6968,63926,62969,38571,64361,62969
20205,KS,10128,13500,9078,11236,5853,4891,9058,13500,9305.933549,7500,11236,56561,6968,-17430,8360,6968,63744,63529,39131,64921,63529
20207,KS,11004,13500,9078,11236,5853,4891,9201,13500,8394.863132,7500,11236,56526,6968,-17430,8360,6968,64763,63494,39096,64886,63494
20209,KS,14016,13500,9078,11236,5853,4891,9693,13750,8655.168965,7500,11346,60159,8058,-15494,9978,8058,68267,68217,44665,70137,68217
21001,KY,9996,12017,8887,11553,5581,5178,8009,12017,8122.675361,7516,11553,54383,7589,-17137,8717,7589,61221,61972,37246,63100,61972
21003,KY,9996,12017,8887,11553,5581,5178,8009,11430,8791.601567,7516,11056,53968,7589,-17137,8717,7589,61221,61557,36831,62685,61557
21005,KY,10032,12017,8887,11553,5581,5178,8014,11687,8281.943505,7516,11069,53764,7589,-17137,8717,7589,61262,61353,36627,62481,61353
21007,KY,9300,12017,8887,11553,5581,5178,7908,11179,7867.84633,7516,10931,51972,7020,-17706,7884,7020,60424,58992,34266,59856,58992
21009,KY,9504,12017,8887,11553,5581,5178,7937,11547,8377.504392,7516,10419,52541,7020,-17706,7884,7020,60657,59561,34835,60425,59561
21011,KY,9996,12017,8887,11553,5581,5178,8009,12415,8409.358021,7516,10228,53742,7589,-17137,8717,7589,61221,61331,36605,62459,61331
21013,KY,9516,12017,8887,11553,5581,5178,7939,11726,8281.943505,7516,9401,51618,7020,-17706,7884,7020,60671,58638,33912,59502,58638
21015,KY,12216,12017,8887,11553,5581,5178,8331,13833,8600.479794,7516,11576,58920,8727,-15248,10383,8727,63763,67647,43672,69303,67647
21017,KY,12252,12017,8887,11553,5581,5178,8336,11527,8504.918907,7516,11332,56310,8158,-16240,9550,8158,63804,64468,40070,65860,64468
21019,KY,10188,12017,8887,11553,5581,5178,8036,11335,7867.84633,7516,10777,52861,7020,-17706,7884,7020,61440,59881,35155,60745,59881
21021,KY,10668,12017,8887,11553,5581,5178,8106,11543,7581.16367,7516,10160,52646,7020,-17706,7884,7020,61990,59666,34940,60530,59666
21023,KY,12216,12017,8887,11553,5581,5178,8331,12149,8441.211649,7516,11580,57079,8158,-16240,9550,8158,63763,65237,40839,66629,65237
21025,KY,8448,12017,8887,11553,5581,5178,7784,12017,8473.065278,7516,11553,53185,7020,-17706,7884,7020,59448,60205,35479,61069,60205
21027,KY,9996,12017,8887,11553,5581,5178,8009,12017,8696.04068,7516,11553,54956,7589,-17137,8717,7589,61221,62545,37819,63673,62545
21029,KY,11712,12017,8887,11553,5581,5178,8258,12091,8759.747938,7516,11353,56610,8158,-16240,9550,8158,63186,64768,40370,66160,64768
21031,KY,9996,12017,8887,11553,5581,5178,8009,11544,8154.52899,7516,11064,53452,7589,-17137,8717,7589,61221,61041,36315,62169,61041
21033,KY,9564,12017,8887,11553,5581,5178,7946,12017,8250.089876,7516,11553,54078,7589,-17137,8717,7589,60726,61667,36941,62795,61667
21035,KY,10896,12017,8887,11553,5581,5178,8139,12403,8696.04068,7516,10367,55055,7589,-17137,8717,7589,62251,62644,37918,63772,62644
21037,KY,12216,12017,8887,11553,5581,5178,8331,13329,9205.698742,7516,11577,59021,8727,-15248,10383,8727,63763,67748,43773,69404,67748
21039,KY,9072,12017,8887,11553,5581,5178,7874,12017,7963.407216,7516,11553,53299,7589,-17137,8717,7589,60162,60888,36162,62016,60888
21041,KY,11424,12017,8887,11553,5581,5178,8216,12017,7549.310041,7516,11553,55237,8158,-16240,9550,8158,62856,63395,38997,64787,63395
21043,KY,9480,12017,8887,11553,5581,5178,7934,12017,9619.795917,7516,11553,55364,7589,-17137,8717,7589,60630,62953,38227,64081,62953
21045,KY,9228,12017,8887,11553,5581,5178,7897,12017,7804.139072,7516,11553,53296,7589,-17137,8717,7589,60341,60885,36159,62013,60885
21047,KY,12192,12017,8887,11553,5581,5178,8327,12219,7995.260845,7516,11357,56457,8158,-16240,9550,8158,63735,64615,40217,66007,64615
21049,KY,12252,12017,8887,11553,5581,5178,8336,12541,8504.918907,7516,11320,57311,8158,-16240,9550,8158,63804,65469,41071,66861,65469
21051,KY,9996,12017,8887,11553,5581,5178,8009,12017,8473.065278,7516,11553,54733,7589,-17137,8717,7589,61221,62322,37596,63450,62322
21053,KY,9552,12017,8887,11553,5581,5178,7944,12017,8122.675361,7516,11553,53939,7589,-17137,8717,7589,60712,61528,36802,62656,61528
21055,KY,9696,12017,8887,11553,5581,5178,7965,12017,8568.626165,7516,11553,54529,7589,-17137,8717,7589,60877,62118,37392,63246,62118
21057,KY,9996,12017,8887,11553,5581,5178,8009,12017,8281.943505,7516,11553,54542,7589,-17137,8717,7589,61221,62131,37405,63259,62131
21059,KY,9720,12017,8887,11553,5581,5178,7968,11431,8281.943505,7516,11165,53292,7020,-17706,7884,7020,60904,60312,35586,61176,60312
21061,KY,10080,12017,8887,11553,5581,5178,8021,12104,8154.52899,7516,11060,54093,7589,-17137,8717,7589,61317,61682,36956,62810,61682
21063,KY,8448,12017,8887,11553,5581,5178,7784,12017,8377.504392,7516,11553,53090,7020,-17706,7884,7020,59448,60110,35384,60974,60110
21065,KY,8448,12017,8887,11553,5581,5178,7784,12017,8441.211649,7516,11553,53153,7020,-17706,7884,7020,59448,60173,35447,61037,60173
21067,KY,12252,12017,8887,11553,5581,5178,8336,13511,8473.065278,7516,11305,58235,8727,-15248,10383,8727,63804,66962,42987,68618,66962
21069,KY,9996,12017,8887,11553,5581,5178,8009,12017,8281.943505,7516,11553,54542,7589,-17137,8717,7589,61221,62131,37405,63259,62131
21071,KY,8544,12017,8887,11553,5581,5178,7798,12017,8982.72334,7516,11553,53791,7020,-17706,7884,7020,59558,60811,36085,61675,60811
21073,KY,11760,12017,8887,11553,5581,5178,8265,12536,8727.894309,7516,11028,56746,8158,-16240,9550,8158,63241,64904,40506,66296,64904
21075,KY,9996,12017,8887,11553,5581,5178,8009,10733,8027.114474,7516,10272,51722,7020,-17706,7884,7020,61221,58742,34016,59606,58742
21077,KY,12216,12017,8887,11553,5581,5178,8331,13743,8536.772536,7516,11579,58769,8727,-15248,10383,8727,63763,67496,43521,69152,67496
21079,KY,9588,12017,8887,11553,5581,5178,7949,12017,8186.382618,7516,11553,54038,7589,-17137,8717,7589,60753,61627,36901,62755,61627
21081,KY,10248,12017,8887,11553,5581,5178,8045,13250,8218.236247,7516,11579,55989,8158,-16240,9550,8158,61509,64147,39749,65539,64147
21083,KY,8604,12017,8887,11553,5581,5178,7806,11081,8281.943505,7516,10433,51094,6451,-18275,7051,6451,59626,57545,32819,58145,57545
21085,KY,9540,12017,8887,11553,5581,5178,7942,12017,7867.84633,7516,11553,53672,7589,-17137,8717,7589,60698,61261,36535,62389,61261
21087,KY,9300,12017,8887,11553,5581,5178,7908,12017,8090.821732,7516,11553,53655,7589,-17137,8717,7589,60424,61244,36518,62372,61244
21089,KY,10188,12017,8887,11553,5581,5178,8036,11421,9141.991484,7516,10757,54201,7020,-17706,7884,7020,61440,61221,36495,62085,61221
21091,KY,9720,12017,8887,11553,5581,5178,7968,12016,8409.358021,7516,11172,54011,7589,-17137,8717,7589,60904,61600,36874,62728,61600
21093,KY,10344,12017,8887,11553,5581,5178,8059,12558,7931.553588,7516,11360,54887,7589,-17137,8717,7589,61619,62476,37750,63604,62476
21095,KY,9228,12017,8887,11553,5581,5178,7897,12017,8441.211649,7516,11553,53933,7589,-17137,8717,7589,60341,61522,36796,62650,61522
21097,KY,8952,12017,8887,11553,5581,5178,7857,12017,8504.918907,7516,11553,53721,7589,-17137,8717,7589,60025,61310,36584,62438,61310
21099,KY,8448,12017,8887,11553,5581,5178,7784,12017,7963.407216,7516,11553,52675,7020,-17706,7884,7020,59448,59695,34969,60559,59695
21101,KY,11292,12017,8887,11553,5581,5178,8197,11869,8632.333423,7516,11251,55738,7589,-17137,8717,7589,62705,63327,38601,64455,63327
21103,KY,11712,12017,8887,11553,5581,5178,8258,11693,8281.943505,7516,11355,55737,8158,-16240,9550,8158,63186,63895,39497,65287,63895
21105,KY,8448,12017,8887,11553,5581,5178,7784,12017,8473.065278,7516,11553,53185,7020,-17706,7884,7020,59448,60205,35479,61069,60205
21107,KY,9996,12017,8887,11553,5581,5178,8009,11356,8664.187051,7516,10887,53597,7020,-17706,7884,7020,61221,60617,35891,61481,60617
21109,KY,9696,12017,8887,11553,5581,5178,7965,12017,8090.821732,7516,11553,54051,7589,-17137,8717,7589,60877,61640,36914,62768,61640
21111,KY,11712,12017,8887,11553,5581,5178,8258,13106,8568.626165,7516,11319,57400,8158,-16240,9550,8158,63186,65558,41160,66950,65558
21113,KY,12252,12017,8887,11553,5581,5178,8336,13214,8473.065278,7516,11325,57958,8727,-15248,10383,8727,63804,66685,42710,68341,66685
21115,KY,8784,12017,8887,11553,5581,5178,7833,12017,8473.065278,7516,11553,53521,7020,-17706,7884,7020,59833,60541,35815,61405,60541
21117,KY,12216,12017,8887,11553,5581,5178,8331,13082,8473.065278,7516,11578,58043,8727,-15248,10383,8727,63763,66770,42795,68426,66770
21119,KY,9648,12017,8887,11553,5581,5178,7958,12017,8536.772536,7516,11553,54449,7589,-17137,8717,7589,60822,62038,37312,63166,62038
21121,KY,9768,12017,8887,11553,5581,5178,7975,12608,8186.382618,7516,9911,53167,7020,-17706,7884,7020,60959,60187,35461,61051,60187
21123,KY,10344,12017,8887,11553,5581,5178,8059,11357,7995.260845,7516,11375,53765,7589,-17137,8717,7589,61619,61354,36628,62482,61354
21125,KY,9264,12017,8887,11553,5581,5178,7902,12378,7708.578185,7516,9916,51960,7020,-17706,7884,7020,60382,58980,34254,59844,58980
21127,KY,8748,12017,8887,11553,5581,5178,7827,12017,8186.382618,7516,11553,53198,7020,-17706,7884,7020,59791,60218,35492,61082,60218
21129,KY,9960,12017,8887,11553,5581,5178,8003,12017,7995.260845,7516,11553,54219,7589,-17137,8717,7589,61179,61808,37082,62936,61808
21131,KY,8604,12017,8887,11553,5581,5178,7806,12017,8345.650763,7516,11553,53214,7020,-17706,7884,7020,59626,60234,35508,61098,60234
21133,KY,8448,12017,8887,11553,5581,5178,7784,12017,8409.358021,7516,11553,53121,7020,-17706,7884,7020,59448,60141,35415,61005,60141
21135,KY,8940,12017,8887,11553,5581,5178,7855,12017,8058.968103,7516,11553,53263,7589,-17137,8717,7589,60011,60852,36126,61980,60852
21137,KY,8808,12017,8887,11553,5581,5178,7836,11567,7963.407216,7516,10221,51253,7020,-17706,7884,7020,59860,58273,33547,59137,58273
21139,KY,9996,12017,8887,11553,5581,5178,8009,11156,7995.260845,7516,10924,52766,7020,-17706,7884,7020,61221,59786,35060,60650,59786
21141,KY,9132,12017,8887,11553,5581,5178,7883,12017,8027.114474,7516,11553,53423,7589,-17137,8717,7589,60231,61012,36286,62140,61012
21143,KY,8448,12017,8887,11553,5581,5178,7784,12017,8632.333423,7516,11553,53344,7020,-17706,7884,7020,59448,60364,35638,61228,60364
21145,KY,9192,12017,8887,11553,5581,5178,7892,11911,7835.992701,7516,10844,52477,7020,-17706,7884,7020,60300,59497,34771,60361,59497
21147,KY,9324,12017,8887,11553,5581,5178,7911,12017,7931.553588,7516,11553,53520,7589,-17137,8717,7589,60451,61109,36383,62237,61109
21149,KY,9720,12017,8887,11553,5581,5178,7968,11155,8345.650763,7516,11179,53093,7020,-17706,7884,7020,60904,60113,35387,60977,60113
21151,KY,10272,12017,8887,11553,5581,5178,8049,12809,8473.065278,7516,10942,55190,7589,-17137,8717,7589,61537,62779,38053,63907,62779
21153,KY,8448,12017,8887,11553,5581,5178,7784,12017,8504.918907,7516,11553,53217,7020,-17706,7884,7020,59448,60237,35511,61101,60237
21155,KY,8832,12017,8887,11553,5581,5178,7840,12017,7931.553588,7516,11553,53028,7020,-17706,7884,7020,59888,60048,35322,60912,60048
21157,KY,9588,12017,8887,11553,5581,5178,7949,12017,8632.333423,7516,11553,54484,7589,-17137,8717,7589,60753,62073,37347,63201,62073
21159,KY,9780,12017,8887,11553,5581,5178,7977,12017,8441.211649,7516,11553,54485,7589,-17137,8717,7589,60973,62074,37348,63202,62074
21161,KY,9744,12017,8887,11553,5581,5178,7972,11665,8186.382618,7516,11051,53340,7589,-17137,8717,7589,60932,60929,36203,62057,60929
21163,KY,10824,12017,8887,11553,5581,5178,8129,12819,8281.943505,7516,11370,55988,8158,-16240,9550,8158,62169,64146,39748,65538,64146
21165,KY,8676,12017,8887,11553,5581,5178,7817,11201,8345.650763,7516,10255,51171,6451,-18275,7051,6451,59709,57622,32896,58222,57622
21167,KY,9696,12017,8887,11553,5581,5178,7965,12017,8218.236247,7516,11553,54178,7589,-17137,8717,7589,60877,61767,37041,62895,61767
21169,KY,9024,12017,8887,11553,5581,5178,7867,10894,8218.236247,7516,10467,51297,6451,-18275,7051,6451,60107,57748,33022,58348,57748
21171,KY,8448,12017,8887,11553,5581,5178,7784,12017,8409.358021,7516,11553,53121,7020,-17706,7884,7020,59448,60141,35415,61005,60141
21173,KY,10092,12017,8887,11553,5581,5178,8023,12181,8313.797134,7516,10173,53454,7589,-17137,8717,7589,61331,61043,36317,62171,61043
21175,KY,9996,12017,8887,11553,5581,5178,8009,12017,8313.797134,7516,11553,54574,7589,-17137,8717,7589,61221,62163,37437,63291,62163
21177,KY,8448,12017,8887,11553,5581,5178,7784,12017,8250.089876,7516,11553,52962,7020,-17706,7884,7020,59448,59982,35256,60846,59982
21179,KY,10824,12017,8887,11553,5581,5178,8129,11550,8568.626165,7516,11202,54839,7589,-17137,8717,7589,62169,62428,37702,63556,62428
21181,KY,9732,12017,8887,11553,5581,5178,7970,12017,8345.650763,7516,11553,54342,7589,-17137,8717,7589,60918,61931,37205,63059,61931
21183,KY,9600,12017,8887,11553,5581,5178,7951,12017,8058.968103,7516,11553,53923,7589,-17137,8717,7589,60767,61512,36786,62640,61512
21185,KY,11712,12017,8887,11553,5581,5178,8258,13832,8823.455196,7516,11361,58422,8727,-15248,10383,8727,63186,67149,43174,68805,67149
21187,KY,9456,12017,8887,11553,5581,5178,7930,12017,8632.333423,7516,11553,54352,7589,-17137,8717,7589,60602,61941,37215,63069,61941
21189,KY,8880,12017,8887,11553,5581,5178,7847,12017,8441.211649,7516,11553,53585,7589,-17137,8717,7589,59943,61174,36448,62302,61174
21191,KY,12216,12017,8887,11553,5581,5178,8331,12207,8632.333423,7516,11579,57328,8158,-16240,9550,8158,63763,65486,41088,66878,65486
21193,KY,8448,12017,8887,11553,5581,5178,7784,12017,8600.479794,7516,11553,53312,7020,-17706,7884,7020,59448,60332,35606,61196,60332
21195,KY,10968,12017,8887,11553,5581,5178,8150,12017,8504.918907,7516,11553,55737,8158,-16240,9550,8158,62334,63895,39497,65287,63895
21197,KY,9696,12017,8887,11553,5581,5178,7965,12017,8377.504392,7516,11553,54338,7589,-17137,8717,7589,60877,61927,37201,63055,61927
21199,KY,9588,12017,8887,11553,5581,5178,7949,11800,7644.870928,7516,10084,51811,7020,-17706,7884,7020,60753,58831,34105,59695,58831
21201,KY,11136,12017,8887,11553,5581,5178,8174,12017,8186.382618,7516,11553,55586,8158,-16240,9550,8158,62526,63744,39346,65136,63744
21203,KY,9660,12017,8887,11553,5581,5178,7960,11571,7867.84633,7516,10996,52788,7020,-17706,7884,7020,60836,59808,35082,60672,59808
21205,KY,8580,12017,8887,11553,5581,5178,7803,12017,8441.211649,7516,11553,53285,7020,-17706,7884,7020,59599,60305,35579,61169,60305
21207,KY,8976,12017,8887,11553,5581,5178,7860,12017,7835.992701,7516,11553,53076,7589,-17137,8717,7589,60052,60665,35939,61793,60665
21209,KY,12252,12017,8887,11553,5581,5178,8336,12565,8855.308825,7516,11323,57690,8158,-16240,9550,8158,63804,65848,41450,67240,65848
21211,KY,11124,12017,8887,11553,5581,5178,8172,12687,8568.626165,7516,11346,56420,8158,-16240,9550,8158,62512,64578,40180,65970,64578
21213,KY,9336,12017,8887,11553,5581,5178,7913,12017,8409.358021,7516,11553,54009,7589,-17137,8717,7589,60465,61598,36872,62726,61598
21215,KY,11712,12017,8887,11553,5581,5178,8258,12115,8568.626165,7516,11357,56447,8158,-16240,9550,8158,63186,64605,40207,65997,64605
21217,KY,9060,12017,8887,11553,5581,5178,7873,10895,7995.260845,7516,10207,50851,6451,-18275,7051,6451,60149,57302,32576,57902,57302
21219,KY,10140,12017,8887,11553,5581,5178,8029,12017,8186.382618,7516,11553,54590,7589,-17137,8717,7589,61385,62179,37453,63307,62179
21221,KY,12192,12017,8887,11553,5581,5178,8327,11612,8345.650763,7516,11367,56210,8158,-16240,9550,8158,63735,64368,39970,65760,64368
21223,KY,11712,12017,8887,11553,5581,5178,8258,12125,7963.407216,7516,11353,55848,8158,-16240,9550,8158,63186,64006,39608,65398,64006
21225,KY,9360,12017,8887,11553,5581,5178,7916,12017,8218.236247,7516,11553,53842,7589,-17137,8717,7589,60492,61431,36705,62559,61431
21227,KY,10080,12017,8887,11553,5581,5178,8021,12357,8154.52899,7516,10999,54284,7589,-17137,8717,7589,61317,61873,37147,63001,61873
21229,KY,9192,12017,8887,11553,5581,5178,7892,12017,7995.260845,7516,11553,53451,7589,-17137,8717,7589,60300,61040,36314,62168,61040
21231,KY,8448,12017,8887,11553,5581,5178,7784,12017,8027.114474,7516,11553,52739,7020,-17706,7884,7020,59448,59759,35033,60623,59759
21233,KY,11292,12017,8887,11553,5581,5178,8197,12017,8600.479794,7516,11553,56156,8158,-16240,9550,8158,62705,64314,39916,65706,64314
21235,KY,9672,12017,8887,11553,5581,5178,7962,11999,8441.211649,7516,9933,52739,7020,-17706,7884,7020,60850,59759,35033,60623,59759
21237,KY,11196,12017,8887,11553,5581,5178,8183,12017,8058.968103,7516,11553,55519,8158,-16240,9550,8158,62595,63677,39279,65069,63677
21239,KY,12252,12017,8887,11553,5581,5178,8336,11996,9333.113258,7516,11334,57610,8158,-16240,9550,8158,63804,65768,41370,67160,65768
22001,LA,10272,5472,8887,11553,6303,5178,7636,4923,9014.576969,10504,11416,51307,4722,-20004,5322,4722,55301,56029,31303,56629,56029
22003,LA,10812,5472,8887,11553,6303,5178,7719,5472,8536.772536,10504,11553,52056,5255,-19471,6119,5255,55924,57311,32585,58175,57311
22005,LA,11940,5472,8887,11553,6303,5178,7895,6066,9492.381402,10504,11628,54808,5788,-18938,6916,5788,57228,60596,35870,61724,60596
22007,LA,11604,5472,8887,11553,6303,5178,7842,5472,9237.552371,10504,11553,53549,5255,-19471,6119,5255,56839,58804,34078,59668,58804
22009,LA,11472,5472,8887,11553,6303,5178,7822,5472,8441.211649,10504,11553,52620,5255,-19471,6119,5255,56687,57875,33149,58739,57875
22011,LA,10764,5472,8887,11553,6303,5178,7712,5474,8536.772536,10504,11247,51704,5255,-19471,6119,5255,55869,56959,32233,57823,56959
22013,LA,11268,5472,8887,11553,6303,5178,7790,5472,8887.162454,10504,11553,52862,5255,-19471,6119,5255,56451,58117,33391,58981,58117
22015,LA,11316,5472,8887,11553,6303,5178,7798,6077,9078.284227,10504,11169,53323,5255,-19471,6119,5255,56507,58578,33852,59442,58578
22017,LA,11316,5472,8887,11553,6303,5178,7798,5635,8919.016082,10504,11160,52712,5255,-19471,6119,5255,56507,57967,33241,58831,57967
22019,LA,11664,5472,8887,11553,6303,5178,7852,5514,8536.772536,10504,11196,52592,5255,-19471,6119,5255,56909,57847,33121,58711,57847
22021,LA,11268,5472,8887,11553,6303,5178,7790,5472,8504.918907,10504,11553,52480,5255,-19471,6119,5255,56451,57735,33009,58599,57735
22023,LA,11664,5472,8887,11553,6303,5178,7852,5411,8186.382618,10504,11219,52162,5255,-19471,6119,5255,56909,57417,32691,58281,57417
22025,LA,11268,5472,8887,11553,6303,5178,7790,5472,8473.065278,10504,11553,52448,5255,-19471,6119,5255,56451,57703,32977,58567,57703
22027,LA,11268,5472,8887,11553,6303,5178,7790,5472,8823.455196,10504,11553,52798,5255,-19471,6119,5255,56451,58053,33327,58917,58053
22029,LA,11268,5472,8887,11553,6303,5178,7790,4892,8855.308825,10504,9668,50365,4722,-20004,5322,4722,56451,55087,30361,55687,55087
22031,LA,11316,5472,8887,11553,6303,5178,7798,5701,8664.187051,10504,11176,52540,5255,-19471,6119,5255,56507,57795,33069,58659,57795
22033,LA,11940,5472,8887,11553,6303,5178,7895,6126,9269.406,10504,11638,54655,5788,-18938,6916,5788,57228,60443,35717,61571,60443
22035,LA,9516,5472,8887,11553,6303,5178,7518,5472,8600.479794,10504,11553,50823,4722,-20004,5322,4722,54427,55545,30819,56145,55545
22037,LA,11940,5472,8887,11553,6303,5178,7895,5480,9460.527773,10504,11621,54183,5255,-19471,6119,5255,57228,59438,34712,60302,59438
22039,LA,10116,5472,8887,11553,6303,5178,7611,5472,8568.626165,10504,11553,51392,4722,-20004,5322,4722,55120,56114,31388,56714,56114
22041,LA,9936,5472,8887,11553,6303,5178,7584,5472,8186.382618,10504,11553,50829,4722,-20004,5322,4722,54913,55551,30825,56151,55551
22043,LA,10668,5472,8887,11553,6303,5178,7697,5438,9046.430598,10504,11026,51861,4722,-20004,5322,4722,55758,56583,31857,57183,56583
22045,LA,10572,5472,8887,11553,6303,5178,7682,5484,8600.479794,10504,11407,51746,5255,-19471,6119,5255,55647,57001,32275,57865,57001
22047,LA,10332,5472,8887,11553,6303,5178,7645,5202,9269.406,10504,11625,52110,4722,-20004,5322,4722,55370,56832,32106,57432,56832
22049,LA,11268,5472,8887,11553,6303,5178,7790,5472,8632.333423,10504,11553,52607,5255,-19471,6119,5255,56451,57862,33136,58726,57862
22051,LA,14280,5472,8887,11553,6303,5178,8258,6414,9364.966886,10504,11301,57042,6321,-18077,7713,6321,59931,63363,38965,64755,63363
22053,LA,10836,5472,8887,11553,6303,5178,7723,5472,8759.747938,10504,11553,52303,5255,-19471,6119,5255,55952,57558,32832,58422,57558
22055,LA,12456,5472,8887,11553,6303,5178,7975,6068,9492.381402,10504,11428,55126,5788,-18938,6916,5788,57824,60914,36188,62042,60914
22057,LA,12000,5472,8887,11553,6303,5178,7904,5600,9237.552371,10504,11627,54146,5255,-19471,6119,5255,57297,59401,34675,60265,59401
22059,LA,10536,5472,8887,11553,6303,5178,7677,5472,8250.089876,10504,11553,51493,5255,-19471,6119,5255,55606,56748,32022,57612,56748
22061,LA,12636,5472,8887,11553,6303,5178,8003,5754,9014.576969,10504,10448,53534,5255,-19471,6119,5255,58032,58789,34063,59653,58789
22063,LA,11940,5472,8887,11553,6303,5178,7895,6045,8696.04068,10504,11626,53990,5788,-18938,6916,5788,57228,59778,35052,60906,59778
22065,LA,10116,5472,8887,11553,6303,5178,7611,5472,8536.772536,10504,11553,51360,4722,-20004,5322,4722,55120,56082,31356,56682,56082
22067,LA,10332,5472,8887,11553,6303,5178,7645,4803,8218.236247,10504,9868,48904,4455,-20271,4923,4455,55370,53359,28633,53827,53359
22069,LA,11604,5472,8887,11553,6303,5178,7842,5645,9046.430598,10504,10290,52267,5255,-19471,6119,5255,56839,57522,32796,58386,57522
22071,LA,14280,5472,8887,11553,6303,5178,8258,7312,10256.86849,10504,11268,58799,6321,-18077,7713,6321,59931,65120,40722,66512,65120
22073,LA,10356,5472,8887,11553,6303,5178,7649,5466,8600.479794,10504,10507,50612,4722,-20004,5322,4722,55398,55334,30608,55934,55334
22075,LA,14280,5472,8887,11553,6303,5178,8258,7340,8186.382618,10504,11321,56809,6321,-18077,7713,6321,59931,63130,38732,64522,63130
22077,LA,11940,5472,8887,11553,6303,5178,7895,5545,9333.113258,10504,11622,54122,5255,-19471,6119,5255,57228,59377,34651,60241,59377
22079,LA,10668,5472,8887,11553,6303,5178,7697,5511,8154.52899,10504,10978,50994,4722,-20004,5322,4722,55758,55716,30990,56316,55716
22081,LA,11268,5472,8887,11553,6303,5178,7790,5472,8919.016082,10504,11553,52894,5255,-19471,6119,5255,56451,58149,33423,59013,58149
22083,LA,10416,5472,8887,11553,6303,5178,7658,5472,8473.065278,10504,11553,51596,5255,-19471,6119,5255,55467,56851,32125,57715,56851
22085,LA,9516,5472,8887,11553,6303,5178,7518,5472,8823.455196,10504,11553,51046,4722,-20004,5322,4722,54427,55768,31042,56368,55768
22087,LA,14280,5472,8887,11553,6303,5178,8258,5460,8982.72334,10504,11322,55727,5788,-18938,6916,5788,59931,61515,36789,62643,61515
22089,LA,14280,5472,8887,11553,6303,5178,8258,6231,9810.917691,10504,11315,57319,6321,-18077,7713,6321,59931,63640,39242,65032,63640
22091,LA,11940,5472,8887,11553,6303,5178,7895,5553,9141.991484,10504,11621,53938,5255,-19471,6119,5255,57228,59193,34467,60057,59193
22093,LA,11268,5472,8887,11553,6303,5178,7790,5509,9779.064062,10504,11316,53554,5255,-19471,6119,5255,56451,58809,34083,59673,58809
22095,LA,14280,5472,8887,11553,6303,5178,8258,5625,9237.552371,10504,11303,56128,5788,-18938,6916,5788,59931,61916,37190,63044,61916
22097,LA,9576,5472,8887,11553,6303,5178,7528,5041,8504.918907,10504,10339,49143,4455,-20271,4923,4455,54497,53598,28872,54066,53598
22099,LA,12456,5472,8887,11553,6303,5178,7975,5386,9205.698742,10504,11423,54152,5255,-19471,6119,5255,57824,59407,34681,60271,59407
22101,LA,11724,5472,8887,11553,6303,5178,7861,5435,9078.284227,10504,11006,52926,5255,-19471,6119,5255,56978,58181,33455,59045,58181
22103,LA,14280,5472,8887,11553,6303,5178,8258,6407,9683.503175,10504,11307,57360,6321,-18077,7713,6321,59931,63681,39283,65073,63681
22105,LA,12456,5472,8887,11553,6303,5178,7975,5963,9269.406,10504,11139,54509,5788,-18938,6916,5788,57824,60297,35571,61425,60297
22107,LA,9516,5472,8887,11553,6303,5178,7518,5472,8568.626165,10504,11553,50792,4722,-20004,5322,4722,54427,55514,30788,56114,55514
22109,LA,12000,5472,8887,11553,6303,5178,7904,5737,8568.626165,10504,11633,53621,5255,-19471,6119,5255,57297,58876,34150,59740,58876
22111,LA,10356,5472,8887,11553,6303,5178,7649,5377,8696.04068,10504,10593,50704,4722,-20004,5322,4722,55398,55426,30700,56026,55426
22113,LA,11508,5472,8887,11553,6303,5178,7828,5243,8696.04068,10504,11417,52546,5255,-19471,6119,5255,56729,57801,33075,58665,57801
22115,LA,13680,5472,8887,11553,6303,5178,8165,6104,8345.650763,10504,11532,55344,5788,-18938,6916,5788,59238,61132,36406,62260,61132
22117,LA,9816,5472,8887,11553,6303,5178,7565,5077,9110.137856,10504,9900,49586,4455,-20271,4923,4455,54774,54041,29315,54509,54041
22119,LA,10020,5472,8887,11553,6303,5178,7597,5200,8759.747938,10504,11152,50814,4722,-20004,5322,4722,55010,55536,30810,56136,55536
22121,LA,11940,5472,8887,11553,6303,5178,7895,5797,9428.674144,10504,11630,54477,5255,-19471,6119,5255,57228,59732,35006,60596,59732
22123,LA,10944,5472,8887,11553,6303,5178,7740,5472,8377.504392,10504,11553,52029,5255,-19471,6119,5255,56077,57284,32558,58148,57284
22125,LA,11940,5472,8887,11553,6303,5178,7895,6217,9078.284227,10504,11621,54538,5788,-18938,6916,5788,57228,60326,35600,61454,60326
22127,LA,10272,5472,8887,11553,6303,5178,7636,5472,8409.358021,10504,11553,51388,4722,-20004,5322,4722,55301,56110,31384,56710,56110
23001,ME,11376,4756,10321,9258,6469,4819,10992,4039,11615.96144,9185,8839,49874,3608,-21118,3944,3608,57991,53482,28756,53818,53482
23003,ME,9684,4756,10321,9258,6469,4819,10663,4756,10913.08479,9185,9258,48615,3608,-21118,3944,3608,55970,52223,27497,52559,52223
23005,ME,15895,4756,10321,9258,6469,4819,11872,5772,12355.83159,9185,9228,57254,5136,-19590,6264,5136,63390,62390,37664,63518,62390
23007,ME,9912,4756,10321,9258,6469,4819,10707,4756,11800.92898,9185,9258,49731,3608,-21118,3944,3608,56242,53339,28613,53675,53339
23009,ME,12996,4756,10321,9258,6469,4819,11308,4756,12577.79264,9185,9258,53592,4101,-20625,4701,4101,59927,57693,32967,58293,57693
23011,ME,11616,4756,10321,9258,6469,4819,11039,5763,11467.98741,9185,8786,51637,4101,-20625,4701,4101,58278,55738,31012,56338,55738
23013,ME,13596,4756,10321,9258,6469,4819,11425,4756,13206.68227,9185,9258,54821,4101,-20625,4701,4101,60644,58922,34196,59522,58922
23015,ME,13716,4756,10321,9258,6469,4819,11448,4756,13724.59138,9185,9258,55459,4603,-20123,5467,4603,60787,60062,35336,60926,60062
23017,ME,11280,4756,10321,9258,6469,4819,10974,4756,11357.00688,9185,9258,50655,3854,-20872,4322,3854,57877,54509,29783,54977,54509
23019,ME,12303,4756,10321,9258,6469,4819,11173,5078,11283.01987,9185,8802,51470,4101,-20625,4701,4101,59099,55571,30845,56171,55571
23021,ME,10116,4756,10321,9258,6469,4819,10747,4756,11911.9095,9185,9258,50046,3608,-21118,3944,3608,56486,53654,28928,53990,53654
23023,ME,13416,4756,10321,9258,6469,4819,11390,5378,13576.61735,9185,9237,55612,4603,-20123,5467,4603,60429,60215,35489,61079,60215
23025,ME,11532,4756,10321,9258,6469,4819,11023,4756,10802.10427,9185,9258,50352,3854,-20872,4322,3854,58178,54206,29480,54674,54206
23027,ME,12024,4756,10321,9258,6469,4819,11119,4756,12910.73421,9185,9258,52953,4101,-20625,4701,4101,58766,57054,32328,57654,57054
23029,ME,10152,4756,10321,9258,6469,4819,10754,4756,11578.96793,9185,9258,49749,3608,-21118,3944,3608,56529,53357,28631,53693,53357
23031,ME,15083,4756,10321,9258,6469,4819,11714,4410,12318.83809,9185,9236,55052,4603,-20123,5467,4603,62420,59655,34929,60519,59655
24001,MD,10404,8693,8887,11553,6209,5178,8374,7863,9333.113258,8140,10138,51056,5501,-19225,6101,5501,59298,56557,31831,57157,56557
24003,MD,19188,8693,8887,11553,6209,5178,9650,9696,9460.527773,8140,12471,64134,8789,-14340,10973,8789,69358,72923,49794,75107,72923
24005,MD,19188,8693,8887,11553,6209,5178,9650,9633,9237.552371,8140,12530,63906,8789,-14340,10973,8789,69358,72695,49566,74879,72695
24009,MD,23592,8693,8887,11553,6209,5178,10289,11101,10830.23381,8140,13073,71914,10433,-11426,13409,10433,74401,82347,60488,85323,82347
24011,MD,14232,8693,8887,11553,6209,5178,8930,8693,9014.576969,8140,11553,56811,7145,-17253,8537,7145,63682,63956,39558,65348,63956
24013,MD,19188,8693,8887,11553,6209,5178,9650,11205,10288.72212,8140,12458,66457,9337,-13368,11785,9337,69358,75794,53089,78242,75794
24015,MD,16968,8693,8887,11553,6209,5178,9327,10044,8823.455196,8140,12166,61319,8241,-15311,10161,8241,66815,69560,46008,71480,69560
24017,MD,23592,8693,8887,11553,6209,5178,10289,9275,9396.820515,8140,13134,68716,10433,-11426,13409,10433,74401,79149,57290,82125,79149
24019,MD,12660,8693,8887,11553,6209,5178,8702,9176,8696.04068,8140,11003,54853,6597,-18129,7725,6597,61882,61450,36724,62578,61450
24021,MD,23592,8693,8887,11553,6209,5178,10289,7666,9364.966886,8140,13196,67136,9885,-12397,12597,9885,74401,77021,54739,79733,77021
24023,MD,10548,8693,8887,11553,6209,5178,8395,8693,8727.894309,8140,11553,52840,6049,-18677,6913,6049,59463,58889,34163,59753,58889
24025,MD,19188,8693,8887,11553,6209,5178,9650,8678,9556.08866,8140,12451,63192,8789,-14340,10973,8789,69358,71981,48852,74165,71981
24027,MD,19188,8693,8887,11553,6209,5178,9650,8458,10607.25841,8140,12484,64055,8789,-14340,10973,8789,69358,72844,49715,75028,72844
24028,MD,23928,8693,8887,11553,6209,5178,10338,8693,8887,8140,11553,66379,9885,-12397,12597,9885,74786,76264,53982,78976,76264
24029,MD,14892,8693,8887,11553,6209,5178,9026,8693,10065.74672,8140,11553,58522,7145,-17253,8537,7145,64438,65667,41269,67059,65667
24031,MD,23592,8693,8887,11553,6209,5178,10289,8034,10766.52656,8140,13460,69171,9885,-12397,12597,9885,74401,79056,56774,81768,79056
24033,MD,23592,8693,8887,11553,6209,5178,10289,8664,9110.137856,8140,13419,68103,9885,-12397,12597,9885,74401,77988,55706,80700,77988
24035,MD,19188,8693,8887,11553,6209,5178,9650,9520,11626.57454,8140,12397,66050,8789,-14340,10973,8789,69358,74839,51710,77023,74839
24037,MD,21216,8693,8887,11553,6209,5178,9944,8830,9428.674144,8140,13063,65856,9337,-13368,11785,9337,71680,75193,52488,77641,75193
24039,MD,10500,8693,8887,11553,6209,5178,8388,8158,8568.626165,8140,11363,51908,6049,-18677,6913,6049,59408,57957,33231,58821,57957
24041,MD,15840,8693,8887,11553,6209,5178,9164,9032,10575.40478,8140,11694,60459,7693,-16282,9349,7693,65524,68152,44177,69808,68152
24043,MD,16080,8693,8887,11553,6209,5178,9198,9586,8823.455196,8140,11479,59286,7693,-16282,9349,7693,65798,66979,43004,68635,66979
24045,MD,13512,8693,8887,11553,6209,5178,8826,9984,8791.601567,8140,11351,56957,7145,-17253,8537,7145,62858,64102,39704,65494,64102
24047,MD,13272,8693,8887,11553,6209,5178,8791,8265,9938.332206,8140,11361,56154,6597,-18129,7725,6597,62583,62751,38025,63879,62751
24510,MD,19188,8693,8887,11553,6209,5178,9650,8452,9874.624948,8140,12711,63543,8789,-14340,10973,8789,69358,72332,49203,74516,72332
25001,MA,18456,14318,10321,9258,6268,4819,11069,15124,13243.67578,9005,9200,69848,10905,-11377,13617,10905,74509,80753,58471,83465,80753
25003,MA,12092,14318,10321,9258,6268,4819,10005,15940,12651.77966,9005,8753,63261,9237,-14315,11157,9237,67081,72498,48946,74418,72498
25005,MA,14208,14318,10321,9258,6268,4819,10359,13900,11061.05882,9005,9262,62255,9237,-14315,11157,9237,69551,71492,47940,73412,71492
25007,MA,20328,14318,10321,9258,6268,4819,11382,14154,11948.90301,9005,10021,70276,11461,-10398,14437,11461,76694,81737,59878,84713,81737
25009,MA,19676,14318,10321,9258,6268,4819,11273,14487,11541.97442,9005,10073,69601,11461,-10398,14437,11461,75933,81062,59203,84038,81062
25011,MA,14756,14318,10321,9258,6268,4819,10450,15235,11837.92249,9005,9073,64726,9793,-13336,11977,9793,70190,74519,51390,76703,74519
25013,MA,14244,14318,10321,9258,6268,4819,10365,12861,10580.14322,9005,9039,60548,9237,-14315,11157,9237,69593,69785,46233,71705,69785
25015,MA,14244,14318,10321,9258,6268,4819,10365,18366,12170.86406,9005,9057,67662,10349,-12356,12797,10349,69593,78011,55306,80459,78011
25017,MA,20853,14318,10321,9258,6268,4819,11470,18277,11948.90301,9005,10106,75009,12573,-8440,16077,12573,77307,87582,66569,91086,87582
25019,MA,30300,14318,10321,9258,6268,4819,13049,14318,11763.93547,9005,9258,79464,14721,-4572,18567,14721,88333,94185,74892,98031,94185
25021,MA,21705,14318,10321,9258,6268,4819,11612,16480,11615.96144,9005,10083,73708,12573,-8440,16077,12573,78301,86281,65268,89785,86281
25023,MA,19731,14318,10321,9258,6268,4819,11282,16633,12318.83809,9005,10014,72521,12017,-9419,15257,12017,75997,84538,63102,87778,84538
25025,MA,21732,14318,10321,9258,6268,4819,11617,15751,12651.77966,9005,10340,74299,12017,-9419,15257,12017,78333,86316,64880,89556,86316
25027,MA,14175,14318,10321,9258,6268,4819,10353,17458,11246.02636,9005,9859,66562,10349,-12356,12797,10349,69512,76911,54206,79359,76911
26001,MI,10176,7006,9078,11236,5652,4891,8818,7006,8687.707195,7692,11236,49689,5837,-18889,6437,5837,56857,55526,30800,56126,55526
26003,MI,9516,7006,9078,11236,5652,4891,8714,7006,9175.780633,7692,11236,49517,5567,-19159,6035,5567,56093,55084,30358,55552,55084
26005,MI,10824,7006,9078,11236,5652,4891,8920,7515,8817.860111,7692,11193,50933,5837,-18889,6437,5837,57607,56770,32044,57370,56770
26007,MI,11268,7006,9078,11236,5652,4891,8990,6462,8785.321882,7692,9750,48848,5567,-19159,6035,5567,58121,54415,29689,54883,54415
26009,MI,10560,7006,9078,11236,5652,4891,8878,7006,9859.083446,7692,11236,51244,5837,-18889,6437,5837,57301,57081,32355,57681,57081
26011,MI,10932,7006,9078,11236,5652,4891,8937,7006,8427.401361,7692,11236,50184,5837,-18889,6437,5837,57732,56021,31295,56621,56021
26013,MI,9516,7006,9078,11236,5652,4891,8714,7006,9305.933549,7692,11236,49647,5567,-19159,6035,5567,56093,55214,30488,55682,55214
26015,MI,10692,7006,9078,11236,5652,4891,8899,7090,8525.016049,7692,11276,50165,5837,-18889,6437,5837,57454,56002,31276,56602,56002
26017,MI,10524,7006,9078,11236,5652,4891,8873,6976,8167.095528,7692,10629,48880,5567,-19159,6035,5567,57260,54447,29721,54915,54447
26019,MI,12096,7006,9078,11236,5652,4891,9120,6674,9110.704174,7692,10887,51350,5837,-18889,6437,5837,59079,57187,32461,57787,57187
26021,MI,11196,7006,9078,11236,5652,4891,8979,6995,8297.248444,7692,10683,49754,5837,-18889,6437,5837,58038,55591,30865,56191,55591
26023,MI,10848,7006,9078,11236,5652,4891,8924,6767,7548.869173,7692,10608,48355,5567,-19159,6035,5567,57635,53922,29196,54390,53922
26025,MI,10428,7006,9078,11236,5652,4891,8857,7078,8264.710215,7692,10580,48934,5567,-19159,6035,5567,57148,54501,29775,54969,54501
26027,MI,10980,7006,9078,11236,5652,4891,8944,6707,9013.089487,7692,10844,50127,5837,-18889,6437,5837,57787,55964,31238,56564,55964
26029,MI,10272,7006,9078,11236,5652,4891,8833,7006,9956.698133,7692,11236,51054,5837,-18889,6437,5837,56968,56891,32165,57491,56891
26031,MI,11268,7006,9078,11236,5652,4891,8990,7006,8687.707195,7692,11236,50781,5837,-18889,6437,5837,58121,56618,31892,57218,56618
26033,MI,9624,7006,9078,11236,5652,4891,8731,6980,8915.474799,7692,10239,48341,5299,-19427,5635,5299,56218,53640,28914,53976,53640
26035,MI,9516,7006,9078,11236,5652,4891,8714,7006,7776.636777,7692,11236,48118,5567,-19159,6035,5567,56093,53685,28959,54153,53685
26037,MI,12156,7006,9078,11236,5652,4891,9130,7860,9110.704174,7692,10955,52665,6375,-18351,7239,6375,59149,59040,34314,59904,59040
26039,MI,10452,7006,9078,11236,5652,4891,8861,7006,8785.321882,7692,11236,50062,5837,-18889,6437,5837,57176,55899,31173,56499,55899
26041,MI,11268,7006,9078,11236,5652,4891,8990,6568,8980.551257,7692,10378,49777,5567,-19159,6035,5567,58121,55344,30618,55812,55344
26043,MI,9516,7006,9078,11236,5652,4891,8714,6298,9045.627716,7692,10469,47911,1874,-22852,2215,1874,56093,49785,25059,50126,49785
26045,MI,12156,7006,9078,11236,5652,4891,9130,7991,8492.477819,7692,10940,52162,6375,-18351,7239,6375,59149,58537,33811,59401,58537
26047,MI,11796,7006,9078,11236,5652,4891,9073,7006,9598.777612,7692,11236,52220,5837,-18889,6437,5837,58732,58057,33331,58657,58057
26049,MI,11124,7006,9078,11236,5652,4891,8967,7351,8427.401361,7692,10398,49883,5837,-18889,6437,5837,57954,55720,30994,56320,55720
26051,MI,11268,7006,9078,11236,5652,4891,8990,7006,9305.933549,7692,11236,51399,5837,-18889,6437,5837,58121,57236,32510,57836,57236
26053,MI,10464,7006,9078,11236,5652,4891,8863,7006,8492.477819,7692,11236,49781,5837,-18889,6437,5837,57190,55618,30892,56218,55618
26055,MI,13104,7006,9078,11236,5652,4891,9279,7894,9468.624695,7692,10856,53906,6375,-18351,7239,6375,60246,60281,35555,61145,60281
26057,MI,9780,7006,9078,11236,5652,4891,8755,6764,8264.710215,7692,10275,47667,5299,-19427,5635,5299,56398,52966,28240,53302,52966
26059,MI,10884,7006,9078,11236,5652,4891,8929,6787,8004.404382,7692,10564,48823,5567,-19159,6035,5567,57676,54390,29664,54858,54390
26061,MI,9672,7006,9078,11236,5652,4891,8738,6586,9338.471779,7692,9909,48089,1874,-22852,2215,1874,56273,49963,25237,50304,49963
26063,MI,11124,7006,9078,11236,5652,4891,8967,7006,8427.401361,7692,11236,50376,5837,-18889,6437,5837,57954,56213,31487,56813,56213
26065,MI,12156,7006,9078,11236,5652,4891,9130,8224,8915.474799,7692,10916,52794,6375,-18351,7239,6375,59149,59169,34443,60033,59169
26067,MI,10932,7006,9078,11236,5652,4891,8937,7368,8329.786674,7692,10906,50119,5837,-18889,6437,5837,57732,55956,31230,56556,55956
26069,MI,11268,7006,9078,11236,5652,4891,8990,7006,8980.551257,7692,11236,51074,5837,-18889,6437,5837,58121,56911,32185,57511,56911
26071,MI,9756,7006,9078,11236,5652,4891,8751,7006,8590.092507,7692,11236,49171,5567,-19159,6035,5567,56370,54738,30012,55206,54738
26073,MI,11052,7006,9078,11236,5652,4891,8956,7908,8525.016049,7692,10260,50327,5837,-18889,6437,5837,57871,56164,31438,56764,56164
26075,MI,12744,7006,9078,11236,5652,4891,9223,7259,8102.019069,7692,10706,51395,6375,-18351,7239,6375,59830,57770,33044,58634,57770
26077,MI,11340,7006,9078,11236,5652,4891,9001,7956,8655.168965,7692,10833,51367,5837,-18889,6437,5837,58204,57204,32478,57804,57204
26079,MI,11892,7006,9078,11236,5652,4891,9088,6688,9078.165945,7692,10863,51104,5837,-18889,6437,5837,58843,56941,32215,57541,56941
26081,MI,12396,7006,9078,11236,5652,4891,9168,8143,8525.016049,7692,11284,52931,6375,-18351,7239,6375,59427,59306,34580,60170,59306
26083,MI,11376,7006,9078,11236,5652,4891,9007,5932,9305.933549,7692,10035,49231,5567,-19159,6035,5567,58246,54798,30072,55266,54798
26085,MI,10512,7006,9078,11236,5652,4891,8871,7006,8199.633757,7692,11236,49537,5837,-18889,6437,5837,57246,55374,30648,55974,55374
26087,MI,13488,7006,9078,11236,5652,4891,9340,7424,8785.321882,7692,11018,53298,6375,-18351,7239,6375,60691,59673,34947,60537,59673
26089,MI,11976,7006,9078,11236,5652,4891,9102,7634,14902.50897,7692,10897,57993,6375,-18351,7239,6375,58941,64368,39642,65232,64368
26091,MI,10452,7006,9078,11236,5652,4891,8861,7175,7809.175006,7692,10800,48819,5837,-18889,6437,5837,57176,54656,29930,55256,54656
26093,MI,15432,7006,9078,11236,5652,4891,9647,8511,8785.321882,7692,11007,56319,7451,-16947,8843,7451,62942,63770,39372,65162,63770
26095,MI,10860,7006,9078,11236,5652,4891,8926,7006,9175.780633,7692,11236,50861,5837,-18889,6437,5837,57649,56698,31972,57298,56698
26097,MI,9900,7006,9078,11236,5652,4891,8774,7006,9110.704174,7692,11236,49836,5567,-19159,6035,5567,56537,55403,30677,55871,55403
26099,MI,13488,7006,9078,11236,5652,4891,9340,8329,8817.860111,7692,10983,54200,6913,-17813,8041,6913,60691,61113,36387,62241,61113
26101,MI,9708,7006,9078,11236,5652,4891,8744,7006,9143.242403,7692,11236,49676,5567,-19159,6035,5567,56315,55243,30517,55711,55243
26103,MI,10392,7006,9078,11236,5652,4891,8852,7060,9403.548237,7692,10681,50119,5567,-19159,6035,5567,57107,55686,30960,56154,55686
26105,MI,10524,7006,9078,11236,5652,4891,8873,7125,8329.786674,7692,10269,48830,5567,-19159,6035,5567,57260,54397,29671,54865,54397
26107,MI,10632,7006,9078,11236,5652,4891,8890,7187,8264.710215,7692,10143,48809,5567,-19159,6035,5567,57385,54376,29650,54844,54376
26109,MI,10128,7006,9078,11236,5652,4891,8810,6264,10542.38626,7692,10246,49764,5299,-19427,5635,5299,56801,55063,30337,55399,55063
26111,MI,13152,7006,9078,11236,5652,4891,9287,7611,9143.242403,7692,10951,53441,6375,-18351,7239,6375,60302,59816,35090,60680,59816
26113,MI,10788,7006,9078,11236,5652,4891,8914,6463,8915.474799,7692,10600,49350,5567,-19159,6035,5567,57565,54917,30191,55385,54917
26115,MI,13032,7006,9078,11236,5652,4891,9268,7770,8622.630736,7692,11104,53111,6375,-18351,7239,6375,60163,59486,34760,60350,59486
26117,MI,11064,7006,9078,11236,5652,4891,8958,6774,8199.633757,7692,11276,49896,5837,-18889,6437,5837,57885,55733,31007,56333,55733
26119,MI,11136,7006,9078,11236,5652,4891,8969,7006,8817.860111,7692,11236,50779,5837,-18889,6437,5837,57968,56616,31890,57216,56616
26121,MI,10440,7006,9078,11236,5652,4891,8859,6846,8134.557298,7692,10460,48463,5567,-19159,6035,5567,57162,54030,29304,54498,54030
26123,MI,10032,7006,9078,11236,5652,4891,8795,7006,8004.404382,7692,11236,48861,5567,-19159,6035,5567,56690,54428,29702,54896,54428
26125,MI,13488,7006,9078,11236,5652,4891,9340,9268,8980.551257,7692,10985,55305,6913,-17813,8041,6913,60691,62218,37492,63346,62218
26127,MI,9840,7006,9078,11236,5652,4891,8765,7006,8687.707195,7692,11236,49353,5567,-19159,6035,5567,56468,54920,30194,55388,54920
26129,MI,9540,7006,9078,11236,5652,4891,8717,7006,8427.401361,7692,11236,48792,5567,-19159,6035,5567,56120,54359,29633,54827,54359
26131,MI,10116,7006,9078,11236,5652,4891,8808,7006,8622.630736,7692,11236,49564,5837,-18889,6437,5837,56787,55401,30675,56001,55401
26133,MI,10836,7006,9078,11236,5652,4891,8922,7006,6963.181047,7692,11236,48624,5837,-18889,6437,5837,57621,54461,29735,55061,54461
26135,MI,10236,7006,9078,11236,5652,4891,8827,7006,8785.321882,7692,11236,49846,5837,-18889,6437,5837,56926,55683,30957,56283,55683
26137,MI,11196,7006,9078,11236,5652,4891,8979,7006,8948.013028,7692,11236,50969,5837,-18889,6437,5837,58038,56806,32080,57406,56806
26139,MI,13044,7006,9078,11236,5652,4891,9270,7970,8297.248444,7692,11281,53175,6375,-18351,7239,6375,60177,59550,34824,60414,59550
26141,MI,10788,7006,9078,11236,5652,4891,8914,7006,9045.627716,7692,11236,50659,5837,-18889,6437,5837,57565,56496,31770,57096,56496
26143,MI,10080,7006,9078,11236,5652,4891,8803,7006,8557.554278,7692,11236,49463,5567,-19159,6035,5567,56746,55030,30304,55498,55030
26145,MI,11328,7006,9078,11236,5652,4891,8999,7014,8199.633757,7692,10537,49661,5837,-18889,6437,5837,58190,55498,30772,56098,55498
26147,MI,13488,7006,9078,11236,5652,4891,9340,7475,8427.401361,7692,11005,52978,6375,-18351,7239,6375,60691,59353,34627,60217,59353
26149,MI,10428,7006,9078,11236,5652,4891,8857,6695,8264.710215,7692,10831,48801,5567,-19159,6035,5567,57148,54368,29642,54836,54368
26151,MI,9972,7006,9078,11236,5652,4891,8786,7006,8199.633757,7692,11236,48997,5567,-19159,6035,5567,56621,54564,29838,55032,54564
26153,MI,9516,7006,9078,11236,5652,4891,8714,7006,8948.013028,7692,11236,49289,5567,-19159,6035,5567,56093,54856,30130,55324,54856
26155,MI,10176,7006,9078,11236,5652,4891,8818,6996,7809.175006,7692,10743,48308,5567,-19159,6035,5567,56857,53875,29149,54343,53875
26157,MI,10572,7006,9078,11236,5652,4891,8880,7006,8134.557298,7692,11236,49532,5837,-18889,6437,5837,57315,55369,30643,55969,55369
26159,MI,11340,7006,9078,11236,5652,4891,9001,7232,8655.168965,7692,10840,50650,5837,-18889,6437,5837,58204,56487,31761,57087,56487
26161,MI,15612,7006,9078,11236,5652,4891,9675,9721,9208.318862,7692,11194,58319,7989,-15986,9645,7989,63150,66308,42333,67964,66308
26163,MI,13488,7006,9078,11236,5652,4891,9340,7811,8590.092507,7692,10973,53444,6375,-18351,7239,6375,60691,59819,35093,60683,59819
26165,MI,10668,7006,9078,11236,5652,4891,8895,7023,8297.248444,7692,10562,49134,5567,-19159,6035,5567,57426,54701,29975,55169,54701
27001,MN,12480,13602,9078,11236,5900,4891,11322,13602,8882.93657,7968,11236,59060,7784,-16191,9440,7784,68509,66844,42869,68500,66844
27003,MN,15984,13602,9078,11236,5900,4891,11973,15447,8687.707195,7968,12078,65055,9566,-13139,12014,9566,72664,74621,51916,77069,74621
27005,MN,10092,13602,9078,11236,5900,4891,10879,13602,8915.474799,7968,11236,56704,7190,-17208,8582,7190,65678,63894,39496,65286,63894
27007,MN,11160,13602,9078,11236,5900,4891,11077,13433,8785.321882,7968,10795,57032,7190,-17208,8582,7190,66944,64222,39824,65614,64222
27009,MN,11916,13602,9078,11236,5900,4891,11218,14164,9859.083446,7968,11342,60140,7784,-16191,9440,7784,67841,67924,43949,69580,67924
27011,MN,9516,13602,9078,11236,5900,4891,10772,13602,8882.93657,7968,11236,56096,7190,-17208,8582,7190,64995,63286,38888,64678,63286
27013,MN,11592,13602,9078,11236,5900,4891,11158,14146,8720.245424,7968,11433,58750,7784,-16191,9440,7784,67457,66534,42559,68190,66534
27015,MN,9516,13602,9078,11236,5900,4891,10772,11848,9273.39532,7968,10795,54292,6596,-18130,7724,6596,64995,60888,36162,62016,60888
27017,MN,10824,13602,9078,11236,5900,4891,11015,12511,9305.933549,7968,10683,56183,6596,-18130,7724,6596,66546,62779,38053,63907,62779
27019,MN,15984,13602,9078,11236,5900,4891,11973,17176,11843.91543,7968,12054,69917,10160,-12122,12872,10160,72664,80077,57795,82789,80077
27021,MN,10680,13602,9078,11236,5900,4891,10988,12149,8492.477819,7968,10536,54716,6596,-18130,7724,6596,66375,61312,36586,62440,61312
27023,MN,11424,13602,9078,11236,5900,4891,11126,13602,9110.704174,7968,11236,58232,7784,-16191,9440,7784,67257,66016,42041,67672,66016
27025,MN,15984,13602,9078,11236,5900,4891,11973,14283,9663.85407,7968,12041,64832,9566,-13139,12014,9566,72664,74398,51693,76846,74398
27027,MN,12096,13602,9078,11236,5900,4891,11251,14163,9533.701154,7968,11270,59921,7784,-16191,9440,7784,68054,67705,43730,69361,67705
27029,MN,9540,13602,9078,11236,5900,4891,10776,13602,8915.474799,7968,11236,56152,7190,-17208,8582,7190,65023,63342,38944,64734,63342
27031,MN,12156,13602,9078,11236,5900,4891,11262,13602,9078.165945,7968,11236,58931,7784,-16191,9440,7784,68125,66715,42740,68371,66715
27033,MN,11268,13602,9078,11236,5900,4891,11097,13602,8915.474799,7968,11236,57880,7784,-16191,9440,7784,67072,65664,41689,67320,65664
27035,MN,12744,13602,9078,11236,5900,4891,11371,12765,8590.092507,7968,10476,57435,7190,-17208,8582,7190,68822,64625,40227,66017,64625
27037,MN,15984,13602,9078,11236,5900,4891,11973,17313,9501.162924,7968,12099,67756,10160,-12122,12872,10160,72664,77916,55634,80628,77916
27039,MN,13872,13602,9078,11236,5900,4891,11581,13313,8948.013028,7968,11946,60938,8378,-15174,10298,8378,70160,69316,45764,71236,69316
27041,MN,10392,13602,9078,11236,5900,4891,10935,13085,9110.704174,7968,10863,56309,7190,-17208,8582,7190,66034,63499,39101,64891,63499
27043,MN,11268,13602,9078,11236,5900,4891,11097,13602,8850.398341,7968,11236,57815,7784,-16191,9440,7784,67072,65599,41624,67255,65599
27045,MN,10980,13602,9078,11236,5900,4891,11044,11952,8817.860111,7968,11931,56540,7190,-17208,8582,7190,66731,63730,39332,65122,63730
27047,MN,9516,13602,9078,11236,5900,4891,10772,11710,9501.162924,7968,10706,54292,6002,-18724,6866,6002,64995,60294,35568,61158,60294
27049,MN,13044,13602,9078,11236,5900,4891,11427,14545,9924.159904,7968,11250,61622,8378,-15174,10298,8378,69178,70000,46448,71920,70000
27051,MN,11268,13602,9078,11236,5900,4891,11097,13602,9110.704174,7968,11236,58076,7784,-16191,9440,7784,67072,65860,41885,67516,65860
27053,MN,15984,13602,9078,11236,5900,4891,11973,17530,9598.777612,7968,12151,68123,10160,-12122,12872,10160,72664,78283,56001,80995,78283
27055,MN,11664,13602,9078,11236,5900,4891,11171,12143,8752.783653,7968,11198,56617,7190,-17208,8582,7190,67542,63807,39409,65199,63807
27057,MN,11136,13602,9078,11236,5900,4891,11073,13602,9045.627716,7968,11236,57879,7190,-17208,8582,7190,66916,65069,40671,66461,65069
27059,MN,15984,13602,9078,11236,5900,4891,11973,14021,9305.933549,7968,12049,64219,8972,-14157,11156,8972,72664,73191,50062,75375,73191
27061,MN,11160,13602,9078,11236,5900,4891,11077,13602,8948.013028,7968,11236,57805,7190,-17208,8582,7190,66944,64995,40597,66387,64995
27063,MN,10908,13602,9078,11236,5900,4891,11030,13602,8752.783653,7968,11236,57358,7190,-17208,8582,7190,66645,64548,40150,65940,64548
27065,MN,12264,13602,9078,11236,5900,4891,11282,13602,8948.013028,7968,11236,58909,7784,-16191,9440,7784,68253,66693,42718,68349,66693
27067,MN,9816,13602,9078,11236,5900,4891,10828,13233,9078.165945,7968,11094,56080,7190,-17208,8582,7190,65351,63270,38872,64662,63270
27069,MN,10716,13602,9078,11236,5900,4891,10995,13602,9078.165945,7968,11236,57491,7190,-17208,8582,7190,66418,64681,40283,66073,64681
27071,MN,9516,13602,9078,11236,5900,4891,10772,13602,8882.93657,7968,11236,56096,7190,-17208,8582,7190,64995,63286,38888,64678,63286
27073,MN,9516,13602,9078,11236,5900,4891,10772,13602,9078.165945,7968,11236,56291,7190,-17208,8582,7190,64995,63481,39083,64873,63481
27075,MN,11016,13602,9078,11236,5900,4891,11051,13602,9143.242403,7968,11236,57856,7190,-17208,8582,7190,66774,65046,40648,66438,65046
27077,MN,9516,13602,9078,11236,5900,4891,10772,13602,8882.93657,7968,11236,56096,7190,-17208,8582,7190,64995,63286,38888,64678,63286
27079,MN,10668,13602,9078,11236,5900,4891,10986,13174,8850.398341,7968,12041,57593,7190,-17208,8582,7190,66361,64783,40385,66175,64783
27081,MN,9516,13602,9078,11236,5900,4891,10772,13602,9403.548237,7968,11236,56617,7190,-17208,8582,7190,64995,63807,39409,65199,63807
27083,MN,11268,13602,9078,11236,5900,4891,11097,12645,9305.933549,7968,11148,57226,7190,-17208,8582,7190,67072,64416,40018,65808,64416
27085,MN,11088,13602,9078,11236,5900,4891,11064,13761,9403.548237,7968,11257,58368,7784,-16191,9440,7784,66859,66152,42177,67808,66152
27087,MN,9516,13602,9078,11236,5900,4891,10772,13602,9110.704174,7968,11236,56324,7190,-17208,8582,7190,64995,63514,39116,64906,63514
27089,MN,10560,13602,9078,11236,5900,4891,10966,13602,8948.013028,7968,11236,57205,7190,-17208,8582,7190,66233,64395,39997,65787,64395
27091,MN,9936,13602,9078,11236,5900,4891,10850,13602,9175.780633,7968,11236,56809,7190,-17208,8582,7190,65493,63999,39601,65391,63999
27093,MN,11220,13602,9078,11236,5900,4891,11088,13602,9305.933549,7968,11236,58223,7190,-17208,8582,7190,67015,65413,41015,66805,65413
27095,MN,10848,13602,9078,11236,5900,4891,11019,13276,8915.474799,7968,12041,57939,7784,-16191,9440,7784,66574,65723,41748,67379,65723
27097,MN,9864,13602,9078,11236,5900,4891,10837,13602,9110.704174,7968,11236,56672,7190,-17208,8582,7190,65408,63862,39464,65254,63862
27099,MN,11280,13602,9078,11236,5900,4891,11100,12003,7906.789694,7968,10905,54954,7190,-17208,8582,7190,67087,62144,37746,63536,62144
27101,MN,9516,13602,9078,11236,5900,4891,10772,13602,8785.321882,7968,11236,55998,7190,-17208,8582,7190,64995,63188,38790,64580,63188
27103,MN,11592,13602,9078,11236,5900,4891,11158,14201,10151.92751,7968,11430,60234,7784,-16191,9440,7784,67457,68018,44043,69674,68018
27105,MN,11268,13602,9078,11236,5900,4891,11097,11912,8232.171986,7968,11265,55536,7190,-17208,8582,7190,67072,62726,38328,64118,62726
27107,MN,11268,13602,9078,11236,5900,4891,11097,13602,9143.242403,7968,11236,58108,7784,-16191,9440,7784,67072,65892,41917,67548,65892
27109,MN,13872,13602,9078,11236,5900,4891,11581,14901,8948.013028,7968,11972,62552,8972,-14157,11156,8972,70160,71524,48395,73708,71524
27111,MN,10920,13602,9078,11236,5900,4891,11033,12515,9143.242403,7968,10765,56202,7190,-17208,8582,7190,66660,63392,38994,64784,63392
27113,MN,9516,13602,9078,11236,5900,4891,10772,13602,8948.013028,7968,11236,56161,7190,-17208,8582,7190,64995,63351,38953,64743,63351
27115,MN,11352,13602,9078,11236,5900,4891,11113,13602,9208.318862,7968,11236,58257,7784,-16191,9440,7784,67172,66041,42066,67697,66041
27117,MN,11244,13602,9078,11236,5900,4891,11093,13602,8817.860111,7968,11236,57759,7784,-16191,9440,7784,67044,65543,41568,67199,65543
27119,MN,11772,13602,9078,11236,5900,4891,11191,12709,9273.39532,7968,11031,57645,7190,-17208,8582,7190,67670,64835,40437,66227,64835
27121,MN,10428,13602,9078,11236,5900,4891,10941,13602,9078.165945,7968,11236,57203,7190,-17208,8582,7190,66076,64393,39995,65785,64393
27123,MN,15984,13602,9078,11236,5900,4891,11973,16590,9501.162924,7968,12155,67089,10160,-12122,12872,10160,72664,77249,54967,79961,77249
27125,MN,10908,13602,9078,11236,5900,4891,11030,13602,9240.857091,7968,11236,57846,7190,-17208,8582,7190,66645,65036,40638,66428,65036
27127,MN,10284,13602,9078,11236,5900,4891,10915,13602,9175.780633,7968,11236,57157,7190,-17208,8582,7190,65906,64347,39949,65739,64347
27129,MN,9516,13602,9078,11236,5900,4891,10772,13602,9240.857091,7968,11236,56454,7190,-17208,8582,7190,64995,63644,39246,65036,63644
27131,MN,14772,13602,9078,11236,5900,4891,11748,14598,8785.321882,7968,11289,62303,8972,-14157,11156,8972,71227,71275,48146,73459,71275
27133,MN,9516,13602,9078,11236,5900,4891,10772,13602,8752.783653,7968,11236,55966,7190,-17208,8582,7190,64995,63156,38758,64548,63156
27135,MN,9516,13602,9078,11236,5900,4891,10772,13602,8948.013028,7968,11236,56161,7190,-17208,8582,7190,64995,63351,38953,64743,63351
27137,MN,10824,13602,9078,11236,5900,4891,11015,12933,9110.704174,7968,10635,56363,7190,-17208,8582,7190,66546,63553,39155,64945,63553
27139,MN,15984,13602,9078,11236,5900,4891,11973,17042,8915.474799,7968,12055,66856,10160,-12122,12872,10160,72664,77016,54734,79728,77016
27141,MN,15984,13602,9078,11236,5900,4891,11973,14342,8525.016049,7968,12015,63725,9566,-13139,12014,9566,72664,73291,50586,75739,73291
27143,MN,11268,13602,9078,11236,5900,4891,11097,12203,9338.471779,7968,12032,57701,7190,-17208,8582,7190,67072,64891,40493,66283,64891
27145,MN,11916,13602,9078,11236,5900,4891,11218,13526,9110.704174,7968,11341,58753,7784,-16191,9440,7784,67841,66537,42562,68193,66537
27147,MN,12228,13602,9078,11236,5900,4891,11276,13559,9566.239383,7968,11399,59612,7784,-16191,9440,7784,68211,67396,43421,69052,67396
27149,MN,9516,13602,9078,11236,5900,4891,10772,13602,9045.627716,7968,11236,56259,7190,-17208,8582,7190,64995,63449,39051,64841,63449
27151,MN,11256,13602,9078,11236,5900,4891,11095,13602,9045.627716,7968,11236,57999,7784,-16191,9440,7784,67058,65783,41808,67439,65783
27153,MN,12396,13602,9078,11236,5900,4891,11307,13602,9078.165945,7968,11236,59171,7784,-16191,9440,7784,68410,66955,42980,68611,66955
27155,MN,9516,13602,9078,11236,5900,4891,10772,13602,9110.704174,7968,11236,56324,7190,-17208,8582,7190,64995,63514,39116,64906,63514
27157,MN,11268,13602,9078,11236,5900,4891,11097,13272,9566.239383,7968,11950,58915,7784,-16191,9440,7784,67072,66699,42724,68355,66699
27159,MN,10068,13602,9078,11236,5900,4891,10875,13602,8785.321882,7968,11236,56550,7190,-17208,8582,7190,65650,63740,39342,65132,63740
27161,MN,11400,13602,9078,11236,5900,4891,11122,13602,8948.013028,7968,11236,58045,7784,-16191,9440,7784,67229,65829,41854,67485,65829
27163,MN,15984,13602,9078,11236,5900,4891,11973,16748,9468.624695,7968,12059,67118,10160,-12122,12872,10160,72664,77278,54996,79990,77278
27165,MN,11268,13602,9078,11236,5900,4891,11097,13602,8882.93657,7968,11236,57848,7784,-16191,9440,7784,67072,65632,41657,67288,65632
27167,MN,10284,13602,9078,11236,5900,4891,10915,11268,9175.780633,7968,11024,54610,6596,-18130,7724,6596,65906,61206,36480,62334,61206
27169,MN,10164,13602,9078,11236,5900,4891,10892,13375,10021.77459,7968,11218,57638,7190,-17208,8582,7190,65763,64828,40430,66220,64828
27171,MN,15984,13602,9078,11236,5900,4891,11973,15001,10086.85105,7968,12048,65979,9566,-13139,12014,9566,72664,75545,52840,77993,75545
27173,MN,11244,13602,9078,11236,5900,4891,11093,13602,9175.780633,7968,11236,58117,7784,-16191,9440,7784,67044,65901,41926,67557,65901
28001,MS,9660,14216,8887,11553,6070,5178,8116,13696,9110.137856,8944,11553,58142,7251,-17147,8643,7251,63680,65393,40995,66785,65393
28003,MS,9996,14216,8887,11553,6070,5178,8168,13790,9205.698742,8944,11553,58667,7804,-16171,9460,7804,64068,66471,42496,68127,66471
28005,MS,10056,14216,8887,11553,6070,5178,8177,14207,9428.674144,8944,11553,59367,7804,-16171,9460,7804,64137,67171,43196,68827,67171
28007,MS,10860,14216,8887,11553,6070,5178,8302,14216,9842.771319,8944,11553,60594,7804,-16171,9460,7804,65066,68398,44423,70054,68398
28009,MS,9480,14216,8887,11553,6070,5178,8088,13414,9205.698742,8944,11553,57775,7251,-17147,8643,7251,63472,65026,40628,66418,65026
28011,MS,9300,14216,8887,11553,6070,5178,8060,13815,9396.820515,8944,11553,58187,7251,-17147,8643,7251,63264,65438,41040,66830,65438
28013,MS,10404,14216,8887,11553,6070,5178,8231,14216,9428.674144,8944,11553,59724,7804,-16171,9460,7804,64539,67528,43553,69184,67528
28015,MS,15252,14216,8887,11553,6070,5178,8983,14333,9364.966886,8944,11553,64625,9463,-13242,11911,9463,70139,74088,51383,76536,74088
28017,MS,9180,14216,8887,11553,6070,5178,8041,14216,9141.991484,8944,11553,58213,7251,-17147,8643,7251,63125,65464,41066,66856,65464
28019,MS,10860,14216,8887,11553,6070,5178,8302,14216,9524.235031,8944,11553,60275,7804,-16171,9460,7804,65066,68079,44104,69735,68079
28021,MS,9744,14216,8887,11553,6070,5178,8129,14111,9110.137856,8944,11553,58640,7804,-16171,9460,7804,63777,66444,42469,68100,66444
28023,MS,10860,14216,8887,11553,6070,5178,8302,14180,9014.576969,8944,11553,59730,7804,-16171,9460,7804,65066,67534,43559,69190,67534
28025,MS,9840,14216,8887,11553,6070,5178,8144,14216,9046.430598,8944,11553,58777,7804,-16171,9460,7804,63888,66581,42606,68237,66581
28027,MS,9564,14216,8887,11553,6070,5178,8101,13670,9141.991484,8944,11553,58051,7251,-17147,8643,7251,63569,65302,40904,66694,65302
28029,MS,11520,14216,8887,11553,6070,5178,8404,14350,8887.162454,8944,11553,60432,8357,-15195,10277,8357,65828,68789,45237,70709,68789
28031,MS,10860,14216,8887,11553,6070,5178,8302,14216,9014.576969,8944,11553,59766,7804,-16171,9460,7804,65066,67570,43595,69226,67570
28033,MS,12792,14216,8887,11553,6070,5178,8602,15515,8823.455196,8944,11553,62806,8910,-14219,11094,8910,67298,71716,48587,73900,71716
28035,MS,11544,14216,8887,11553,6070,5178,8408,15445,9396.820515,8944,11553,62061,8357,-15195,10277,8357,65856,70418,46866,72338,70418
28037,MS,10860,14216,8887,11553,6070,5178,8302,14216,8950.869711,8944,11553,59702,7804,-16171,9460,7804,65066,67506,43531,69162,67506
28039,MS,13476,14216,8887,11553,6070,5178,8708,14216,9046.430598,8944,11553,62413,8910,-14219,11094,8910,68088,71323,48194,73507,71323
28041,MS,10860,14216,8887,11553,6070,5178,8302,14216,9492.381402,8944,11553,60243,7804,-16171,9460,7804,65066,68047,44072,69703,68047
28043,MS,9288,14216,8887,11553,6070,5178,8058,13526,9492.381402,8944,11553,57982,7251,-17147,8643,7251,63250,65233,40835,66625,65233
28045,MS,12780,14216,8887,11553,6070,5178,8600,15826,9587.942289,8944,11553,63869,8910,-14219,11094,8910,67284,72779,49650,74963,72779
28047,MS,12780,14216,8887,11553,6070,5178,8600,16806,9237.552371,8944,11553,64499,9463,-13242,11911,9463,67284,73962,51257,76410,73962
28049,MS,11520,14216,8887,11553,6070,5178,8404,15017,9173.845113,8944,11553,61386,8357,-15195,10277,8357,65828,69743,46191,71663,69743
28051,MS,9180,14216,8887,11553,6070,5178,8041,14216,10097.60035,8944,11553,59169,7251,-17147,8643,7251,63125,66420,42022,67812,66420
28053,MS,10728,14216,8887,11553,6070,5178,8281,14216,9237.552371,8944,11553,59857,7804,-16171,9460,7804,64913,67661,43686,69317,67661
28055,MS,17148,14216,8887,11553,6070,5178,9278,14216,9173.845113,8944,11553,66213,9463,-13242,11911,9463,72330,75676,52971,78124,75676
28057,MS,10860,14216,8887,11553,6070,5178,8302,13731,8950.869711,8944,11553,59217,7804,-16171,9460,7804,65066,67021,43046,68677,67021
28059,MS,13476,14216,8887,11553,6070,5178,8708,15860,9779.064062,8944,11553,64790,8910,-14219,11094,8910,68088,73700,50571,75884,73700
28061,MS,10860,14216,8887,11553,6070,5178,8302,13930,8982.72334,8944,11553,59447,7804,-16171,9460,7804,65066,67251,43276,68907,67251
28063,MS,9960,14216,8887,11553,6070,5178,8162,14216,9141.991484,8944,11553,58993,7804,-16171,9460,7804,64026,66797,42822,68453,66797
28065,MS,10860,14216,8887,11553,6070,5178,8302,14216,8919.016082,8944,11553,59670,7804,-16171,9460,7804,65066,67474,43499,69130,67474
28067,MS,12516,14216,8887,11553,6070,5178,8559,14555,8950.869711,8944,11553,61697,8357,-15195,10277,8357,66979,70054,46502,71974,70054
28069,MS,9612,14216,8887,11553,6070,5178,8108,12557,9205.698742,8944,11553,57050,7251,-17147,8643,7251,63624,64301,39903,65693,64301
28071,MS,12480,14216,8887,11553,6070,5178,8553,16824,10702.8193,8944,11553,65682,8910,-14219,11094,8910,66937,74592,51463,76776,74592
28073,MS,11544,14216,8887,11553,6070,5178,8408,16688,8950.869711,8944,11553,62858,8910,-14219,11094,8910,65856,71768,48639,73952,71768
28075,MS,10524,14216,8887,11553,6070,5178,8250,15462,9014.576969,8944,11553,60676,8357,-15195,10277,8357,64678,69033,45481,70953,69033
28077,MS,10044,14216,8887,11553,6070,5178,8175,14216,9078.284227,8944,11553,59013,7804,-16171,9460,7804,64123,66817,42842,68473,66817
28079,MS,10164,14216,8887,11553,6070,5178,8194,14216,8727.894309,8944,11553,58783,7804,-16171,9460,7804,64262,66587,42612,68243,66587
28081,MS,10032,14216,8887,11553,6070,5178,8173,14808,8855.308825,8944,11553,59370,7804,-16171,9460,7804,64109,67174,43199,68830,67174
28083,MS,9180,14216,8887,11553,6070,5178,8041,13235,9556.08866,8944,11553,57646,7251,-17147,8643,7251,63125,64897,40499,66289,64897
28085,MS,9696,14216,8887,11553,6070,5178,8121,15500,9269.406,8944,11553,60141,7804,-16171,9460,7804,63721,67945,43970,69601,67945
28087,MS,11112,14216,8887,11553,6070,5178,8341,14815,9460.527773,8944,11553,61063,8357,-15195,10277,8357,65357,69420,45868,71340,69420
28089,MS,11520,14216,8887,11553,6070,5178,8404,17281,10543.55115,8944,11553,65019,8910,-14219,11094,8910,65828,73929,50800,76113,73929
28091,MS,9180,14216,8887,11553,6070,5178,8041,14216,9014.576969,8944,11553,58086,7251,-17147,8643,7251,63125,65337,40939,66729,65337
28093,MS,10584,14216,8887,11553,6070,5178,8259,15712,9078.284227,8944,11553,61049,8357,-15195,10277,8357,64747,69406,45854,71326,69406
28095,MS,9612,14216,8887,11553,6070,5178,8108,14216,8823.455196,8944,11553,58326,7804,-16171,9460,7804,63624,66130,42155,67786,66130
28097,MS,10332,14216,8887,11553,6070,5178,8220,14216,9333.113258,8944,11553,59556,7804,-16171,9460,7804,64456,67360,43385,69016,67360
28099,MS,9912,14216,8887,11553,6070,5178,8155,14216,9014.576969,8944,11553,58818,7804,-16171,9460,7804,63971,66622,42647,68278,66622
28101,MS,11016,14216,8887,11553,6070,5178,8326,14216,9046.430598,8944,11553,59953,7804,-16171,9460,7804,65246,67757,43782,69413,67757
28103,MS,10860,14216,8887,11553,6070,5178,8302,14216,9396.820515,8944,11553,60148,7804,-16171,9460,7804,65066,67952,43977,69608,67952
28105,MS,12312,14216,8887,11553,6070,5178,8527,16867,9747.210433,8944,11553,64601,8910,-14219,11094,8910,66743,73511,50382,75695,73511
28107,MS,10320,14216,8887,11553,6070,5178,8218,14216,9269.406,8944,11553,59480,7804,-16171,9460,7804,64442,67284,43309,68940,67284
28109,MS,11892,14216,8887,11553,6070,5178,8462,15180,9269.406,8944,11553,62016,8357,-15195,10277,8357,66258,70373,46821,72293,70373
28111,MS,11544,14216,8887,11553,6070,5178,8408,15143,9014.576969,8944,11553,61377,8357,-15195,10277,8357,65856,69734,46182,71654,69734
28113,MS,9756,14216,8887,11553,6070,5178,8131,15049,8727.894309,8944,11553,59208,7804,-16171,9460,7804,63791,67012,43037,68668,67012
28115,MS,9948,14216,8887,11553,6070,5178,8160,14402,9396.820515,8944,11553,59422,7804,-16171,9460,7804,64012,67226,43251,68882,67226
28117,MS,10272,14216,8887,11553,6070,5178,8211,14216,8855.308825,8944,11553,59018,7804,-16171,9460,7804,64387,66822,42847,68478,66822
28119,MS,9180,14216,8887,11553,6070,5178,8041,14216,9046.430598,8944,11553,58117,7251,-17147,8643,7251,63125,65368,40970,66760,65368
28121,MS,11520,14216,8887,11553,6070,5178,8404,16260,9237.552371,8944,11553,62693,8910,-14219,11094,8910,65828,71603,48474,73787,71603
28123,MS,9912,14216,8887,11553,6070,5178,8155,14216,8919.016082,8944,11553,58722,7804,-16171,9460,7804,63971,66526,42551,68182,66526
28125,MS,9180,14216,8887,11553,6070,5178,8041,14216,9173.845113,8944,11553,58245,7251,-17147,8643,7251,63125,65496,41098,66888,65496
28127,MS,9240,14216,8887,11553,6070,5178,8050,14892,9110.137856,8944,11553,58917,7804,-16171,9460,7804,63194,66721,42746,68377,66721
28129,MS,10476,14216,8887,11553,6070,5178,8242,14216,9141.991484,8944,11553,59509,7804,-16171,9460,7804,64622,67313,43338,68969,67313
28131,MS,12780,14216,8887,11553,6070,5178,8600,14216,9587.942289,8944,11553,62259,8357,-15195,10277,8357,67284,70616,47064,72536,70616
28133,MS,9648,14216,8887,11553,6070,5178,8114,12348,9524.235031,8944,11553,57195,7251,-17147,8643,7251,63666,64446,40048,65838,64446
28135,MS,10860,14216,8887,11553,6070,5178,8302,14216,9364.966886,8944,11553,60116,7804,-16171,9460,7804,65066,67920,43945,69576,67920
28137,MS,10608,14216,8887,11553,6070,5178,8263,15868,8727.894309,8944,11553,60879,8357,-15195,10277,8357,64775,69236,45684,71156,69236
28139,MS,9792,14216,8887,11553,6070,5178,8136,14216,9460.527773,8944,11553,59144,7804,-16171,9460,7804,63832,66948,42973,68604,66948
28141,MS,10728,14216,8887,11553,6070,5178,8281,14216,8791.601567,8944,11553,59411,7804,-16171,9460,7804,64913,67215,43240,68871,67215
28143,MS,10368,14216,8887,11553,6070,5178,8225,15760,8887.162454,8944,11553,60690,8357,-15195,10277,8357,64497,69047,45495,70967,69047
28145,MS,10860,14216,8887,11553,6070,5178,8302,14216,8982.72334,8944,11553,59734,7804,-16171,9460,7804,65066,67538,43563,69194,67538
28147,MS,11448,14216,8887,11553,6070,5178,8393,14216,9110.137856,8944,11553,60449,8357,-15195,10277,8357,65745,68806,45254,70726,68806
28149,MS,10212,14216,8887,11553,6070,5178,8201,15309,9269.406,8944,11553,60466,8357,-15195,10277,8357,64317,68823,45271,70743,68823
28151,MS,10344,14216,8887,11553,6070,5178,8222,13794,9046.430598,8944,11553,58859,7804,-16171,9460,7804,64470,66663,42688,68319,66663
28153,MS,9216,14216,8887,11553,6070,5178,8047,14216,9460.527773,8944,11553,58568,7251,-17147,8643,7251,63167,65819,41421,67211,65819
28155,MS,10860,14216,8887,11553,6070,5178,8302,14216,9524.235031,8944,11553,60275,7804,-16171,9460,7804,65066,68079,44104,69735,68079
28157,MS,9264,14216,8887,11553,6070,5178,8054,14216,9396.820515,8944,11553,58552,7804,-16171,9460,7804,63222,66356,42381,68012,66356
28159,MS,10656,14216,8887,11553,6070,5178,8270,14216,9333.113258,8944,11553,59880,7804,-16171,9460,7804,64830,67684,43709,69340,67684
28161,MS,10860,14216,8887,11553,6070,5178,8302,14216,9810.917691,8944,11553,60562,7804,-16171,9460,7804,65066,68366,44391,70022,68366
28163,MS,10008,14216,8887,11553,6070,5178,8170,15074,9874.624948,8944,11553,60631,7804,-16171,9460,7804,64082,68435,44460,70091,68435
29001,MO,9324,7977,9078,11236,6151,4891,7021,7649,7906.789694,9456,9806,49033,5530,-19196,6130,5530,55678,54563,29837,55163,54563
29003,MO,11460,7977,9078,11236,6151,4891,7310,8035,8264.710215,9456,10965,53072,6121,-18605,6985,6121,58103,59193,34467,60057,59193
29005,MO,10536,7977,9078,11236,6151,4891,7185,7977,8882.93657,9456,11236,52979,6121,-18605,6985,6121,57054,59100,34374,59964,59100
29007,MO,10764,7977,9078,11236,6151,4891,7216,7191,7646.48386,9456,10706,50655,6121,-18605,6985,6121,57313,56776,32050,57640,56776
29009,MO,9228,7977,9078,11236,6151,4891,7008,7977,8817.860111,9456,11236,51606,5530,-19196,6130,5530,55569,57136,32410,57736,57136
29011,MO,9000,7977,9078,11236,6151,4891,6977,7977,8167.095528,9456,11236,50727,5530,-19196,6130,5530,55310,56257,31531,56857,56257
29013,MO,10428,7977,9078,11236,6151,4891,7170,7662,8622.630736,9456,11344,52403,6121,-18605,6985,6121,56931,58524,33798,59388,58524
29015,MO,10704,7977,9078,11236,6151,4891,7207,7977,8329.786674,9456,11236,52594,6121,-18605,6985,6121,57244,58715,33989,59579,58715
29017,MO,10572,7977,9078,11236,6151,4891,7190,7281,8687.707195,9456,10855,51742,6121,-18605,6985,6121,57095,57863,33137,58727,57863
29019,MO,12132,7977,9078,11236,6151,4891,7401,9048,9403.548237,9456,11077,56008,6712,-18014,7840,6712,58866,62720,37994,63848,62720
29021,MO,11460,7977,9078,11236,6151,4891,7310,7969,8036.942611,9456,10942,52754,6121,-18605,6985,6121,58103,58875,34149,59739,58875
29023,MO,9036,7977,9078,11236,6151,4891,6982,7368,7874.251465,9456,9933,48558,5234,-19492,5702,5234,55351,53792,29066,54260,53792
29025,MO,14016,7977,9078,11236,6151,4891,7655,7615,9013.089487,9456,11342,56333,7303,-17095,8695,7303,61004,63636,39238,65028,63636
29027,MO,9948,7977,9078,11236,6151,4891,7105,7911,9175.780633,9456,11077,52458,6121,-18605,6985,6121,56386,58579,33853,59443,58579
29029,MO,10680,7977,9078,11236,6151,4891,7204,7977,9598.777612,9456,11236,53839,6121,-18605,6985,6121,57217,59960,35234,60824,59960
29031,MO,10572,7977,9078,11236,6151,4891,7190,8044,8459.93959,9456,10801,52224,6121,-18605,6985,6121,57095,58345,33619,59209,58345
29033,MO,8904,7977,9078,11236,6151,4891,6964,7977,8167.095528,9456,11236,50631,5530,-19196,6130,5530,55201,56161,31435,56761,56161
29035,MO,10536,7977,9078,11236,6151,4891,7185,7977,7906.789694,9456,11236,52003,6121,-18605,6985,6121,57054,58124,33398,58988,58124
29037,MO,14016,7977,9078,11236,6151,4891,7655,8945,8752.783653,9456,11349,57409,7303,-17095,8695,7303,61004,64712,40314,66104,64712
29039,MO,10044,7977,9078,11236,6151,4891,7118,7977,8199.633757,9456,11236,51804,6121,-18605,6985,6121,56495,57925,33199,58789,57925
29041,MO,8904,7977,9078,11236,6151,4891,6964,7977,8004.404382,9456,11236,50468,5530,-19196,6130,5530,55201,55998,31272,56598,55998
29043,MO,11484,7977,9078,11236,6151,4891,7313,8143,9371.010008,9456,10694,54038,6121,-18605,6985,6121,58130,60159,35433,61023,60159
29045,MO,9324,7977,9078,11236,6151,4891,7021,7066,7646.48386,9456,10662,49045,5530,-19196,6130,5530,55678,54575,29849,55175,54575
29047,MO,14016,7977,9078,11236,6151,4891,7655,9099,8882.93657,9456,11346,57690,7303,-17095,8695,7303,61004,64993,40595,66385,64993
29049,MO,14016,7977,9078,11236,6151,4891,7655,8233,9533.701154,9456,11345,57475,7303,-17095,8695,7303,61004,64778,40380,66170,64778
29051,MO,10680,7977,9078,11236,6151,4891,7204,8201,8720.245424,9456,11066,53014,6121,-18605,6985,6121,57217,59135,34409,59999,59135
29053,MO,10536,7977,9078,11236,6151,4891,7185,7977,8687.707195,9456,11236,52784,6121,-18605,6985,6121,57054,58905,34179,59769,58905
29055,MO,8904,7977,9078,11236,6151,4891,6964,7977,9501.162924,9456,11236,51965,5530,-19196,6130,5530,55201,57495,32769,58095,57495
29056,MO,12732,7977,9078,11236,6151,4891,7482,7977,9078,9456,11236,55370,6712,-18014,7840,6712,59547,62082,37356,63210,62082
29057,MO,9708,7977,9078,11236,6151,4891,7073,7977,8557.554278,9456,11236,51826,6121,-18605,6985,6121,56114,57947,33221,58811,57947
29059,MO,8904,7977,9078,11236,6151,4891,6964,7252,8655.168965,9456,10715,49873,5530,-19196,6130,5530,55201,55403,30677,56003,55403
29061,MO,10536,7977,9078,11236,6151,4891,7185,7977,8850.398341,9456,11236,52946,6121,-18605,6985,6121,57054,59067,34341,59931,59067
29063,MO,11460,7977,9078,11236,6151,4891,7310,7999,8167.095528,9456,10943,52916,6121,-18605,6985,6121,58103,59037,34311,59901,59037
29065,MO,10116,7977,9078,11236,6151,4891,7128,7977,8492.477819,9456,11236,52168,6121,-18605,6985,6121,56577,58289,33563,59153,58289
29067,MO,9852,7977,9078,11236,6151,4891,7092,7977,8752.783653,9456,11236,52165,6121,-18605,6985,6121,56277,58286,33560,59150,58286
29069,MO,10536,7977,9078,11236,6151,4891,7185,6765,7516.330944,9456,9572,48737,5530,-19196,6130,5530,57054,54267,29541,54867,54267
29071,MO,12732,7977,9078,11236,6151,4891,7482,8352,8069.48084,9456,11175,54676,6712,-18014,7840,6712,59547,61388,36662,62516,61388
29073,MO,10536,7977,9078,11236,6151,4891,7185,7977,8232.171986,9456,11236,52328,6121,-18605,6985,6121,57054,58449,33723,59313,58449
29075,MO,9816,7977,9078,11236,6151,4891,7087,7977,8232.171986,9456,11236,51608,6121,-18605,6985,6121,56236,57729,33003,58593,57729
29077,MO,11484,7977,9078,11236,6151,4891,7313,7887,8752.783653,9456,10666,53137,6121,-18605,6985,6121,58130,59258,34532,60122,59258
29079,MO,10536,7977,9078,11236,6151,4891,7185,7977,8785.321882,9456,11236,52881,6121,-18605,6985,6121,57054,59002,34276,59866,59002
29081,MO,8964,7977,9078,11236,6151,4891,6972,7977,8850.398341,9456,11236,51374,5530,-19196,6130,5530,55269,56904,32178,57504,56904
29083,MO,10764,7977,9078,11236,6151,4891,7216,7977,7483.792714,9456,11236,51808,6121,-18605,6985,6121,57313,57929,33203,58793,57929
29085,MO,8904,7977,9078,11236,6151,4891,6964,7977,8102.019069,9456,11236,50566,5530,-19196,6130,5530,55201,56096,31370,56696,56096
29087,MO,9336,7977,9078,11236,6151,4891,7023,7977,8394.863132,9456,11236,51291,5530,-19196,6130,5530,55692,56821,32095,57421,56821
29089,MO,12132,7977,9078,11236,6151,4891,7401,7977,8980.551257,9456,11236,54673,6712,-18014,7840,6712,58866,61385,36659,62513,61385
29091,MO,9144,7977,9078,11236,6151,4891,6997,7439,7776.636777,9456,9852,48558,5234,-19492,5702,5234,55474,53792,29066,54260,53792
29093,MO,9528,7977,9078,11236,6151,4891,7048,7977,8492.477819,9456,11236,51580,6121,-18605,6985,6121,55909,57701,32975,58565,57701
29095,MO,14016,7977,9078,11236,6151,4891,7655,8801,8557.554278,9456,11350,57072,7303,-17095,8695,7303,61004,64375,39977,65767,64375
29097,MO,10116,7977,9078,11236,6151,4891,7128,7457,8102.019069,9456,10762,50785,5530,-19196,6130,5530,56577,56315,31589,56915,56315
29099,MO,12732,7977,9078,11236,6151,4891,7482,8631,9013.089487,9456,11172,55895,6712,-18014,7840,6712,59547,62607,37881,63735,62607
29101,MO,11916,7977,9078,11236,6151,4891,7371,8600,8199.633757,9456,10985,54048,6712,-18014,7840,6712,58620,60760,36034,61888,60760
29103,MO,10536,7977,9078,11236,6151,4891,7185,7977,8004.404382,9456,11236,52100,6121,-18605,6985,6121,57054,58221,33495,59085,58221
29105,MO,9864,7977,9078,11236,6151,4891,7094,7872,7581.407402,9456,10220,49884,5530,-19196,6130,5530,56291,55414,30688,56014,55414
29107,MO,14016,7977,9078,11236,6151,4891,7655,7841,9826.545216,9456,11346,57376,7303,-17095,8695,7303,61004,64679,40281,66071,64679
29109,MO,10164,7977,9078,11236,6151,4891,7134,7977,8882.93657,9456,11236,52607,6121,-18605,6985,6121,56631,58728,34002,59592,58728
29111,MO,9264,7977,9078,11236,6151,4891,7013,7372,8004.404382,9456,10858,49845,5530,-19196,6130,5530,55610,55375,30649,55975,55375
29113,MO,12732,7977,9078,11236,6151,4891,7482,8514,8102.019069,9456,11177,54872,6712,-18014,7840,6712,59547,61584,36858,62712,61584
29115,MO,9612,7977,9078,11236,6151,4891,7060,7977,8102.019069,9456,11236,51274,6121,-18605,6985,6121,56005,57395,32669,58259,57395
29117,MO,10176,7977,9078,11236,6151,4891,7136,7977,8817.860111,9456,11236,52554,6121,-18605,6985,6121,56645,58675,33949,59539,58675
29119,MO,10536,7977,9078,11236,6151,4891,7185,7712,9403.548237,9456,11119,53118,6121,-18605,6985,6121,57054,59239,34513,60103,59239
29121,MO,9780,7977,9078,11236,6151,4891,7083,7977,7939.327923,9456,11236,51279,6121,-18605,6985,6121,56196,57400,32674,58264,57400
29123,MO,9588,7977,9078,11236,6151,4891,7057,7977,8590.092507,9456,11236,51738,6121,-18605,6985,6121,55978,57859,33133,58723,57859
29125,MO,10536,7977,9078,11236,6151,4891,7185,7977,8655.168965,9456,11236,52751,6121,-18605,6985,6121,57054,58872,34146,59736,58872
29127,MO,9276,7977,9078,11236,6151,4891,7014,7399,7744.098548,9456,10711,49477,5530,-19196,6130,5530,55623,55007,30281,55607,55007
29129,MO,9840,7977,9078,11236,6151,4891,7091,7977,8004.404382,9456,11236,51404,6121,-18605,6985,6121,56264,57525,32799,58389,57525
29131,MO,9228,7977,9078,11236,6151,4891,7008,7977,9696.3923,9456,11236,52484,5530,-19196,6130,5530,55569,58014,33288,58614,58014
29133,MO,9192,7977,9078,11236,6151,4891,7003,7977,8102.019069,9456,11236,50854,5530,-19196,6130,5530,55528,56384,31658,56984,56384
29135,MO,10032,7977,9078,11236,6151,4891,7117,7489,9110.704174,9456,11082,52062,6121,-18605,6985,6121,56482,58183,33457,59047,58183
29137,MO,8904,7977,9078,11236,6151,4891,6964,7977,7679.02209,9456,11236,50143,5530,-19196,6130,5530,55201,55673,30947,56273,55673
29139,MO,9480,7977,9078,11236,6151,4891,7042,7977,8036.942611,9456,11236,51077,6121,-18605,6985,6121,55855,57198,32472,58062,57198
29141,MO,9240,7977,9078,11236,6151,4891,7010,7977,9045.627716,9456,11236,51846,5530,-19196,6130,5530,55583,57376,32650,57976,57376
29143,MO,9312,7977,9078,11236,6151,4891,7019,7977,8232.171986,9456,11236,51104,5530,-19196,6130,5530,55664,56634,31908,57234,56634
29145,MO,10116,7977,9078,11236,6151,4891,7128,7610,7971.866152,9456,10790,50835,5530,-19196,6130,5530,56577,56365,31639,56965,56365
29147,MO,8964,7977,9078,11236,6151,4891,6972,7775,9110.704174,9456,10194,50390,5530,-19196,6130,5530,55269,55920,31194,56520,55920
29149,MO,9552,7977,9078,11236,6151,4891,7052,7977,8102.019069,9456,11236,51214,6121,-18605,6985,6121,55937,57335,32609,58199,57335
29151,MO,10680,7977,9078,11236,6151,4891,7204,7229,9045.627716,9456,11088,52390,6121,-18605,6985,6121,57217,58511,33785,59375,58511
29153,MO,8904,7977,9078,11236,6151,4891,6964,7977,8817.860111,9456,11236,51282,5530,-19196,6130,5530,55201,56812,32086,57412,56812
29155,MO,9204,7977,9078,11236,6151,4891,7005,7977,8134.557298,9456,11236,50899,5530,-19196,6130,5530,55542,56429,31703,57029,56429
29157,MO,10248,7977,9078,11236,6151,4891,7146,7977,8525.016049,9456,11236,52333,6121,-18605,6985,6121,56727,58454,33728,59318,58454
29159,MO,10488,7977,9078,11236,6151,4891,7178,7438,7841.713236,9456,10306,50420,5530,-19196,6130,5530,56999,55950,31224,56550,55950
29161,MO,10332,7977,9078,11236,6151,4891,7157,8117,8069.48084,9456,10581,51446,6121,-18605,6985,6121,56822,57567,32841,58431,57567
29163,MO,10404,7977,9078,11236,6151,4891,7167,7977,8036.942611,9456,11236,52001,6121,-18605,6985,6121,56904,58122,33396,58986,58122
29165,MO,14016,7977,9078,11236,6151,4891,7655,9975,10770.15386,9456,11344,60452,7894,-16081,9550,7894,61004,68346,44371,70002,68346
29167,MO,10200,7977,9078,11236,6151,4891,7139,7265,7679.02209,9456,10703,50194,5530,-19196,6130,5530,56672,55724,30998,56324,55724
29169,MO,13080,7977,9078,11236,6151,4891,7529,8881,8882.93657,9456,10946,56137,7303,-17095,8695,7303,59942,63440,39042,64832,63440
29171,MO,9540,7977,9078,11236,6151,4891,7050,7977,7711.560319,9456,11236,50812,6121,-18605,6985,6121,55923,56933,32207,57797,56933
29173,MO,10536,7977,9078,11236,6151,4891,7185,7395,8069.48084,9456,10760,51107,6121,-18605,6985,6121,57054,57228,32502,58092,57228
29175,MO,9384,7977,9078,11236,6151,4891,7029,7439,7613.945631,9456,10066,48850,5530,-19196,6130,5530,55746,54380,29654,54980,54380
29177,MO,14016,7977,9078,11236,6151,4891,7655,7868,8980.551257,9456,11342,56554,7303,-17095,8695,7303,61004,63857,39459,65249,63857
29179,MO,8904,7977,9078,11236,6151,4891,6964,7977,8752.783653,9456,11236,51217,5530,-19196,6130,5530,55201,56747,32021,57347,56747
29181,MO,10536,7977,9078,11236,6151,4891,7185,7977,8102.019069,9456,11236,52198,6121,-18605,6985,6121,57054,58319,33593,59183,58319
29183,MO,12732,7977,9078,11236,6151,4891,7482,9648,9143.242403,9456,11167,57038,7303,-17095,8695,7303,59547,64341,39943,65733,64341
29185,MO,8904,7977,9078,11236,6151,4891,6964,7977,7906.789694,9456,11236,50371,5530,-19196,6130,5530,55201,55901,31175,56501,55901
29186,MO,10188,7977,9078,11236,6151,4891,7138,7977,8850.398341,9456,11236,52598,6121,-18605,6985,6121,56659,58719,33993,59583,58719
29187,MO,10656,7977,9078,11236,6151,4891,7201,7756,8362.324903,9456,9711,50832,5530,-19196,6130,5530,57190,56362,31636,56962,56362
29189,MO,12732,7977,9078,11236,6151,4891,7482,9670,9305.933549,9456,11160,57215,7303,-17095,8695,7303,59547,64518,40120,65910,64518
29195,MO,9708,7977,9078,11236,6151,4891,7073,7106,7451.254485,9456,10263,48875,5530,-19196,6130,5530,56114,54405,29679,55005,54405
29197,MO,10536,7977,9078,11236,6151,4891,7185,6777,7841.713236,9456,9937,49438,5530,-19196,6130,5530,57054,54968,30242,55568,54968
29199,MO,9108,7977,9078,11236,6151,4891,6992,7977,8394.863132,9456,11236,51063,5530,-19196,6130,5530,55433,56593,31867,57193,56593
29201,MO,9300,7977,9078,11236,6151,4891,7018,7300,9598.777612,9456,10754,51300,5530,-19196,6130,5530,55651,56830,32104,57430,56830
29203,MO,8904,7977,9078,11236,6151,4891,6964,7977,8036.942611,9456,11236,50501,5530,-19196,6130,5530,55201,56031,31305,56631,56031
29205,MO,9696,7977,9078,11236,6151,4891,7071,7977,7744.098548,9456,11236,51000,6121,-18605,6985,6121,56100,57121,32395,57985,57121
29207,MO,9624,7977,9078,11236,6151,4891,7061,7977,9240.857091,9456,11236,52425,6121,-18605,6985,6121,56018,58546,33820,59410,58546
29209,MO,9936,7977,9078,11236,6151,4891,7104,8122,9208.318862,9456,10050,51663,5530,-19196,6130,5530,56373,57193,32467,57793,57193
29211,MO,10596,7977,9078,11236,6151,4891,7193,7977,8362.324903,9456,11236,52518,6121,-18605,6985,6121,57122,58639,33913,59503,58639
29213,MO,9864,7977,9078,11236,6151,4891,7094,8740,9566.239383,9456,10007,52524,6121,-18605,6985,6121,56291,58645,33919,59509,58645
29215,MO,10536,7977,9078,11236,6151,4891,7185,7977,8980.551257,9456,11236,53077,6121,-18605,6985,6121,57054,59198,34472,60062,59198
29217,MO,9912,7977,9078,11236,6151,4891,7100,7977,8980.551257,9456,11236,52453,6121,-18605,6985,6121,56345,58574,33848,59438,58574
29219,MO,12732,7977,9078,11236,6151,4891,7482,8549,7776.636777,9456,11177,54582,6712,-18014,7840,6712,59547,61294,36568,62422,61294
29221,MO,9984,7977,9078,11236,6151,4891,7110,7977,9175.780633,9456,11236,52720,6121,-18605,6985,6121,56427,58841,34115,59705,58841
29223,MO,9840,7977,9078,11236,6151,4891,7091,7977,8264.710215,9456,11236,51665,6121,-18605,6985,6121,56264,57786,33060,58650,57786
29225,MO,11484,7977,9078,11236,6151,4891,7313,7381,8882.93657,9456,10694,52789,6121,-18605,6985,6121,58130,58910,34184,59774,58910
29227,MO,9168,7977,9078,11236,6151,4891,7000,7977,8915.474799,9456,11236,51643,5530,-19196,6130,5530,55501,57173,32447,57773,57173
29229,MO,9024,7977,9078,11236,6151,4891,6980,7977,8167.095528,9456,11236,50751,5530,-19196,6130,5530,55337,56281,31555,56881,56281
29510,MO,12732,7977,9078,11236,6151,4891,7482,9425,8915.474799,9456,11145,56565,7303,-17095,8695,7303,59547,63868,39470,65260,63868
30001,MT,11268,10739,10607,9970,5169,5250,8500,10739,10949.36144,10189,9970,58365,7665,-16310,9321,7665,61503,66030,42055,67686,66030
30003,MT,10836,10739,10607,9970,5169,5250,8442,10739,10645.21251,10189,9970,57629,7074,-17324,8466,7074,61013,64703,40305,66095,64703
30005,MT,9516,10739,10607,9970,5169,5250,8263,10739,11063.41729,10189,9970,56727,7074,-17324,8466,7074,59514,63801,39403,65193,63801
30007,MT,9804,10739,10607,9970,5169,5250,8302,10739,10873.32421,10189,9970,56825,7074,-17324,8466,7074,59841,63899,39501,65291,63899
30009,MT,11604,10739,10607,9970,5169,5250,8546,11232,10607.19389,10189,9868,58750,7665,-16310,9321,7665,61885,66415,42440,68071,66415
30011,MT,10740,10739,10607,9970,5169,5250,8429,10739,11063.41729,10189,9970,57951,7074,-17324,8466,7074,60904,65025,40627,66417,65025
30013,MT,11064,10739,10607,9970,5169,5250,8473,12082,10265.02635,10189,9553,58402,7665,-16310,9321,7665,61272,66067,42092,67723,66067
30015,MT,11268,10739,10607,9970,5169,5250,8500,10739,10417.10081,10189,9970,57833,7665,-16310,9321,7665,61503,65498,41523,67154,65498
30017,MT,11148,10739,10607,9970,5169,5250,8484,10739,10721.24974,10189,9970,58017,7074,-17324,8466,7074,61367,65091,40693,66483,65091
30019,MT,10440,10739,10607,9970,5169,5250,8388,10739,12051.90131,10189,9970,58640,7074,-17324,8466,7074,60563,65714,41316,67106,65714
30021,MT,10968,10739,10607,9970,5169,5250,8460,10739,11633.69653,10189,9970,58750,7074,-17324,8466,7074,61163,65824,41426,67216,65824
30023,MT,11268,10739,10607,9970,5169,5250,8500,10739,11063.41729,10189,9970,58479,7665,-16310,9321,7665,61503,66144,42169,67800,66144
30025,MT,11268,10739,10607,9970,5169,5250,8500,10739,11367.56622,10189,9970,58784,7665,-16310,9321,7665,61503,66449,42474,68105,66449
30027,MT,9996,10739,10607,9970,5169,5250,8328,10739,10721.24974,10189,9970,56865,7074,-17324,8466,7074,60059,63939,39541,65331,63939
30029,MT,13020,10739,10607,9970,5169,5250,8737,12938,10455.11943,10189,9568,61419,8256,-15296,10176,8256,63492,69675,46123,71595,69675
30031,MT,13212,10739,10607,9970,5169,5250,8763,15221,10835.30559,10189,9881,64588,9438,-13267,11886,9438,63710,74026,51321,76474,74026
30033,MT,10740,10739,10607,9970,5169,5250,8429,10739,10607.19389,10189,9970,57495,7074,-17324,8466,7074,60904,64569,40171,65961,64569
30035,MT,11268,10739,10607,9970,5169,5250,8500,10739,10645.21251,10189,9970,58061,7665,-16310,9321,7665,61503,65726,41751,67382,65726
30037,MT,9600,10739,10607,9970,5169,5250,8275,10178,10569.17528,10189,9877,55663,6483,-18243,7611,6483,59610,62146,37420,63274,62146
30039,MT,9564,10739,10607,9970,5169,5250,8270,10739,11063.41729,10189,9970,56775,7074,-17324,8466,7074,59569,63849,39451,65241,63849
30041,MT,11268,10739,10607,9970,5169,5250,8500,10739,10911.34282,10189,9970,58327,7665,-16310,9321,7665,61503,65992,42017,67648,65992
30043,MT,11016,10739,10607,9970,5169,5250,8466,11901,10873.32421,10189,9923,59153,7665,-16310,9321,7665,61217,66818,42843,68474,66818
30045,MT,10908,10739,10607,9970,5169,5250,8452,10739,10569.17528,10189,9970,57625,7074,-17324,8466,7074,61095,64699,40301,66091,64699
30047,MT,9852,10739,10607,9970,5169,5250,8309,10739,12318.03162,10189,9970,58318,7074,-17324,8466,7074,59896,65392,40994,66784,65392
30049,MT,11328,10739,10607,9970,5169,5250,8508,13242,10759.26836,10189,9913,60681,8256,-15296,10176,8256,61571,68937,45385,70857,68937
30051,MT,10740,10739,10607,9970,5169,5250,8429,10739,10379.0822,10189,9970,57267,7074,-17324,8466,7074,60904,64341,39943,65733,64341
30053,MT,10752,10739,10607,9970,5169,5250,8431,10739,10607.19389,10189,9970,57507,7074,-17324,8466,7074,60918,64581,40183,65973,64581
30055,MT,11268,10739,10607,9970,5169,5250,8500,10739,11595.67791,10189,9970,59012,7665,-16310,9321,7665,61503,66677,42702,68333,66677
30057,MT,10416,10739,10607,9970,5169,5250,8385,10739,10987.38006,10189,9970,57551,7074,-17324,8466,7074,60536,64625,40227,66017,64625
30059,MT,9516,10739,10607,9970,5169,5250,8263,10739,10797.28698,10189,9970,56461,7074,-17324,8466,7074,59514,63535,39137,64927,63535
30061,MT,10572,10739,10607,9970,5169,5250,8406,10739,10683.23113,10189,9970,57403,7074,-17324,8466,7074,60713,64477,40079,65869,64477
30063,MT,14544,10739,10607,9970,5169,5250,8943,13877,10987.38006,10189,9670,64517,9438,-13267,11886,9438,65222,73955,51250,76403,73955
30065,MT,10620,10739,10607,9970,5169,5250,8413,10739,10493.13805,10189,9970,57261,7074,-17324,8466,7074,60768,64335,39937,65727,64335
30067,MT,11196,10739,10607,9970,5169,5250,8491,10739,10683.23113,10189,9970,58027,7074,-17324,8466,7074,61422,65101,40703,66493,65101
30069,MT,10740,10739,10607,9970,5169,5250,8429,10739,10493.13805,10189,9970,57381,7074,-17324,8466,7074,60904,64455,40057,65847,64455
30071,MT,10740,10739,10607,9970,5169,5250,8429,10739,11139.45452,10189,9970,58027,7074,-17324,8466,7074,60904,65101,40703,66493,65101
30073,MT,11268,10739,10607,9970,5169,5250,8500,10739,10379.0822,10189,9970,57795,7665,-16310,9321,7665,61503,65460,41485,67116,65460
30075,MT,11268,10739,10607,9970,5169,5250,8500,10739,11177.47314,10189,9970,58593,7665,-16310,9321,7665,61503,66258,42283,67914,66258
30077,MT,9516,10739,10607,9970,5169,5250,8263,10739,10835.30559,10189,9970,56499,7074,-17324,8466,7074,59514,63573,39175,64965,63573
30079,MT,10740,10739,10607,9970,5169,5250,8429,10739,11595.67791,10189,9970,58484,7074,-17324,8466,7074,60904,65558,41160,66950,65558
30081,MT,12144,10739,10607,9970,5169,5250,8619,10739,12926.32948,10189,9970,61218,7665,-16310,9321,7665,62498,68883,44908,70539,68883
30083,MT,9792,10739,10607,9970,5169,5250,8301,10739,12127.93854,10189,9970,58068,7074,-17324,8466,7074,59828,65142,40744,66534,65142
30085,MT,9516,10739,10607,9970,5169,5250,8263,10739,12470.10608,10189,9970,58134,7074,-17324,8466,7074,59514,65208,40810,66600,65208
30087,MT,9516,10739,10607,9970,5169,5250,8263,10739,10645.21251,10189,9970,56309,7074,-17324,8466,7074,59514,63383,38985,64775,63383
30089,MT,9720,10739,10607,9970,5169,5250,8291,10739,10683.23113,10189,9970,56551,7074,-17324,8466,7074,59746,63625,39227,65017,63625
30091,MT,11268,10739,10607,9970,5169,5250,8500,10739,12508.1247,10189,9970,59924,7665,-16310,9321,7665,61503,67589,43614,69245,67589
30093,MT,9516,10739,10607,9970,5169,5250,8263,9940,11519.64068,10189,8846,55260,6483,-18243,7611,6483,59514,61743,37017,62871,61743
30095,MT,10788,10739,10607,9970,5169,5250,8435,10739,10607.19389,10189,9970,57543,7074,-17324,8466,7074,60958,64617,40219,66009,64617
30097,MT,11352,10739,10607,9970,5169,5250,8512,10739,10645.21251,10189,9970,58145,7665,-16310,9321,7665,61599,65810,41835,67466,65810
30099,MT,10596,10739,10607,9970,5169,5250,8410,10739,10721.24974,10189,9970,57465,7074,-17324,8466,7074,60741,64539,40141,65931,64539
30101,MT,11268,10739,10607,9970,5169,5250,8500,10739,10379.0822,10189,9970,57795,7665,-16310,9321,7665,61503,65460,41485,67116,65460
30103,MT,10656,10739,10607,9970,5169,5250,8418,10739,10493.13805,10189,9970,57297,7074,-17324,8466,7074,60809,64371,39973,65763,64371
30105,MT,10584,10739,10607,9970,5169,5250,8408,10739,12051.90131,10189,9970,58784,7074,-17324,8466,7074,60727,65858,41460,67250,65858
30107,MT,10740,10739,10607,9970,5169,5250,8429,10739,10645.21251,10189,9970,57533,7074,-17324,8466,7074,60904,64607,40209,65999,64607
30109,MT,10740,10739,10607,9970,5169,5250,8429,10739,12165.95716,10189,9970,59054,7074,-17324,8466,7074,60904,66128,41730,67520,66128
30111,MT,11604,10739,10607,9970,5169,5250,8546,12890,10455.11943,10189,9853,60242,8256,-15296,10176,8256,61885,68498,44946,70418,68498
31001,NE,8772,8131,9078,11236,6172,4891,8525,7091,8622.630736,10200,10974,50551,3532,-21194,4132,3532,56805,54083,29357,54683,54083
31003,NE,9144,8131,9078,11236,6172,4891,8581,8131,8752.783653,10200,11236,52355,4100,-20626,4964,4100,57233,56455,31729,57319,56455
31005,NE,10428,8131,9078,11236,6172,4891,8774,8131,9208.318862,10200,11236,54094,4100,-20626,4964,4100,58710,58194,33468,59058,58194
31007,NE,8880,8131,9078,11236,6172,4891,8541,7689,9208.318862,10200,10932,51801,3532,-21194,4132,3532,56929,55333,30607,55933,55333
31009,NE,8820,8131,9078,11236,6172,4891,8532,8131,8687.707195,10200,11236,51966,4100,-20626,4964,4100,56860,56066,31340,56930,56066
31011,NE,8772,8131,9078,11236,6172,4891,8525,8131,8557.554278,10200,11236,51788,4100,-20626,4964,4100,56805,55888,31162,56752,55888
31013,NE,9240,8131,9078,11236,6172,4891,8595,8131,9208.318862,10200,11236,52906,4100,-20626,4964,4100,57343,57006,32280,57870,57006
31015,NE,10380,8131,9078,11236,6172,4891,8766,8131,8720.245424,10200,11236,53558,4100,-20626,4964,4100,58654,57658,32932,58522,57658
31017,NE,8772,8131,9078,11236,6172,4891,8525,8131,8459.93959,10200,11236,51690,4100,-20626,4964,4100,56805,55790,31064,56654,55790
31019,NE,10476,8131,9078,11236,6172,4891,8781,7075,9175.780633,10200,11444,53262,4100,-20626,4964,4100,58765,57362,32636,58226,57362
31021,NE,9684,8131,9078,11236,6172,4891,8662,8131,8752.783653,10200,11236,52895,4100,-20626,4964,4100,57854,56995,32269,57859,56995
31023,NE,9288,8131,9078,11236,6172,4891,8602,8131,9078.165945,10200,11236,52824,4100,-20626,4964,4100,57398,56924,32198,57788,56924
31025,NE,12708,8131,9078,11236,6172,4891,9116,7075,9338.471779,10200,11499,55711,4668,-20058,5796,4668,61332,60379,35653,61507,60379
31027,NE,8772,8131,9078,11236,6172,4891,8525,8131,8687.707195,10200,11236,51918,4100,-20626,4964,4100,56805,56018,31292,56882,56018
31029,NE,8772,8131,9078,11236,6172,4891,8525,8131,9078.165945,10200,11236,52308,4100,-20626,4964,4100,56805,56408,31682,57272,56408
31031,NE,9396,8131,9078,11236,6172,4891,8618,8131,8915.474799,10200,11236,52769,4100,-20626,4964,4100,57522,56869,32143,57733,56869
31033,NE,10200,8131,9078,11236,6172,4891,8739,8131,9338.471779,10200,11236,53996,4100,-20626,4964,4100,58447,58096,33370,58960,58096
31035,NE,8772,8131,9078,11236,6172,4891,8525,8131,8459.93959,10200,11236,51690,4100,-20626,4964,4100,56805,55790,31064,56654,55790
31037,NE,8772,8131,9078,11236,6172,4891,8525,8131,8720.245424,10200,11236,51950,4100,-20626,4964,4100,56805,56050,31324,56914,56050
31039,NE,8928,8131,9078,11236,6172,4891,8548,8131,8720.245424,10200,11236,52106,4100,-20626,4964,4100,56984,56206,31480,57070,56206
31041,NE,10380,8131,9078,11236,6172,4891,8766,8131,8687.707195,10200,11236,53526,4100,-20626,4964,4100,58654,57626,32900,58490,57626
31043,NE,10968,8131,9078,11236,6172,4891,8855,7149,8264.710215,10200,11304,52776,4100,-20626,4964,4100,59331,56876,32150,57740,56876
31045,NE,10380,8131,9078,11236,6172,4891,8766,8131,9175.780633,10200,11236,54014,4100,-20626,4964,4100,58654,58114,33388,58978,58114
31047,NE,8988,8131,9078,11236,6172,4891,8557,7881,8362.324903,10200,11304,51626,4100,-20626,4964,4100,57053,55726,31000,56590,55726
31049,NE,8772,8131,9078,11236,6172,4891,8525,8131,9371.010008,10200,11236,52601,4100,-20626,4964,4100,56805,56701,31975,57565,56701
31051,NE,10968,8131,9078,11236,6172,4891,8855,8976,8622.630736,10200,11289,54947,4668,-20058,5796,4668,59331,59615,34889,60743,59615
31053,NE,10308,8131,9078,11236,6172,4891,8755,7092,8622.630736,10200,10924,52038,4100,-20626,4964,4100,58571,56138,31412,57002,56138
31055,NE,12708,8131,9078,11236,6172,4891,9116,6775,8817.860111,10200,11527,54919,4668,-20058,5796,4668,61332,59587,34861,60715,59587
31057,NE,8772,8131,9078,11236,6172,4891,8525,8131,8785.321882,10200,11236,52015,4100,-20626,4964,4100,56805,56115,31389,56979,56115
31059,NE,9108,8131,9078,11236,6172,4891,8575,8131,8720.245424,10200,11236,52286,4100,-20626,4964,4100,57191,56386,31660,57250,56386
31061,NE,10356,8131,9078,11236,6172,4891,8763,8131,8980.551257,10200,11236,53795,4100,-20626,4964,4100,58627,57895,33169,58759,57895
31063,NE,9804,8131,9078,11236,6172,4891,8680,8131,8752.783653,10200,11236,53015,4100,-20626,4964,4100,57992,57115,32389,57979,57115
31065,NE,8772,8131,9078,11236,6172,4891,8525,8131,8915.474799,10200,11236,52145,4100,-20626,4964,4100,56805,56245,31519,57109,56245
31067,NE,9540,8131,9078,11236,6172,4891,8640,7000,8687.707195,10200,10899,51218,3532,-21194,4132,3532,57688,54750,30024,55350,54750
31069,NE,8772,8131,9078,11236,6172,4891,8525,8131,9208.318862,10200,11236,52438,4100,-20626,4964,4100,56805,56538,31812,57402,56538
31071,NE,8772,8131,9078,11236,6172,4891,8525,8131,8492.477819,10200,11236,51722,4100,-20626,4964,4100,56805,55822,31096,56686,55822
31073,NE,9060,8131,9078,11236,6172,4891,8568,6757,8948.013028,10200,11296,51152,3532,-21194,4132,3532,57136,54684,29958,55284,54684
31075,NE,8772,8131,9078,11236,6172,4891,8525,8131,9175.780633,10200,11236,52406,4100,-20626,4964,4100,56805,56506,31780,57370,56506
31077,NE,10380,8131,9078,11236,6172,4891,8766,8131,8980.551257,10200,11236,53819,4100,-20626,4964,4100,58654,57919,33193,58783,57919
31079,NE,9540,8131,9078,11236,6172,4891,8640,6888,8362.324903,10200,11331,51212,3532,-21194,4132,3532,57688,54744,30018,55344,54744
31081,NE,8952,8131,9078,11236,6172,4891,8552,7400,8459.93959,10200,11316,51219,3532,-21194,4132,3532,57012,54751,30025,55351,54751
31083,NE,8772,8131,9078,11236,6172,4891,8525,8131,9013.089487,10200,11236,52243,4100,-20626,4964,4100,56805,56343,31617,57207,56343
31085,NE,8820,8131,9078,11236,6172,4891,8532,8131,9045.627716,10200,11236,52324,4100,-20626,4964,4100,56860,56424,31698,57288,56424
31087,NE,8772,8131,9078,11236,6172,4891,8525,8131,8785.321882,10200,11236,52015,4100,-20626,4964,4100,56805,56115,31389,56979,56115
31089,NE,8772,8131,9078,11236,6172,4891,8525,8131,8882.93657,10200,11236,52113,4100,-20626,4964,4100,56805,56213,31487,57077,56213
31091,NE,9072,8131,9078,11236,6172,4891,8570,8131,9143.242403,10200,11236,52673,4100,-20626,4964,4100,57150,56773,32047,57637,56773
31093,NE,8916,8131,9078,11236,6172,4891,8546,7495,8622.630736,10200,11315,51439,3532,-21194,4132,3532,56970,54971,30245,55571,54971
31095,NE,8772,8131,9078,11236,6172,4891,8525,8131,8590.092507,10200,11236,51820,4100,-20626,4964,4100,56805,55920,31194,56784,55920
31097,NE,8772,8131,9078,11236,6172,4891,8525,8131,9110.704174,10200,11236,52341,4100,-20626,4964,4100,56805,56441,31715,57305,56441
31099,NE,9540,8131,9078,11236,6172,4891,8640,7168,9013.089487,10200,11417,52229,4100,-20626,4964,4100,57688,56329,31603,57193,56329
31101,NE,9552,8131,9078,11236,6172,4891,8642,8131,9143.242403,10200,11236,53153,4100,-20626,4964,4100,57702,57253,32527,58117,57253
31103,NE,8772,8131,9078,11236,6172,4891,8525,8131,8459.93959,10200,11236,51690,4100,-20626,4964,4100,56805,55790,31064,56654,55790
31105,NE,9096,8131,9078,11236,6172,4891,8573,8131,9371.010008,10200,11236,52925,4100,-20626,4964,4100,57177,57025,32299,57889,57025
31107,NE,10380,8131,9078,11236,6172,4891,8766,8131,8948.013028,10200,11236,53786,4100,-20626,4964,4100,58654,57886,33160,58750,57886
31109,NE,11676,8131,9078,11236,6172,4891,8961,8402,9273.39532,10200,11250,55692,4668,-20058,5796,4668,60145,60360,35634,61488,60360
31111,NE,9384,8131,9078,11236,6172,4891,8617,7327,8948.013028,10200,10812,51562,3532,-21194,4132,3532,57509,55094,30368,55694,55094
31113,NE,10644,8131,9078,11236,6172,4891,8806,6833,8720.245424,10200,10901,52189,4100,-20626,4964,4100,58958,56289,31563,57153,56289
31115,NE,8772,8131,9078,11236,6172,4891,8525,8131,8622.630736,10200,11236,51853,4100,-20626,4964,4100,56805,55953,31227,56817,55953
31117,NE,8820,8131,9078,11236,6172,4891,8532,7121,9143.242403,10200,10907,51082,3532,-21194,4132,3532,56860,54614,29888,55214,54614
31119,NE,9240,8131,9078,11236,6172,4891,8595,6951,8752.783653,10200,11128,51163,3532,-21194,4132,3532,57343,54695,29969,55295,54695
31121,NE,10380,8131,9078,11236,6172,4891,8766,6933,8525.016049,10200,11317,52245,4100,-20626,4964,4100,58654,56345,31619,57209,56345
31123,NE,8928,8131,9078,11236,6172,4891,8548,8131,9273.39532,10200,11236,52659,4100,-20626,4964,4100,56984,56759,32033,57623,56759
31125,NE,8772,8131,9078,11236,6172,4891,8525,8131,8850.398341,10200,11236,52080,4100,-20626,4964,4100,56805,56180,31454,57044,56180
31127,NE,8772,8131,9078,11236,6172,4891,8525,8131,8394.863132,10200,11236,51625,4100,-20626,4964,4100,56805,55725,30999,56589,55725
31129,NE,10380,8131,9078,11236,6172,4891,8766,8131,8557.554278,10200,11236,53396,4100,-20626,4964,4100,58654,57496,32770,58360,57496
31131,NE,10560,8131,9078,11236,6172,4891,8793,8131,8817.860111,10200,11236,53836,4668,-20058,5796,4668,58861,58504,33778,59632,58504
31133,NE,8772,8131,9078,11236,6172,4891,8525,8131,8655.168965,10200,11236,51885,4100,-20626,4964,4100,56805,55985,31259,56849,55985
31135,NE,8772,8131,9078,11236,6172,4891,8525,8131,9143.242403,10200,11236,52373,4100,-20626,4964,4100,56805,56473,31747,57337,56473
31137,NE,8772,8131,9078,11236,6172,4891,8525,8131,8948.013028,10200,11236,52178,4100,-20626,4964,4100,56805,56278,31552,57142,56278
31139,NE,8772,8131,9078,11236,6172,4891,8525,7480,8720.245424,10200,11144,51208,3532,-21194,4132,3532,56805,54740,30014,55340,54740
31141,NE,8772,8131,9078,11236,6172,4891,8525,9491,8882.93657,10200,11401,53639,4100,-20626,4964,4100,56805,57739,33013,58603,57739
31143,NE,8772,8131,9078,11236,6172,4891,8525,8131,8882.93657,10200,11236,52113,4100,-20626,4964,4100,56805,56213,31487,57077,56213
31145,NE,8772,8131,9078,11236,6172,4891,8525,8131,8525.016049,10200,11236,51755,4100,-20626,4964,4100,56805,55855,31129,56719,55855
31147,NE,8772,8131,9078,11236,6172,4891,8525,8131,8720.245424,10200,11236,51950,4100,-20626,4964,4100,56805,56050,31324,56914,56050
31149,NE,9024,8131,9078,11236,6172,4891,8563,8131,8394.863132,10200,11236,51877,4100,-20626,4964,4100,57095,55977,31251,56841,55977
31151,NE,10332,8131,9078,11236,6172,4891,8759,8131,9110.704174,10200,11236,53901,4100,-20626,4964,4100,58599,58001,33275,58865,58001
31153,NE,12708,8131,9078,11236,6172,4891,9116,7034,8915.474799,10200,11512,55261,4668,-20058,5796,4668,61332,59929,35203,61057,59929
31155,NE,10956,8131,9078,11236,6172,4891,8853,7015,9305.933549,10200,11493,53861,4100,-20626,4964,4100,59317,57961,33235,58825,57961
31157,NE,9420,8131,9078,11236,6172,4891,8622,7346,8980.551257,10200,10849,51686,3532,-21194,4132,3532,57550,55218,30492,55818,55218
31159,NE,9756,8131,9078,11236,6172,4891,8673,7276,9175.780633,10200,11248,52547,4100,-20626,4964,4100,57937,56647,31921,57511,56647
31161,NE,9516,8131,9078,11236,6172,4891,8636,8131,9468.624695,10200,11236,53443,4100,-20626,4964,4100,57660,57543,32817,58407,57543
31163,NE,8772,8131,9078,11236,6172,4891,8525,8131,8655.168965,10200,11236,51885,4100,-20626,4964,4100,56805,55985,31259,56849,55985
31165,NE,9492,8131,9078,11236,6172,4891,8633,9359,9208.318862,10200,10934,54084,4100,-20626,4964,4100,57633,58184,33458,59048,58184
31167,NE,10380,8131,9078,11236,6172,4891,8766,9930,8785.321882,10200,11142,55328,4668,-20058,5796,4668,58654,59996,35270,61124,59996
31169,NE,8772,8131,9078,11236,6172,4891,8525,8131,8459.93959,10200,11236,51690,4100,-20626,4964,4100,56805,55790,31064,56654,55790
31171,NE,8952,8131,9078,11236,6172,4891,8552,8131,8850.398341,10200,11236,52260,4100,-20626,4964,4100,57012,56360,31634,57224,56360
31173,NE,8772,8131,9078,11236,6172,4891,8525,8131,8557.554278,10200,11236,51788,4100,-20626,4964,4100,56805,55888,31162,56752,55888
31175,NE,8772,8131,9078,11236,6172,4891,8525,8131,8622.630736,10200,11236,51853,4100,-20626,4964,4100,56805,55953,31227,56817,55953
31177,NE,12708,8131,9078,11236,6172,4891,9116,6986,8948.013028,10200,11499,55232,4668,-20058,5796,4668,61332,59900,35174,61028,59900
31179,NE,9804,8131,9078,11236,6172,4891,8680,8131,8655.168965,10200,11236,52917,4100,-20626,4964,4100,57992,57017,32291,57881,57017
31181,NE,10380,8131,9078,11236,6172,4891,8766,8131,8622.630736,10200,11236,53461,4100,-20626,4964,4100,58654,57561,32835,58425,57561
31183,NE,10380,8131,9078,11236,6172,4891,8766,8131,8752.783653,10200,11236,53591,4100,-20626,4964,4100,58654,57691,32965,58555,57691
31185,NE,8964,8131,9078,11236,6172,4891,8553,8131,8459.93959,10200,11236,51882,4100,-20626,4964,4100,57025,55982,31256,56846,55982
32001,NV,12180,6545,10607,9970,6254,5250,6837,7569,11671.71515,8425,9779,54875,4697,-20029,5561,4697,57643,59572,34846,60436,59572
32003,NV,18360,6545,10607,9970,6254,5250,7549,7699,10835.30559,8425,10165,60734,6615,-16937,8535,6615,64535,67349,43797,69269,67349
32005,NV,17220,6545,10607,9970,6254,5250,7417,8639,10721.24974,8425,10056,60311,6615,-16937,8535,6615,63263,66926,43374,68846,66926
32007,NV,13488,6545,10607,9970,6254,5250,6987,6028,11671.71515,8425,10993,55856,5174,-19552,6302,5174,59101,61030,36304,62158,61030
32009,NV,10740,6545,10607,9970,6254,5250,6671,6545,13116.42256,8425,9970,54046,4219,-20507,4819,4219,56037,58265,33539,58865,58265
32011,NV,12372,6545,10607,9970,6254,5250,6859,7434,11291.52898,8425,10885,55657,5174,-19552,6302,5174,57857,60831,36105,61959,60831
32013,NV,11904,6545,10607,9970,6254,5250,6805,6644,10531.15666,8425,10119,52874,4697,-20029,5561,4697,57335,57571,32845,58435,57571
32015,NV,11784,6545,10607,9970,6254,5250,6791,6545,11367.56622,8425,9970,53342,4697,-20029,5561,4697,57201,58039,33313,58903,58039
32017,NV,12204,6545,10607,9970,6254,5250,6840,6545,10759.26836,8425,9970,53153,4697,-20029,5561,4697,57670,57850,33124,58714,57850
32019,NV,13884,6545,10607,9970,6254,5250,7033,7527,10645.21251,8425,9526,55256,5174,-19552,6302,5174,59543,60430,35704,61558,60430
32021,NV,13284,6545,10607,9970,6254,5250,6964,6545,11139.45452,8425,9970,54613,5174,-19552,6302,5174,58874,59787,35061,60915,59787
32023,NV,13176,6545,10607,9970,6254,5250,6952,6343,10531.15666,8425,8646,52371,4697,-20029,5561,4697,58754,57068,32342,57932,57068
32027,NV,11268,6545,10607,9970,6254,5250,6732,6545,10987.38006,8425,9970,52445,4697,-20029,5561,4697,56626,57142,32416,58006,57142
32029,NV,16284,6545,10607,9970,6254,5250,7310,7533,11025.39867,8425,9962,58480,6129,-17846,7785,6129,62220,64609,40634,66265,64609
32031,NV,16284,6545,10607,9970,6254,5250,7310,7606,10987.38006,8425,9960,58512,6129,-17846,7785,6129,62220,64641,40666,66297,64641
32033,NV,13176,6545,10607,9970,6254,5250,6952,6545,10341.06358,8425,9970,53707,4697,-20029,5561,4697,58754,58404,33678,59268,58404
32510,NV,14868,6545,10607,9970,6254,5250,7146,6859,12241.99439,8425,9626,57270,5174,-19552,6302,5174,60640,62444,37718,63572,62444
33001,NH,16152,4398,10321,9258,6291,4819,10137,3862,11726.94196,8465,9241,54265,6392,-18334,7256,6392,61376,60657,35931,61521,60657
33003,NH,16920,4398,10321,9258,6291,4819,10264,4398,13280.66929,8465,9258,57141,6981,-17745,8109,6981,62271,64122,39396,65250,64122
33005,NH,14532,4398,10321,9258,6291,4819,9870,3959,11283.01987,8465,9138,52196,5802,-18924,6402,5802,59489,57998,33272,58598,57998
33007,NH,10524,4398,10321,9258,6291,4819,9207,3956,11504.98092,8465,8428,47698,-1172,-25898,-751,-1172,54818,46526,21800,46947,46526
33009,NH,15300,4398,10321,9258,6291,4819,9996,4766,11985.89652,8465,9068,54404,6392,-18334,7256,6392,60383,60796,36070,61660,60796
33011,NH,17459,4398,10321,9258,6291,4819,10353,3731,11098.05233,8465,10016,55588,6981,-17745,8109,6981,62899,62569,37843,63697,62569
33013,NH,15852,4398,10321,9258,6291,4819,10088,3804,11357.00688,8465,9788,54085,6392,-18334,7256,6392,61027,60477,35751,61341,60477
33015,NH,17676,4398,10321,9258,6291,4819,10389,3871,11430.9939,8465,10017,56280,6981,-17745,8109,6981,63152,63261,38535,64389,63261
33017,NH,17508,4398,10321,9258,6291,4819,10361,5062,11209.03285,8465,10042,57105,7571,-16827,8963,7571,62956,64676,40278,66068,64676
33019,NH,14904,4398,10321,9258,6291,4819,9931,5438,10543.14971,8465,9068,53236,6392,-18334,7256,6392,59922,59628,34902,60492,59628
34001,NJ,18900,20608,10321,9258,6182,4819,8507,21122,10950.0783,10457,9346,75595,9317,-11272,13085,9317,78595,84912,64323,88680,84912
34003,NJ,21792,20608,10321,9258,6182,4819,8890,26989,12244.85107,10457,10104,86407,13112,-4011,16850,13112,81870,99519,82396,103257,99519
34005,NJ,16968,20608,10321,9258,6182,4819,8250,25753,10432.16919,10457,9769,78198,10703,-8590,14549,10703,76406,88901,69608,92747,88901
34007,NJ,16968,20608,10321,9258,6182,4819,8250,18341,11135.04584,10457,9794,71514,8411,-13025,11651,8411,76406,79925,58489,83165,79925
34009,NJ,17412,20608,10321,9258,6182,4819,8309,21235,12540.79913,10457,8818,75282,8864,-12149,12368,8864,76909,84146,63133,87650,84146
34011,NJ,16500,20608,10321,9258,6182,4819,8188,20575,9951.253589,10457,9237,71539,8411,-13025,11651,8411,75876,79950,58514,83190,79950
34013,NJ,19584,20608,10321,9258,6182,4819,8597,18967,12873.7407,10457,10167,76868,9317,-11272,13085,9317,79369,86185,65596,89953,86185
34015,NJ,16968,20608,10321,9258,6182,4819,8250,18445,10284.19516,10457,9765,70738,8411,-13025,11651,8411,76406,79149,57713,82389,79149
34017,NJ,19716,20608,10321,9258,6182,4819,8615,18377,10987.07181,10457,10398,74754,9317,-11272,13085,9317,79519,84071,63482,87839,84071
34019,NJ,22704,20608,10321,9258,6182,4819,9011,23720,13095.70175,10457,9957,84752,11506,-7063,15316,11506,82903,96258,77689,100068,96258
34021,NJ,19224,20608,10321,9258,6182,4819,8550,18587,11209.03285,10457,10113,74409,8864,-12149,12368,8864,78962,83273,62260,86777,83273
34023,NJ,22704,20608,10321,9258,6182,4819,9011,21594,10691.12374,10457,10038,80303,10703,-8590,14549,10703,82903,91006,71713,94852,91006
34025,NJ,22380,20608,10321,9258,6182,4819,8968,21232,11283.01987,10457,9998,80170,10703,-8590,14549,10703,82536,90873,71580,94719,90873
34027,NJ,19584,20608,10321,9258,6182,4819,8597,19619,11874.91599,10457,9994,76348,9317,-11272,13085,9317,79369,85665,65076,89433,85665
34029,NJ,22380,20608,10321,9258,6182,4819,8968,18453,10876.09128,10457,9974,76959,9900,-10116,13782,9900,82536,86859,66843,90741,86859
34031,NJ,21792,20608,10321,9258,6182,4819,8890,18364,10728.11725,10457,10094,76254,9317,-11272,13085,9317,81870,85571,64982,89339,85571
34033,NJ,16968,20608,10321,9258,6182,4819,8250,27161,12022.89002,10457,9747,81175,10703,-8590,14549,10703,76406,91878,72585,95724,91878
34035,NJ,22704,20608,10321,9258,6182,4819,9011,17850,11726.94196,10457,9997,77554,9900,-10116,13782,9900,82903,87454,67438,91336,87454
34037,NJ,19584,20608,10321,9258,6182,4819,8597,18891,12392.8251,10457,9955,76099,9317,-11272,13085,9317,79369,85416,64827,89184,85416
34039,NJ,19584,20608,10321,9258,6182,4819,8597,18175,10543.14971,10457,10088,73667,8864,-12149,12368,8864,79369,82531,61518,86035,82531
34041,NJ,18360,20608,10321,9258,6182,4819,8435,19150,12096.87704,10457,9321,74204,8864,-12149,12368,8864,77983,83068,62055,86572,83068
35001,NM,13932,9716,10607,9970,5694,5250,8573,11990,10265.02635,6217,9776,57430,7921,-16477,9313,7921,63742,65351,40953,66743,65351
35003,NM,11268,9716,10607,9970,5694,5250,8181,9716,10569.17528,6217,9970,52990,6815,-17911,7679,6815,60686,59805,35079,60669,59805
35005,NM,10920,9716,10607,9970,5694,5250,8129,11409,10036.91465,6217,9159,52992,6815,-17911,7679,6815,60286,59807,35081,60671,59807
35006,NM,10548,9716,10607,9970,5694,5250,8075,9882,9960.877421,6217,9258,51117,6262,-18464,6862,6262,59860,57379,32653,57979,57379
35007,NM,10128,9716,10607,9970,5694,5250,8013,9716,11975.86407,6217,9970,53257,6262,-18464,6862,6262,59378,59519,34793,60119,59519
35009,NM,11736,9716,10607,9970,5694,5250,8249,10491,10949.36144,6217,9392,54036,6815,-17911,7679,6815,61222,60851,36125,61715,60851
35011,NM,11268,9716,10607,9970,5694,5250,8181,9716,10531.15666,6217,9970,52952,6815,-17911,7679,6815,60686,59767,35041,60631,59767
35013,NM,12636,9716,10607,9970,5694,5250,8382,9462,10417.10081,6217,9326,53309,6815,-17911,7679,6815,62255,60124,35398,60988,60124
35015,NM,11364,9716,10607,9970,5694,5250,8195,11183,11177.47314,6217,9940,55131,7368,-17358,8496,7368,60796,62499,37773,63627,62499
35017,NM,11268,9716,10607,9970,5694,5250,8181,11714,10911.34282,6217,8597,53957,6815,-17911,7679,6815,60686,60772,36046,61636,60772
35019,NM,11268,9716,10607,9970,5694,5250,8181,9716,10417.10081,6217,9970,52838,6815,-17911,7679,6815,60686,59653,34927,60517,59653
35021,NM,10128,9716,10607,9970,5694,5250,8013,9716,11633.69653,6217,9970,52915,6262,-18464,6862,6262,59378,59177,34451,59777,59177
35023,NM,11268,9716,10607,9970,5694,5250,8181,9716,10607.19389,6217,9970,53028,6815,-17911,7679,6815,60686,59843,35117,60707,59843
35025,NM,12060,9716,10607,9970,5694,5250,8297,10211,11177.47314,6217,10209,55124,7368,-17358,8496,7368,61594,62492,37766,63620,62492
35027,NM,13284,9716,10607,9970,5694,5250,8477,9716,10797.28698,6217,9970,55234,7368,-17358,8496,7368,62998,62602,37876,63730,62602
35028,NM,17124,9716,10607,9970,5694,5250,9043,11268,11063.41729,6217,12115,63038,9580,-13549,11764,9580,67404,72618,49489,74802,72618
35029,NM,11016,9716,10607,9970,5694,5250,8143,9538,10379.0822,6217,8630,51030,6262,-18464,6862,6262,60396,57292,32566,57892,57292
35031,NM,9516,9716,10607,9970,5694,5250,7923,10925,9998.896037,6217,9651,51557,6815,-17911,7679,6815,58676,58372,33646,59236,58372
35033,NM,10572,9716,10607,9970,5694,5250,8078,9716,11215.49175,6217,9970,52940,6815,-17911,7679,6815,59887,59755,35029,60619,59755
35035,NM,11160,9716,10607,9970,5694,5250,8165,10843,10873.32421,6217,8992,53335,6815,-17911,7679,6815,60562,60150,35424,61014,60150
35037,NM,10428,9716,10607,9970,5694,5250,8057,9716,10455.11943,6217,9970,52036,6815,-17911,7679,6815,59722,58851,34125,59715,58851
35039,NM,11064,9716,10607,9970,5694,5250,8151,11194,10569.17528,6217,9538,53833,6815,-17911,7679,6815,60452,60648,35922,61512,60648
35041,NM,10632,9716,10607,9970,5694,5250,8087,11552,10227.00773,6217,9269,53147,6815,-17911,7679,6815,59956,59962,35236,60826,59962
35043,NM,13932,9716,10607,9970,5694,5250,8573,9763,11139.45452,6217,9804,56105,7368,-17358,8496,7368,63742,63473,38747,64601,63473
35045,NM,10980,9716,10607,9970,5694,5250,8138,10206,10227.00773,6217,10175,53055,6815,-17911,7679,6815,60355,59870,35144,60734,59870
35047,NM,10440,9716,10607,9970,5694,5250,8059,11979,10987.38006,6217,8235,53109,6815,-17911,7679,6815,59736,59924,35198,60788,59924
35049,NM,15396,9716,10607,9970,5694,5250,8788,9930,10949.36144,6217,9591,57333,7921,-16477,9313,7921,65421,65254,40856,66646,65254
35051,NM,9972,9716,10607,9970,5694,5250,7990,9716,9922.858805,6217,9970,51048,6262,-18464,6862,6262,59199,57310,32584,57910,57310
35053,NM,9516,9716,10607,9970,5694,5250,7923,9716,10341.06358,6217,9970,51010,6262,-18464,6862,6262,58676,57272,32546,57872,57272
35055,NM,13476,9716,10607,9970,5694,5250,8506,10487,12964.34809,6217,8606,57000,7368,-17358,8496,7368,63219,64368,39642,65496,64368
35057,NM,13932,9716,10607,9970,5694,5250,8573,10454,10417.10081,6217,9805,56075,7921,-16477,9313,7921,63742,63996,39598,65388,63996
35059,NM,11592,9716,10607,9970,5694,5250,8228,9716,10721.24974,6217,9970,53466,6815,-17911,7679,6815,61057,60281,35555,61145,60281
35061,NM,13932,9716,10607,9970,5694,5250,8573,9761,10188.98912,6217,9805,55154,7368,-17358,8496,7368,63742,62522,37796,63650,62522
36001,NY,13884,15136,10321,9258,5922,4819,11939,16101,11911.9095,11597,9610,67923,8401,-13881,11113,8401,71279,76324,54042,79036,76324
36003,NY,9996,15136,10321,9258,5922,4819,11316,15136,11467.98741,11597,9258,62274,6822,-16730,8742,6822,66768,69096,45544,71016,69096
36005,NY,22224,15136,10321,9258,5922,4819,13275,16315,11578.96793,11597,10554,77088,11205,-9384,14973,11205,80955,88293,67704,92061,88293
36007,NY,11844,15136,10321,9258,5922,4819,11613,16275,10025.2406,11597,8848,63408,7345,-15784,9529,7345,68913,70753,47624,72937,70753
36009,NY,10548,15136,10321,9258,5922,4819,11405,16784,9470.337988,11597,8687,61905,7345,-15784,9529,7345,67409,69250,46121,71434,69250
36011,NY,11736,15136,10321,9258,5922,4819,11595,15808,9766.28605,11597,9011,62737,7345,-15784,9529,7345,68787,70082,46953,72266,70082
36013,NY,10848,15136,10321,9258,5922,4819,11453,16507,9544.325004,11597,8574,61889,7345,-15784,9529,7345,67757,69234,46105,71418,69234
36015,NY,12108,15136,10321,9258,5922,4819,11655,18961,9174.389926,11597,8772,65431,8401,-13881,11113,8401,69219,73832,51550,76544,73832
36017,NY,10836,15136,10321,9258,5922,4819,11451,15136,11061.05882,11597,9258,62707,6822,-16730,8742,6822,67743,69529,45977,71449,69529
36019,NY,13104,15136,10321,9258,5922,4819,11814,16963,10099.22762,11597,8790,65372,7868,-14837,10316,7868,70374,73240,50535,75688,73240
36021,NY,13932,15136,10321,9258,5922,4819,11947,16891,10321.18867,11597,9079,66639,8401,-13881,11113,8401,71335,75040,52758,77752,75040
36023,NY,11604,15136,10321,9258,5922,4819,11574,19009,9803.279558,11597,9021,65854,8401,-13881,11113,8401,68634,74255,51973,76967,74255
36025,NY,10032,15136,10321,9258,5922,4819,11322,15136,12651.77966,11597,9258,63494,6822,-16730,8742,6822,66810,70316,46764,72236,70316
36027,NY,18912,15136,10321,9258,5922,4819,12745,15419,11467.98741,11597,9957,72172,9528,-11908,12768,9528,77113,81700,60264,84940,81700
36029,NY,10896,15136,10321,9258,5922,4819,11461,17809,10210.20814,11597,8907,64239,7868,-14837,10316,7868,67813,72107,49402,74555,72107
36031,NY,12216,15136,10321,9258,5922,4819,11672,15136,9914.260081,11597,9258,62940,7345,-15784,9529,7345,69344,70285,47156,72469,70285
36033,NY,12348,15136,10321,9258,5922,4819,11693,20110,8878.441864,11597,8536,66288,8401,-13881,11113,8401,69497,74689,52407,77401,74689
36035,NY,11220,15136,10321,9258,5922,4819,11513,17737,9803.279558,11597,8664,63840,7868,-14837,10316,7868,68189,71708,49003,74156,71708
36037,NY,11772,15136,10321,9258,5922,4819,11601,17893,9655.305527,11597,9141,64877,7868,-14837,10316,7868,68829,72745,50040,75193,72745
36039,NY,12540,15136,10321,9258,5922,4819,11724,15136,11726.94196,11597,9258,65077,7345,-15784,9529,7345,69720,72422,49293,74606,72422
36041,NY,9720,15136,10321,9258,5922,4819,11272,15136,10765.11076,11597,9258,61295,6822,-16730,8742,6822,66448,68117,44565,70037,68117
36043,NY,12384,15136,10321,9258,5922,4819,11699,17855,9433.34448,11597,8840,64929,7868,-14837,10316,7868,69539,72797,50092,75245,72797
36045,NY,15444,15136,10321,9258,5922,4819,12189,17704,9655.305527,11597,8951,68171,8965,-12894,11941,8965,73089,77136,55277,80112,77136
36047,NY,22224,15136,10321,9258,5922,4819,13275,16118,11578.96793,11597,10652,76989,11205,-9384,14973,11205,80955,88194,67605,91962,88194
36049,NY,11760,15136,10321,9258,5922,4819,11599,15136,10432.16919,11597,9258,63002,7345,-15784,9529,7345,68815,70347,47218,72531,70347
36051,NY,12612,15136,10321,9258,5922,4819,11736,18242,9914.260081,11597,9100,66284,8401,-13881,11113,8401,69804,74685,52403,77397,74685
36053,NY,12612,15136,10321,9258,5922,4819,11736,15997,10173.21464,11597,9113,64312,7868,-14837,10316,7868,69804,72180,49475,74628,72180
36055,NY,12612,15136,10321,9258,5922,4819,11736,15146,10210.20814,11597,9068,63452,7345,-15784,9529,7345,69804,70797,47668,72981,70797
36057,NY,11064,15136,10321,9258,5922,4819,11488,16969,9951.253589,11597,8779,63180,7345,-15784,9529,7345,68008,70525,47396,72709,70525
36059,NY,25164,15136,10321,9258,5922,4819,13746,15364,12281.84458,11597,10046,79272,11898,-8118,15780,11898,84366,91170,71154,95052,91170
36061,NY,22224,15136,10321,9258,5922,4819,13275,15907,16166.16289,11597,11336,82050,11898,-8118,15780,11898,80955,93948,73932,97830,93948
36063,NY,10896,15136,10321,9258,5922,4819,11461,15395,9618.312019,11597,8940,61266,6822,-16730,8742,6822,67813,68088,44536,70008,68088
36065,NY,12384,15136,10321,9258,5922,4819,11699,16232,10099.22762,11597,8813,63944,7868,-14837,10316,7868,69539,71812,49107,74260,71812
36067,NY,12612,15136,10321,9258,5922,4819,11736,15517,10099.22762,11597,9087,63730,7345,-15784,9529,7345,69804,71075,47946,73259,71075
36069,NY,12612,15136,10321,9258,5922,4819,11736,15930,9877.266574,11597,9091,63926,7868,-14837,10316,7868,69804,71794,49089,74242,71794
36071,NY,18912,15136,10321,9258,5922,4819,12745,15976,10913.08479,11597,9961,72178,9528,-11908,12768,9528,77113,81706,60270,84946,81706
36073,NY,12612,15136,10321,9258,5922,4819,11736,15578,8804.454848,11597,9097,62507,7868,-14837,10316,7868,69804,70375,47670,72823,70375
36075,NY,12612,15136,10321,9258,5922,4819,11736,16292,9285.370449,11597,9105,63711,7868,-14837,10316,7868,69804,71579,48874,74027,71579
36077,NY,13608,15136,10321,9258,5922,4819,11895,17206,10395.17568,11597,8823,66448,8401,-13881,11113,8401,70959,74849,52567,77561,74849
36079,NY,22224,15136,10321,9258,5922,4819,13275,16485,13354.6563,11597,9936,78416,11205,-9384,14973,11205,80955,89621,69032,93389,89621
36081,NY,22224,15136,10321,9258,5922,4819,13275,19389,11320.01338,11597,10414,79763,12812,-6481,16658,12812,80955,92575,73282,96421,92575
36083,NY,13884,15136,10321,9258,5922,4819,11939,17435,11578.96793,11597,9603,68917,8401,-13881,11113,8401,71279,77318,55036,80030,77318
36085,NY,22224,15136,10321,9258,5922,4819,13275,16958,11800.92898,11597,10156,77555,11898,-8118,15780,11898,80955,89453,69437,93335,89453
36087,NY,22224,15136,10321,9258,5922,4819,13275,16004,10876.09128,11597,9995,75515,11205,-9384,14973,11205,80955,86720,66131,90488,86720
36089,NY,11664,15136,10321,9258,5922,4819,11584,16910,9544.325004,11597,8583,63118,7345,-15784,9529,7345,68704,70463,47334,72647,70463
36091,NY,13884,15136,10321,9258,5922,4819,11939,15992,11874.91599,11597,9597,67764,8401,-13881,11113,8401,71279,76165,53883,78877,76165
36093,NY,13884,15136,10321,9258,5922,4819,11939,18341,11024.06531,11597,9610,69276,8965,-12894,11941,8965,71279,78241,56382,81217,78241
36095,NY,13884,15136,10321,9258,5922,4819,11939,18928,10987.07181,11597,9610,69825,8965,-12894,11941,8965,71279,78790,56931,81766,78790
36097,NY,11124,15136,10321,9258,5922,4819,11497,15136,9692.299035,11597,9258,61626,7345,-15784,9529,7345,68077,68971,45842,71155,68971
36099,NY,12156,15136,10321,9258,5922,4819,11663,18489,8693.474325,11597,8818,64573,8401,-13881,11113,8401,69275,72974,50692,75686,72974
36101,NY,10512,15136,10321,9258,5922,4819,11399,14243,9396.350973,11597,8752,59319,6822,-16730,8742,6822,67367,66141,42589,68061,66141
36103,NY,25164,15136,10321,9258,5922,4819,13746,17211,11874.91599,11597,9977,80643,12812,-6481,16658,12812,84366,93455,74162,97301,93455
36105,NY,14160,15136,10321,9258,5922,4819,11984,15136,9285.370449,11597,9258,64255,7868,-14837,10316,7868,71600,72123,49418,74571,72123
36107,NY,11844,15136,10321,9258,5922,4819,11613,14960,11504.98092,11597,8882,63607,7345,-15784,9529,7345,68913,70952,47823,73136,70952
36109,NY,18780,15136,10321,9258,5922,4819,12724,14475,11283.01987,11597,8881,69835,8965,-12894,11941,8965,76960,78800,56941,81776,78800
36111,NY,16704,15136,10321,9258,5922,4819,12391,15695,11098.05233,11597,9154,69067,8965,-12894,11941,8965,74551,78032,56173,81008,78032
36113,NY,16368,15136,10321,9258,5922,4819,12337,13204,10913.08479,11597,9000,65902,7868,-14837,10316,7868,74161,73770,51065,76218,73770
36115,NY,16368,15136,10321,9258,5922,4819,12337,16763,12651.77966,11597,9011,71211,8965,-12894,11941,8965,74161,80176,58317,83152,80176
36117,NY,12612,15136,10321,9258,5922,4819,11736,15884,9470.337988,11597,9097,63480,7868,-14837,10316,7868,69804,71348,48643,73796,71348
36119,NY,22236,15136,10321,9258,5922,4819,13277,18030,11874.91599,11597,10063,78619,11898,-8118,15780,11898,80969,90517,70501,94399,90517
36121,NY,10596,15136,10321,9258,5922,4819,11413,15136,11504.98092,11597,9258,62911,6822,-16730,8742,6822,67465,69733,46181,71653,69733
36123,NY,10788,15136,10321,9258,5922,4819,11443,16682,8323.539247,11597,9097,61306,7345,-15784,9529,7345,67687,68651,45522,70835,68651
37001,NC,10668,7261,8887,11553,6386,5178,9720,6471,8887.162454,12688,10990,54882,4053,-20673,5181,4053,59653,58935,34209,60063,58935
37003,NC,9996,7261,8887,11553,6386,5178,9604,6443,8887.162454,12688,10964,54157,4053,-20673,5181,4053,58865,58210,33484,59338,58210
37005,NC,10944,7261,8887,11553,6386,5178,9768,7261,8791.601567,12688,11553,56416,4408,-19990,5800,4408,59977,60824,36426,62216,60824
37007,NC,11184,7261,8887,11553,6386,5178,9810,7261,8632.333423,12688,11553,56496,4408,-19990,5800,4408,60259,60904,36506,62296,60904
37009,NC,9516,7261,8887,11553,6386,5178,9521,7261,8855.308825,12688,11553,55051,4053,-20673,5181,4053,58302,59104,34378,60232,59104
37011,NC,12432,7261,8887,11553,6386,5178,10026,7261,8855.308825,12688,11553,57967,4408,-19990,5800,4408,61723,62375,37977,63767,62375
37013,NC,11268,7261,8887,11553,6386,5178,9824,6862,9014.576969,12688,10704,55715,4053,-20673,5181,4053,60357,59768,35042,60896,59768
37015,NC,10128,7261,8887,11553,6386,5178,9627,7261,8281.943505,12688,11553,55090,4053,-20673,5181,4053,59020,59143,34417,60271,59143
37017,NC,9516,7261,8887,11553,6386,5178,9521,7261,8855.308825,12688,11553,55051,4053,-20673,5181,4053,58302,59104,34378,60232,59104
37019,NC,12936,7261,8887,11553,6386,5178,10113,6772,9874.624948,12688,10834,58283,4408,-19990,5800,4408,62314,62691,38293,64083,62691
37021,NC,11064,7261,8887,11553,6386,5178,9789,6629,8664.187051,12688,10775,54998,4053,-20673,5181,4053,60118,59051,34325,60179,59051
37023,NC,9996,7261,8887,11553,6386,5178,9604,6435,7772.285443,12688,10961,53029,4053,-20673,5181,4053,58865,57082,32356,58210,57082
37025,NC,13152,7261,8887,11553,6386,5178,10150,6200,8664.187051,12688,11534,57415,4408,-19990,5800,4408,62567,61823,37425,63215,61823
37027,NC,9996,7261,8887,11553,6386,5178,9604,6548,8058.968103,12688,10955,53424,4053,-20673,5181,4053,58865,57477,32751,58605,57477
37029,NC,12060,7261,8887,11553,6386,5178,9961,7076,9364.966886,12688,11327,57695,4408,-19990,5800,4408,61286,62103,37705,63495,62103
37031,NC,11856,7261,8887,11553,6386,5178,9926,6462,10256.86849,12688,10831,57272,4053,-20673,5181,4053,61047,61325,36599,62453,61325
37033,NC,10932,7261,8887,11553,6386,5178,9766,7261,7835.992701,12688,11553,55448,4408,-19990,5800,4408,59963,59856,35458,61248,59856
37035,NC,9996,7261,8887,11553,6386,5178,9604,6204,8536.772536,12688,10994,53597,3698,-21028,4562,3698,58865,57295,32569,58159,57295
37037,NC,13044,7261,8887,11553,6386,5178,10132,6676,9874.624948,12688,11327,58788,4408,-19990,5800,4408,62441,63196,38798,64588,63196
37039,NC,10104,7261,8887,11553,6386,5178,9622,7261,9237.552371,12688,11553,56022,4053,-20673,5181,4053,58991,60075,35349,61203,60075
37041,NC,10140,7261,8887,11553,6386,5178,9629,7261,8759.747938,12688,11553,55580,4053,-20673,5181,4053,59034,59633,34907,60761,59633
37043,NC,11268,7261,8887,11553,6386,5178,9824,7261,9364.966886,12688,11553,57313,4408,-19990,5800,4408,60357,61721,37323,63113,61721
37045,NC,10716,7261,8887,11553,6386,5178,9728,6451,7899.699959,12688,10477,53410,4053,-20673,5181,4053,59709,57463,32737,58591,57463
37047,NC,9516,7261,8887,11553,6386,5178,9521,7261,8600.479794,12688,11553,54796,4053,-20673,5181,4053,58302,58849,34123,59977,58849
37049,NC,12300,7261,8887,11553,6386,5178,10003,6427,9428.674144,12688,11019,57041,4408,-19990,5800,4408,61568,61449,37051,62841,61449
37051,NC,13092,7261,8887,11553,6386,5178,10140,6364,8696.04068,12688,11263,57281,4408,-19990,5800,4408,62497,61689,37291,63081,61689
37053,NC,18744,7261,8887,11553,6386,5178,11119,7083,10225.01487,12688,11837,65756,5828,-16877,8276,5828,69128,71584,48879,74032,71584
37055,NC,15720,7261,8887,11553,6386,5178,10595,6711,11085.06285,12688,11372,62754,5118,-18434,7038,5118,65580,67872,44320,69792,67872
37057,NC,10644,7261,8887,11553,6386,5178,9716,6211,7995.260845,12688,11060,53777,4053,-20673,5181,4053,59625,57830,33104,58958,57830
37059,NC,12000,7261,8887,11553,6386,5178,9951,6287,8950.869711,12688,11067,56171,4408,-19990,5800,4408,61216,60579,36181,61971,60579
37061,NC,9516,7261,8887,11553,6386,5178,9521,7261,8759.747938,12688,11553,54956,4053,-20673,5181,4053,58302,59009,34283,60137,59009
37063,NC,13044,7261,8887,11553,6386,5178,10132,6543,9046.430598,12688,11285,57784,4408,-19990,5800,4408,62441,62192,37794,63584,62192
37065,NC,11016,7261,8887,11553,6386,5178,9780,6231,8504.918907,12688,10441,54059,4053,-20673,5181,4053,60061,58112,33386,59240,58112
37067,NC,12000,7261,8887,11553,6386,5178,9951,6210,8759.747938,12688,11041,55876,4408,-19990,5800,4408,61216,60284,35886,61676,60284
37069,NC,13296,7261,8887,11553,6386,5178,10175,6548,8409.358021,12688,12240,58359,4763,-19212,6419,4763,62736,63122,39147,64778,63122
37071,NC,13152,7261,8887,11553,6386,5178,10150,7115,8281.943505,12688,11534,57948,4763,-19212,6419,4763,62567,62711,38736,64367,62711
37073,NC,10164,7261,8887,11553,6386,5178,9633,6739,9078.284227,12688,11834,55681,4053,-20673,5181,4053,59062,59734,35008,60862,59734
37075,NC,11268,7261,8887,11553,6386,5178,9824,7261,9301.259629,12688,11553,57249,4408,-19990,5800,4408,60357,61657,37259,63049,61657
37077,NC,10944,7261,8887,11553,6386,5178,9768,6617,8473.065278,12688,11389,55289,4053,-20673,5181,4053,59977,59342,34616,60470,59342
37079,NC,9600,7261,8887,11553,6386,5178,9535,7261,8154.52899,12688,11553,54435,4053,-20673,5181,4053,58400,58488,33762,59616,58488
37081,NC,11568,7261,8887,11553,6386,5178,9876,6651,8919.016082,12688,11037,56041,4408,-19990,5800,4408,60709,60449,36051,61841,60449
37083,NC,9960,7261,8887,11553,6386,5178,9598,6185,8377.504392,12688,9799,52188,3698,-21028,4562,3698,58823,55886,31160,56750,55886
37085,NC,11316,7261,8887,11553,6386,5178,9832,6269,8982.72334,12688,11395,55829,4053,-20673,5181,4053,60413,59882,35156,61010,59882
37087,NC,11136,7261,8887,11553,6386,5178,9801,6861,9333.113258,12688,10775,55971,4053,-20673,5181,4053,60202,60024,35298,61152,60024
37089,NC,11064,7261,8887,11553,6386,5178,9789,6962,8759.747938,12688,10774,55425,4053,-20673,5181,4053,60118,59478,34752,60606,59478
37091,NC,9516,7261,8887,11553,6386,5178,9521,7261,8281.943505,12688,11553,54478,4053,-20673,5181,4053,58302,58531,33805,59659,58531
37093,NC,11064,7261,8887,11553,6386,5178,9789,7465,9014.576969,12688,11278,56688,4408,-19990,5800,4408,60118,61096,36698,62488,61096
37095,NC,11940,7261,8887,11553,6386,5178,9940,7261,9619.795917,12688,11553,58240,4408,-19990,5800,4408,61145,62648,38250,64040,62648
37097,NC,12048,7261,8887,11553,6386,5178,9959,7429,8919.016082,12688,11531,57793,4408,-19990,5800,4408,61272,62201,37803,63593,62201
37099,NC,10524,7261,8887,11553,6386,5178,9695,7199,9173.845113,12688,10244,55007,4053,-20673,5181,4053,59484,59060,34334,60188,59060
37101,NC,13296,7261,8887,11553,6386,5178,10175,6924,9205.698742,12688,12255,59547,4763,-19212,6419,4763,62736,64310,40335,65966,64310
37103,NC,10752,7261,8887,11553,6386,5178,9735,7074,9078.284227,12688,11070,55840,4053,-20673,5181,4053,59752,59893,35167,61021,59893
37105,NC,10920,7261,8887,11553,6386,5178,9764,7065,9141.991484,12688,11356,56349,4408,-19990,5800,4408,59949,60757,36359,62149,60757
37107,NC,9720,7261,8887,11553,6386,5178,9556,7248,7708.578185,12688,10193,52735,3698,-21028,4562,3698,58541,56433,31707,57297,56433
37109,NC,10416,7261,8887,11553,6386,5178,9676,7292,8250.089876,12688,11531,55356,4053,-20673,5181,4053,59357,59409,34683,60537,59409
37111,NC,9540,7261,8887,11553,6386,5178,9525,7519,9078.284227,12688,10209,54212,4053,-20673,5181,4053,58330,58265,33539,59393,58265
37113,NC,10656,7261,8887,11553,6386,5178,9718,7261,9556.08866,12688,11553,56892,4408,-19990,5800,4408,59639,61300,36902,62692,61300
37115,NC,11064,7261,8887,11553,6386,5178,9789,7407,9333.113258,12688,10822,56493,4408,-19990,5800,4408,60118,60901,36503,62293,60901
37117,NC,9516,7261,8887,11553,6386,5178,9521,7261,8664.187051,12688,11553,54860,4053,-20673,5181,4053,58302,58913,34187,60041,58913
37119,NC,13152,7261,8887,11553,6386,5178,10150,7390,9364.966886,12688,11530,59304,4763,-19212,6419,4763,62567,64067,40092,65723,64067
37121,NC,9828,7261,8887,11553,6386,5178,9575,7261,9269.406,12688,11553,55777,4053,-20673,5181,4053,58668,59830,35104,60958,59830
37123,NC,10020,7261,8887,11553,6386,5178,9608,7261,8504.918907,12688,11553,55205,4053,-20673,5181,4053,58893,59258,34532,60386,59258
37125,NC,11256,7261,8887,11553,6386,5178,9822,7431,10479.8439,12688,10865,57898,4408,-19990,5800,4408,60343,62306,37908,63698,62306
37127,NC,11016,7261,8887,11553,6386,5178,9780,6896,8090.821732,12688,10439,54308,4053,-20673,5181,4053,60061,58361,33635,59489,58361
37129,NC,12936,7261,8887,11553,6386,5178,10113,7407,9524.235031,12688,11124,58857,4763,-19212,6419,4763,62314,63620,39645,65276,63620
37131,NC,10200,7261,8887,11553,6386,5178,9639,8020,9333.113258,12688,9896,55314,4053,-20673,5181,4053,59104,59367,34641,60495,59367
37133,NC,12780,7261,8887,11553,6386,5178,10086,7712,8887.162454,12688,11601,58847,4763,-19212,6419,4763,62131,63610,39635,65266,63610
37135,NC,13044,7261,8887,11553,6386,5178,10132,8099,10989.50196,12688,11296,61295,4763,-19212,6419,4763,62441,66058,42083,67714,66058
37137,NC,10908,7261,8887,11553,6386,5178,9762,7826,9619.795917,12688,11059,57278,4408,-19990,5800,4408,59935,61686,37288,63078,61686
37139,NC,11940,7261,8887,11553,6386,5178,9940,7245,8919.016082,12688,11298,57268,4408,-19990,5800,4408,61145,61676,37278,63068,61676
37141,NC,11652,7261,8887,11553,6386,5178,9891,7882,10129.45398,12688,11170,58699,4408,-19990,5800,4408,60808,63107,38709,64499,63107
37143,NC,13140,7261,8887,11553,6386,5178,10148,9059,8823.455196,12688,11317,60205,5118,-18434,7038,5118,62553,65323,41771,67243,65323
37145,NC,10092,7261,8887,11553,6386,5178,9620,8131,8473.065278,12688,11321,55884,4408,-19990,5800,4408,58977,60292,35894,61684,60292
37147,NC,11148,7261,8887,11553,6386,5178,9803,7954,8919.016082,12688,11086,56973,4408,-19990,5800,4408,60216,61381,36983,62773,61381
37149,NC,9600,7261,8887,11553,6386,5178,9535,7261,9396.820515,12688,11553,55677,4053,-20673,5181,4053,58400,59730,35004,60858,59730
37151,NC,11568,7261,8887,11553,6386,5178,9876,7928,8281.943505,12688,11052,56696,4408,-19990,5800,4408,60709,61104,36706,62496,61104
37153,NC,10128,7261,8887,11553,6386,5178,9627,7377,7613.017299,12688,9910,52894,4053,-20673,5181,4053,59020,56947,32221,58075,56947
37155,NC,9696,7261,8887,11553,6386,5178,9552,8712,7676.724557,12688,10293,54244,4053,-20673,5181,4053,58513,58297,33571,59425,58297
37157,NC,9516,7261,8887,11553,6386,5178,9521,7850,8759.747938,12688,11047,55039,4053,-20673,5181,4053,58302,59092,34366,60220,59092
37159,NC,10620,7261,8887,11553,6386,5178,9712,9034,8027.114474,12688,11534,57081,4408,-19990,5800,4408,59597,61489,37091,62881,61489
37161,NC,10836,7261,8887,11553,6386,5178,9749,8795,7740.431814,12688,10035,55272,4408,-19990,5800,4408,59850,59680,35282,61072,59680
37163,NC,10320,7261,8887,11553,6386,5178,9660,7261,8281.943505,12688,11553,55282,4053,-20673,5181,4053,59245,59335,34609,60463,59335
37165,NC,9852,7261,8887,11553,6386,5178,9579,8513,8887.162454,12688,9672,54790,4053,-20673,5181,4053,58696,58843,34117,59971,58843
37167,NC,10560,7261,8887,11553,6386,5178,9701,8543,8186.382618,12688,10951,56106,4408,-19990,5800,4408,59526,60514,36116,61906,60514
37169,NC,12000,7261,8887,11553,6386,5178,9951,8629,9364.966886,12688,11062,58922,4763,-19212,6419,4763,61216,63685,39710,65341,63685
37171,NC,11268,7261,8887,11553,6386,5178,9824,8911,8727.894309,12688,10249,57022,4408,-19990,5800,4408,60357,61430,37032,62822,61430
37173,NC,10884,7261,8887,11553,6386,5178,9758,7261,9014.576969,12688,11553,56579,4408,-19990,5800,4408,59907,60987,36589,62379,60987
37175,NC,10344,7261,8887,11553,6386,5178,9664,7801,9619.795917,12688,10491,56121,4053,-20673,5181,4053,59273,60174,35448,61302,60174
37177,NC,9792,7261,8887,11553,6386,5178,9568,8710,9779.064062,12688,11385,57532,4408,-19990,5800,4408,58625,61940,37542,63332,61940
37179,NC,13152,7261,8887,11553,6386,5178,10150,7403,9078.284227,12688,11533,59032,4763,-19212,6419,4763,62567,63795,39820,65451,63795
37181,NC,9888,7261,8887,11553,6386,5178,9585,9043,8281.943505,12688,10369,55447,4408,-19990,5800,4408,58738,59855,35457,61247,59855
37183,NC,13296,7261,8887,11553,6386,5178,10175,8141,9460.527773,12688,12283,61046,5118,-18434,7038,5118,62736,66164,42612,68084,66164
37185,NC,11268,7261,8887,11553,6386,5178,9824,7261,8409.358021,12688,11553,56357,4408,-19990,5800,4408,60357,60765,36367,62157,60765
37187,NC,10956,7261,8887,11553,6386,5178,9770,7261,8823.455196,12688,11553,56459,4408,-19990,5800,4408,59991,60867,36469,62259,60867
37189,NC,13584,7261,8887,11553,6386,5178,10225,8681,10766.52656,12688,9993,60890,4763,-19212,6419,4763,63074,65653,41678,67309,65653
37191,NC,10812,7261,8887,11553,6386,5178,9745,8022,8377.504392,12688,11065,56143,4408,-19990,5800,4408,59822,60551,36153,61943,60551
37193,NC,9516,7261,8887,11553,6386,5178,9521,7108,8982.72334,12688,10062,53534,3698,-21028,4562,3698,58302,57232,32506,58096,57232
37195,NC,12816,7261,8887,11553,6386,5178,10092,6430,8281.943505,12688,10470,55864,4408,-19990,5800,4408,62173,60272,35874,61664,60272
37197,NC,12000,7261,8887,11553,6386,5178,9951,6519,8855.308825,12688,11064,56304,4408,-19990,5800,4408,61216,60712,36314,62104,60712
37199,NC,9612,7261,8887,11553,6386,5178,9537,7261,8855.308825,12688,11553,55147,4053,-20673,5181,4053,58414,59200,34474,60328,59200
38001,ND,11268,17386,9078,11236,5524,4891,7279,17386,9663.85407,9924,11236,64369,7481,-15648,9665,7481,66662,71850,48721,74034,71850
38003,ND,9984,17386,9078,11236,5524,4891,7115,17386,9175.780633,9924,11236,62597,7481,-15648,9665,7481,65214,70078,46949,72262,70078
38005,ND,11268,17386,9078,11236,5524,4891,7279,17386,9240.857091,9924,11236,63946,7481,-15648,9665,7481,66662,71427,48298,73611,71427
38007,ND,9636,17386,9078,11236,5524,4891,7071,17386,10412.23334,9924,11236,63485,7481,-15648,9665,7481,64822,70966,47837,73150,70966
38009,ND,9516,17386,9078,11236,5524,4891,7056,17386,9468.624695,9924,11236,62422,7481,-15648,9665,7481,64687,69903,46774,72087,69903
38011,ND,11268,17386,9078,11236,5524,4891,7279,17386,9663.85407,9924,11236,64369,7481,-15648,9665,7481,66662,71850,48721,74034,71850
38013,ND,9888,17386,9078,11236,5524,4891,7103,17386,10184.46574,9924,11236,63509,7481,-15648,9665,7481,65106,70990,47861,73174,70990
38015,ND,11976,17386,9078,11236,5524,4891,7369,16729,8948.013028,9924,11821,64289,8052,-14653,10500,8052,67460,72341,49636,74789,72341
38017,ND,12096,17386,9078,11236,5524,4891,7384,19681,9143.242403,9924,11273,67008,8623,-13659,11335,8623,67595,75631,53349,78343,75631
38019,ND,10644,17386,9078,11236,5524,4891,7199,17386,9338.471779,9924,11236,63419,7481,-15648,9665,7481,65958,70900,47771,73084,70900
38021,ND,10212,17386,9078,11236,5524,4891,7144,17386,9305.933549,9924,11236,62955,7481,-15648,9665,7481,65471,70436,47307,72620,70436
38023,ND,10644,17386,9078,11236,5524,4891,7199,17386,10770.15386,9924,11236,64851,7481,-15648,9665,7481,65958,72332,49203,74516,72332
38025,ND,11268,17386,9078,11236,5524,4891,7279,17386,10347.15688,9924,11236,65052,7481,-15648,9665,7481,66662,72533,49404,74717,72533
38027,ND,11268,17386,9078,11236,5524,4891,7279,17386,9566.239383,9924,11236,64271,7481,-15648,9665,7481,66662,71752,48623,73936,71752
38029,ND,11268,17386,9078,11236,5524,4891,7279,17386,9013.089487,9924,11236,63718,7481,-15648,9665,7481,66662,71199,48070,73383,71199
38031,ND,11244,17386,9078,11236,5524,4891,7276,17386,9501.162924,9924,11236,64182,7481,-15648,9665,7481,66635,71663,48534,73847,71663
38033,ND,10644,17386,9078,11236,5524,4891,7199,17386,10412.23334,9924,11236,64493,7481,-15648,9665,7481,65958,71974,48845,74158,71974
38035,ND,11772,17386,9078,11236,5524,4891,7343,16921,9045.627716,9924,10999,63552,7481,-15648,9665,7481,67230,71033,47904,73217,71033
38037,ND,10644,17386,9078,11236,5524,4891,7199,17386,9143.242403,9924,11236,63224,7481,-15648,9665,7481,65958,70705,47576,72889,70705
38039,ND,11268,17386,9078,11236,5524,4891,7279,17386,9143.242403,9924,11236,63848,7481,-15648,9665,7481,66662,71329,48200,73513,71329
38041,ND,11268,17386,9078,11236,5524,4891,7279,17386,9598.777612,9924,11236,64304,7481,-15648,9665,7481,66662,71785,48656,73969,71785
38043,ND,11052,17386,9078,11236,5524,4891,7251,17386,9078.165945,9924,11236,63567,7481,-15648,9665,7481,66418,71048,47919,73232,71048
38045,ND,11268,17386,9078,11236,5524,4891,7279,17386,9533.701154,9924,11236,64239,7481,-15648,9665,7481,66662,71720,48591,73904,71720
38047,ND,10644,17386,9078,11236,5524,4891,7199,17386,9078.165945,9924,11236,63159,7481,-15648,9665,7481,65958,70640,47511,72824,70640
38049,ND,10032,17386,9078,11236,5524,4891,7121,18040,9468.624695,9924,11406,63761,7481,-15648,9665,7481,65268,71242,48113,73426,71242
38051,ND,11640,17386,9078,11236,5524,4891,7326,17386,9078.165945,9924,11236,64155,8052,-14653,10500,8052,67081,72207,49502,74655,72207
38053,ND,11268,17386,9078,11236,5524,4891,7279,17386,10477.3098,9924,11236,65182,7481,-15648,9665,7481,66662,72663,49534,74847,72663
38055,ND,10416,17386,9078,11236,5524,4891,7170,17386,9143.242403,9924,11236,62996,7481,-15648,9665,7481,65701,70477,47348,72661,70477
38057,ND,11268,17386,9078,11236,5524,4891,7279,17386,9403.548237,9924,11236,64109,7481,-15648,9665,7481,66662,71590,48461,73774,71590
38059,ND,11976,17386,9078,11236,5524,4891,7369,17290,9696.3923,9924,11785,65562,8052,-14653,10500,8052,67460,73614,50909,76062,73614
38061,ND,15972,17386,9078,11236,5524,4891,7878,17386,10119.38928,9924,11236,69528,9194,-12665,12170,9194,71965,78722,56863,81698,78722
38063,ND,10644,17386,9078,11236,5524,4891,7199,17386,9078.165945,9924,11236,63159,7481,-15648,9665,7481,65958,70640,47511,72824,70640
38065,ND,10644,17386,9078,11236,5524,4891,7199,23046,9013.089487,9924,11781,69299,9194,-12665,12170,9194,65958,78493,56634,81469,78493
38067,ND,9516,17386,9078,11236,5524,4891,7056,17386,9045.627716,9924,11236,61999,7481,-15648,9665,7481,64687,69480,46351,71664,69480
38069,ND,11268,17386,9078,11236,5524,4891,7279,17386,9468.624695,9924,11236,64174,7481,-15648,9665,7481,66662,71655,48526,73839,71655
38071,ND,10776,17386,9078,11236,5524,4891,7216,17386,9110.704174,9924,11236,63324,7481,-15648,9665,7481,66107,70805,47676,72989,70805
38073,ND,12132,17386,9078,11236,5524,4891,7389,17386,9208.318862,9924,11236,64777,8052,-14653,10500,8052,67636,72829,50124,75277,72829
38075,ND,11268,17386,9078,11236,5524,4891,7279,18716,9501.162924,9924,11408,65708,8052,-14653,10500,8052,66662,73760,51055,76208,73760
38077,ND,11196,17386,9078,11236,5524,4891,7270,16989,9143.242403,9924,11018,63160,7481,-15648,9665,7481,66581,70641,47512,72825,70641
38079,ND,11268,17386,9078,11236,5524,4891,7279,17386,9240.857091,9924,11236,63946,7481,-15648,9665,7481,66662,71427,48298,73611,71427
38081,ND,11028,17386,9078,11236,5524,4891,7248,17386,9143.242403,9924,11236,63608,7481,-15648,9665,7481,66391,71089,47960,73273,71089
38083,ND,10644,17386,9078,11236,5524,4891,7199,17386,9175.780633,9924,11236,63257,7481,-15648,9665,7481,65958,70738,47609,72922,70738
38085,ND,10536,17386,9078,11236,5524,4891,7186,18307,9013.089487,9924,11791,64461,8052,-14653,10500,8052,65837,72513,49808,74961,72513
38087,ND,10788,17386,9078,11236,5524,4891,7218,17386,9631.315841,9924,11236,63856,7481,-15648,9665,7481,66121,71337,48208,73521,71337
38089,ND,12348,17386,9078,11236,5524,4891,7416,19980,9598.777612,9924,11939,68681,9194,-12665,12170,9194,67879,77875,56016,80851,77875
38091,ND,10128,17386,9078,11236,5524,4891,7134,17386,9143.242403,9924,11236,62708,7481,-15648,9665,7481,65377,70189,47060,72373,70189
38093,ND,9972,17386,9078,11236,5524,4891,7114,17116,9631.315841,9924,10793,62327,6910,-16642,8830,6910,65201,69237,45685,71157,69237
38095,ND,10644,17386,9078,11236,5524,4891,7199,17386,9208.318862,9924,11236,63289,7481,-15648,9665,7481,65958,70770,47641,72954,70770
38097,ND,9900,17386,9078,11236,5524,4891,7104,17386,9143.242403,9924,11236,62480,7481,-15648,9665,7481,65119,69961,46832,72145,69961
38099,ND,10332,17386,9078,11236,5524,4891,7160,17386,9078.165945,9924,11236,62847,7481,-15648,9665,7481,65607,70328,47199,72512,70328
38101,ND,19728,17386,9078,11236,5524,4891,8357,17777,9501.162924,9924,11455,73277,12025,-8988,15529,12025,76200,85302,64289,88806,85302
38103,ND,11268,17386,9078,11236,5524,4891,7279,17386,9143.242403,9924,11236,63848,7481,-15648,9665,7481,66662,71329,48200,73513,71329
38105,ND,15732,17386,9078,11236,5524,4891,7847,19853,10444.77157,9924,12129,72973,9765,-11671,13005,9765,71694,82738,61302,85978,82738
39001,OH,9336,11608,9078,11236,5308,4891,6844,11608,8167.095528,8304,11236,53542,5905,-18821,7033,5905,58301,59447,34721,60575,59447
39003,OH,9792,11608,9078,11236,5308,4891,6902,10798,8069.48084,8304,10744,52599,5378,-19348,6242,5378,58815,57977,33251,58841,57977
39005,OH,10884,11608,9078,11236,5308,4891,7039,10845,7679.02209,8304,10837,53440,5905,-18821,7033,5905,60044,59345,34619,60473,59345
39007,OH,10044,11608,9078,11236,5308,4891,6933,10739,8362.324903,8304,10512,52853,5378,-19348,6242,5378,59098,58231,33505,59095,58231
39009,OH,10584,11608,9078,11236,5308,4891,7001,12543,8655.168965,8304,9855,54832,5905,-18821,7033,5905,59706,60737,36011,61865,60737
39011,OH,10584,11608,9078,11236,5308,4891,7001,10775,7906.789694,8304,11188,53649,5905,-18821,7033,5905,59706,59554,34828,60682,59554
39013,OH,9456,11608,9078,11236,5308,4891,6859,10529,7906.789694,8304,10408,51495,5378,-19348,6242,5378,58436,56873,32147,57737,56873
39015,OH,10452,11608,9078,11236,5308,4891,6985,11469,8590.092507,8304,11262,54968,5905,-18821,7033,5905,59558,60873,36147,62001,60873
39017,OH,12216,11608,9078,11236,5308,4891,7207,12316,8850.398341,8304,11262,57839,6959,-17016,8615,6959,61544,64798,40823,66454,64798
39019,OH,10440,11608,9078,11236,5308,4891,6983,10551,9533.701154,8304,10802,54522,5905,-18821,7033,5905,59544,60427,35701,61555,60427
39021,OH,10860,11608,9078,11236,5308,4891,7036,10962,9045.627716,8304,11001,55064,5905,-18821,7033,5905,60017,60969,36243,62097,60969
39023,OH,11268,11608,9078,11236,5308,4891,7088,11170,8199.633757,8304,10559,54391,5905,-18821,7033,5905,60477,60296,35570,61424,60296
39025,OH,12216,11608,9078,11236,5308,4891,7207,12679,8720.245424,8304,11260,58070,6959,-17016,8615,6959,61544,65029,41054,66685,65029
39027,OH,10152,11608,9078,11236,5308,4891,6947,11360,7776.636777,8304,10867,53350,5905,-18821,7033,5905,59220,59255,34529,60383,59255
39029,OH,9756,11608,9078,11236,5308,4891,6897,10754,8102.019069,8304,10564,52371,5378,-19348,6242,5378,58774,57749,33023,58613,57749
39031,OH,10152,11608,9078,11236,5308,4891,6947,10757,7418.716256,8304,10553,52076,5378,-19348,6242,5378,59220,57454,32728,58318,57454
39033,OH,10560,11608,9078,11236,5308,4891,6998,10361,8590.092507,8304,10384,53090,5378,-19348,6242,5378,59679,58468,33742,59332,58468
39035,OH,12060,11608,9078,11236,5308,4891,7187,13172,9143.242403,8304,10781,58352,6959,-17016,8615,6959,61368,65311,41336,66967,65311
39037,OH,10644,11608,9078,11236,5308,4891,7009,10006,7646.48386,8304,10714,52205,5378,-19348,6242,5378,59774,57583,32857,58447,57583
39039,OH,9708,11608,9078,11236,5308,4891,6891,10522,7548.869173,8304,10951,51925,5378,-19348,6242,5378,58720,57303,32577,58167,57303
39041,OH,12468,11608,9078,11236,5308,4891,7239,14159,9208.318862,8304,11257,60287,7486,-16066,9406,7486,61828,67773,44221,69693,67773
39043,OH,12444,11608,9078,11236,5308,4891,7236,11519,7841.713236,8304,10695,55695,6432,-17966,7824,6432,61801,62127,37729,63519,62127
39045,OH,12468,11608,9078,11236,5308,4891,7239,11924,8687.707195,8304,11260,57534,6432,-17966,7824,6432,61828,63966,39568,65358,63966
39047,OH,10476,11608,9078,11236,5308,4891,6988,10563,7548.869173,8304,10114,51897,5378,-19348,6242,5378,59585,57275,32549,58139,57275
39049,OH,12468,11608,9078,11236,5308,4891,7239,13922,9013.089487,8304,11261,59860,6959,-17016,8615,6959,61828,66819,42844,68475,66819
39051,OH,10956,11608,9078,11236,5308,4891,7048,11118,8948.013028,8304,10720,54937,5905,-18821,7033,5905,60125,60842,36116,61970,60842
39053,OH,9720,11608,9078,11236,5308,4891,6893,11830,7516.330944,8304,10075,52337,5378,-19348,6242,5378,58734,57715,32989,58579,57715
39055,OH,12060,11608,9078,11236,5308,4891,7187,12557,10184.46574,8304,10870,58866,6432,-17966,7824,6432,61368,65298,40900,66690,65298
39057,OH,11436,11608,9078,11236,5308,4891,7109,12447,8590.092507,8304,10661,56329,6432,-17966,7824,6432,60666,62761,38363,64153,62761
39059,OH,9204,11608,9078,11236,5308,4891,6828,10545,7613.945631,8304,10200,50758,5378,-19348,6242,5378,58153,56136,31410,57000,56136
39061,OH,12216,11608,9078,11236,5308,4891,7207,13491,8622.630736,8304,11261,58785,6959,-17016,8615,6959,61544,65744,41769,67400,65744
39063,OH,11028,11608,9078,11236,5308,4891,7057,11744,9013.089487,8304,10948,55928,5905,-18821,7033,5905,60206,61833,37107,62961,61833
39065,OH,10176,11608,9078,11236,5308,4891,6950,11608,8622.630736,8304,11236,54838,5905,-18821,7033,5905,59247,60743,36017,61871,60743
39067,OH,10488,11608,9078,11236,5308,4891,6989,11608,8297.248444,8304,11236,54824,5905,-18821,7033,5905,59598,60729,36003,61857,60729
39069,OH,10872,11608,9078,11236,5308,4891,7038,11608,8687.707195,8304,11236,55599,5905,-18821,7033,5905,60031,61504,36778,62632,61504
39071,OH,9180,11608,9078,11236,5308,4891,6825,11608,8297.248444,8304,11236,53516,5905,-18821,7033,5905,58126,59421,34695,60549,59421
39073,OH,9780,11608,9078,11236,5308,4891,6900,11185,8817.860111,8304,11261,54238,5905,-18821,7033,5905,58801,60143,35417,61271,60143
39075,OH,9264,11608,9078,11236,5308,4891,6835,11608,9175.780633,8304,11236,54479,5905,-18821,7033,5905,58220,60384,35658,61512,60384
39077,OH,10344,11608,9078,11236,5308,4891,6971,11376,7679.02209,8304,11107,53701,5905,-18821,7033,5905,59436,59606,34880,60734,59606
39079,OH,9720,11608,9078,11236,5308,4891,6893,11026,8459.93959,8304,9918,52319,5378,-19348,6242,5378,58734,57697,32971,58561,57697
39081,OH,9876,11608,9078,11236,5308,4891,6912,9915,8134.557298,8304,10352,51472,5378,-19348,6242,5378,58909,56850,32124,57714,56850
39083,OH,10800,11608,9078,11236,5308,4891,7029,10946,8167.095528,8304,10987,54095,5905,-18821,7033,5905,59950,60000,35274,61128,60000
39085,OH,12060,11608,9078,11236,5308,4891,7187,12344,9143.242403,8304,10838,57581,6432,-17966,7824,6432,61368,64013,39615,65405,64013
39087,OH,10188,11608,9078,11236,5308,4891,6952,10635,8102.019069,8304,10507,52628,5378,-19348,6242,5378,59261,58006,33280,58870,58006
39089,OH,12468,11608,9078,11236,5308,4891,7239,11865,8622.630736,8304,11262,57412,6432,-17966,7824,6432,61828,63844,39446,65236,63844
39091,OH,10044,11608,9078,11236,5308,4891,6933,10899,7776.636777,8304,10793,52708,5905,-18821,7033,5905,59098,58613,33887,59741,58613
39093,OH,12060,11608,9078,11236,5308,4891,7187,11899,8720.245424,8304,10844,56718,6432,-17966,7824,6432,61368,63150,38752,64542,63150
39095,OH,10956,11608,9078,11236,5308,4891,7048,11912,8459.93959,8304,10684,55207,5905,-18821,7033,5905,60125,61112,36386,62240,61112
39097,OH,12468,11608,9078,11236,5308,4891,7239,11478,9175.780633,8304,11260,57577,6432,-17966,7824,6432,61828,64009,39611,65401,64009
39099,OH,10080,11608,9078,11236,5308,4891,6938,10806,8459.93959,8304,10416,52958,5378,-19348,6242,5378,59139,58336,33610,59200,58336
39101,OH,11136,11608,9078,11236,5308,4891,7071,10809,7906.789694,8304,10445,53492,5905,-18821,7033,5905,60328,59397,34671,60525,59397
39103,OH,12060,11608,9078,11236,5308,4891,7187,12328,9110.704174,8304,10850,57544,6432,-17966,7824,6432,61368,63976,39578,65368,63976
39105,OH,9576,11608,9078,11236,5308,4891,6875,11608,9045.627716,8304,11236,54661,5905,-18821,7033,5905,58572,60566,35840,61694,60566
39107,OH,10200,11608,9078,11236,5308,4891,6953,10673,7386.178027,8304,11279,52733,5905,-18821,7033,5905,59274,58638,33912,59766,58638
39109,OH,11436,11608,9078,11236,5308,4891,7109,11032,8232.171986,8304,10686,54581,5905,-18821,7033,5905,60666,60486,35760,61614,60486
39111,OH,9180,11608,9078,11236,5308,4891,6825,11608,8394.863132,8304,11236,53614,5905,-18821,7033,5905,58126,59519,34793,60647,59519
39113,OH,11436,11608,9078,11236,5308,4891,7109,12101,8329.786674,8304,10622,55683,6432,-17966,7824,6432,60666,62115,37717,63507,62115
39115,OH,10860,11608,9078,11236,5308,4891,7036,11608,8264.710215,8304,11236,55164,5905,-18821,7033,5905,60017,61069,36343,62197,61069
39117,OH,12468,11608,9078,11236,5308,4891,7239,11057,8948.013028,8304,11260,56928,6432,-17966,7824,6432,61828,63360,38962,64752,63360
39119,OH,10944,11608,9078,11236,5308,4891,7047,11115,8036.942611,8304,10600,53891,5905,-18821,7033,5905,60112,59796,35070,60924,59796
39121,OH,10140,11608,9078,11236,5308,4891,6946,11608,8069.48084,8304,11236,54248,5905,-18821,7033,5905,59207,60153,35427,61281,60153
39123,OH,10956,11608,9078,11236,5308,4891,7048,11598,9501.162924,8304,10832,56082,5905,-18821,7033,5905,60125,61987,37261,63115,61987
39125,OH,9420,11608,9078,11236,5308,4891,6855,11608,8329.786674,8304,11236,53789,5905,-18821,7033,5905,58396,59694,34968,60822,59694
39127,OH,9648,11608,9078,11236,5308,4891,6884,10805,8850.398341,8304,11260,53759,5378,-19348,6242,5378,58653,59137,34411,60001,59137
39129,OH,12468,11608,9078,11236,5308,4891,7239,11470,7809.175006,8304,11259,56201,6432,-17966,7824,6432,61828,62633,38235,64025,62633
39131,OH,10860,11608,9078,11236,5308,4891,7036,11608,8459.93959,8304,11236,55359,5905,-18821,7033,5905,60017,61264,36538,62392,61264
39133,OH,11580,11608,9078,11236,5308,4891,7127,12772,9240.857091,8304,11019,57807,6432,-17966,7824,6432,60828,64239,39841,65631,64239
39135,OH,10524,11608,9078,11236,5308,4891,6994,11608,8459.93959,8304,11236,55023,5905,-18821,7033,5905,59639,60928,36202,62056,60928
39137,OH,9360,11608,9078,11236,5308,4891,6847,11608,8394.863132,8304,11236,53794,5905,-18821,7033,5905,58328,59699,34973,60827,59699
39139,OH,10824,11608,9078,11236,5308,4891,7032,10977,8362.324903,8304,10487,53846,5905,-18821,7033,5905,59977,59751,35025,60879,59751
39141,OH,10632,11608,9078,11236,5308,4891,7007,11278,7841.713236,8304,10481,53427,5905,-18821,7033,5905,59760,59332,34606,60460,59332
39143,OH,9732,11608,9078,11236,5308,4891,6894,10828,7841.713236,8304,10877,52474,5378,-19348,6242,5378,58747,57852,33126,58716,57852
39145,OH,9180,11608,9078,11236,5308,4891,6825,10932,7971.866152,8304,9826,51105,5378,-19348,6242,5378,58126,56483,31757,57347,56483
39147,OH,10260,11608,9078,11236,5308,4891,6961,10327,7971.866152,8304,10748,52501,5378,-19348,6242,5378,59342,57879,33153,58743,57879
39149,OH,9816,11608,9078,11236,5308,4891,6905,11253,7809.175006,8304,11243,53317,5905,-18821,7033,5905,58842,59222,34496,60350,59222
39151,OH,10440,11608,9078,11236,5308,4891,6983,11189,8590.092507,8304,10778,54192,5905,-18821,7033,5905,59544,60097,35371,61225,60097
39153,OH,11580,11608,9078,11236,5308,4891,7127,12183,8948.013028,8304,11003,56909,6432,-17966,7824,6432,60828,63341,38943,64733,63341
39155,OH,10080,11608,9078,11236,5308,4891,6938,10815,8264.710215,8304,10447,52802,5378,-19348,6242,5378,59139,58180,33454,59044,58180
39157,OH,9684,11608,9078,11236,5308,4891,6888,10779,8329.786674,8304,10809,52797,5378,-19348,6242,5378,58693,58175,33449,59039,58175
39159,OH,11952,11608,9078,11236,5308,4891,7174,12447,8134.557298,8304,11261,56990,6432,-17966,7824,6432,61247,63422,39024,64814,63422
39161,OH,9624,11608,9078,11236,5308,4891,6881,9881,9013.089487,8304,10827,52541,5378,-19348,6242,5378,58626,57919,33193,58783,57919
39163,OH,10452,11608,9078,11236,5308,4891,6985,11608,8199.633757,8304,11236,54691,5905,-18821,7033,5905,59558,60596,35870,61724,60596
39165,OH,12216,11608,9078,11236,5308,4891,7207,13012,8655.168965,8304,11261,58339,6959,-17016,8615,6959,61544,65298,41323,66954,65298
39167,OH,9888,11608,9078,11236,5308,4891,6914,11123,8427.401361,8304,10475,53108,5378,-19348,6242,5378,58923,58486,33760,59350,58486
39169,OH,9960,11608,9078,11236,5308,4891,6923,11450,8069.48084,8304,11145,53820,5905,-18821,7033,5905,59004,59725,34999,60853,59725
39171,OH,9180,11608,9078,11236,5308,4891,6825,11608,8590.092507,8304,11236,53809,5905,-18821,7033,5905,58126,59714,34988,60842,59714
39173,OH,10956,11608,9078,11236,5308,4891,7048,12524,8362.324903,8304,10707,55744,6432,-17966,7824,6432,60125,62176,37778,63568,62176
39175,OH,10632,11608,9078,11236,5308,4891,7007,11608,8882.93657,8304,11236,55554,5905,-18821,7033,5905,59760,61459,36733,62587,61459
40001,OK,9060,8489,8887,11553,6723,5178,6784,8489,8632.333423,9460,11553,52372,5638,-19088,6502,5638,56674,58010,33284,58874,58010
40003,OK,9012,8489,8887,11553,6723,5178,6778,8489,8504.918907,9460,11553,52197,5638,-19088,6502,5638,56620,57835,33109,58699,57835
40005,OK,8964,8489,8887,11553,6723,5178,6772,8489,9078.284227,9460,11553,52722,5638,-19088,6502,5638,56566,58360,33634,59224,58360
40007,OK,9216,8489,8887,11553,6723,5178,6804,8489,8855.308825,9460,11553,52751,5638,-19088,6502,5638,56850,58389,33663,59253,58389
40009,OK,10212,8489,8887,11553,6723,5178,6928,8405,9460.527773,9460,11424,54139,5638,-19088,6502,5638,57970,59777,35051,60641,59777
40011,OK,11196,8489,8887,11553,6723,5178,7051,8489,9237.552371,9460,11553,55114,6155,-18571,7283,6155,59077,61269,36543,62397,61269
40013,OK,10008,8489,8887,11553,6723,5178,6903,8667,9110.137856,9460,10541,52965,5638,-19088,6502,5638,57741,58603,33877,59467,58603
40015,OK,8964,8489,8887,11553,6723,5178,6772,8489,8823.455196,9460,11553,52467,5638,-19088,6502,5638,56566,58105,33379,58969,58105
40017,OK,11868,8489,8887,11553,6723,5178,7136,10133,10033.89309,9460,11499,58172,6671,-17727,8063,6671,59834,64843,40445,66235,64843
40019,OK,9252,8489,8887,11553,6723,5178,6808,8429,8345.650763,9460,11152,51817,5638,-19088,6502,5638,56890,57455,32729,58319,57455
40021,OK,8964,8489,8887,11553,6723,5178,6772,9168,8664.187051,9460,10553,51987,5638,-19088,6502,5638,56566,57625,32899,58489,57625
40023,OK,10608,8489,8887,11553,6723,5178,6978,8489,9141.991484,9460,11553,54430,6155,-18571,7283,6155,58416,60585,35859,61713,60585
40025,OK,9096,8489,8887,11553,6723,5178,6789,8489,9078.284227,9460,11553,52854,5638,-19088,6502,5638,56715,58492,33766,59356,58492
40027,OK,11868,8489,8887,11553,6723,5178,7136,10672,9396.820515,9460,11497,58071,6671,-17727,8063,6671,59834,64742,40344,66134,64742
40029,OK,10560,8489,8887,11553,6723,5178,6972,8489,9205.698742,9460,11553,54446,6155,-18571,7283,6155,58362,60601,35875,61729,60601
40031,OK,12120,8489,8887,11553,6723,5178,7167,9260,8696.04068,9460,11245,55959,6671,-17727,8063,6671,60117,62630,38232,64022,62630
40033,OK,9036,8489,8887,11553,6723,5178,6781,7467,8664.187051,9460,11293,51098,5122,-19604,5722,5122,56647,56220,31494,56820,56220
40035,OK,9564,8489,8887,11553,6723,5178,6847,8489,8664.187051,9460,11553,52908,5638,-19088,6502,5638,57241,58546,33820,59410,58546
40037,OK,12024,8489,8887,11553,6723,5178,7155,9234,8982.72334,9460,11350,56228,6671,-17727,8063,6671,60009,62899,38501,64291,62899
40039,OK,10608,8489,8887,11553,6723,5178,6978,8962,9460.527773,9460,11328,54996,6155,-18571,7283,6155,58416,61151,36425,62279,61151
40041,OK,10152,8489,8887,11553,6723,5178,6921,8489,8855.308825,9460,11553,53687,5638,-19088,6502,5638,57903,59325,34599,60189,59325
40043,OK,8964,8489,8887,11553,6723,5178,6772,8489,9492.381402,9460,11553,53136,5638,-19088,6502,5638,56566,58774,34048,59638,58774
40045,OK,8964,8489,8887,11553,6723,5178,6772,8489,9364.966886,9460,11553,53009,5638,-19088,6502,5638,56566,58647,33921,59511,58647
40047,OK,9888,8489,8887,11553,6723,5178,6888,7913,8186.382618,9460,11221,51846,5638,-19088,6502,5638,57606,57484,32758,58348,57484
40049,OK,8964,8489,8887,11553,6723,5178,6772,8489,9141.991484,9460,11553,52786,5638,-19088,6502,5638,56566,58424,33698,59288,58424
40051,OK,9684,8489,8887,11553,6723,5178,6862,9138,9078.284227,9460,11496,54034,5638,-19088,6502,5638,57376,59672,34946,60536,59672
40053,OK,8964,8489,8887,11553,6723,5178,6772,8489,8218.236247,9460,11553,51862,5638,-19088,6502,5638,56566,57500,32774,58364,57500
40055,OK,9600,8489,8887,11553,6723,5178,6852,8489,9205.698742,9460,11553,53486,5638,-19088,6502,5638,57282,59124,34398,59988,59124
40057,OK,9228,8489,8887,11553,6723,5178,6805,8489,9301.259629,9460,11553,53209,5638,-19088,6502,5638,56863,58847,34121,59711,58847
40059,OK,9240,8489,8887,11553,6723,5178,6807,8489,9428.674144,9460,11553,53349,5638,-19088,6502,5638,56877,58987,34261,59851,58987
40061,OK,9936,8489,8887,11553,6723,5178,6894,8489,8600.479794,9460,11553,53216,5638,-19088,6502,5638,57660,58854,34128,59718,58854
40063,OK,9252,8489,8887,11553,6723,5178,6808,8489,9078.284227,9460,11553,53010,5638,-19088,6502,5638,56890,58648,33922,59512,58648
40065,OK,10452,8489,8887,11553,6723,5178,6958,7766,8950.869711,9460,11046,52853,5638,-19088,6502,5638,58240,58491,33765,59355,58491
40067,OK,8964,8489,8887,11553,6723,5178,6772,8489,8696.04068,9460,11553,52340,5638,-19088,6502,5638,56566,57978,33252,58842,57978
40069,OK,8964,8489,8887,11553,6723,5178,6772,8489,8791.601567,9460,11553,52436,5638,-19088,6502,5638,56566,58074,33348,58938,58074
40071,OK,9876,8489,8887,11553,6723,5178,6886,7506,7899.699959,9460,10889,50809,5122,-19604,5722,5122,57592,55931,31205,56531,55931
40073,OK,10200,8489,8887,11553,6723,5178,6927,8489,8982.72334,9460,11553,53863,5638,-19088,6502,5638,57957,59501,34775,60365,59501
40075,OK,10236,8489,8887,11553,6723,5178,6931,8489,8887.162454,9460,11553,53803,5638,-19088,6502,5638,57997,59441,34715,60305,59441
40077,OK,10404,8489,8887,11553,6723,5178,6952,8489,8759.747938,9460,11553,53844,5638,-19088,6502,5638,58186,59482,34756,60346,59482
40079,OK,9444,8489,8887,11553,6723,5178,6832,7823,8536.772536,9460,10592,51034,5122,-19604,5722,5122,57106,56156,31430,56756,56156
40081,OK,9804,8489,8887,11553,6723,5178,6877,8754,9014.576969,9460,11499,53710,5638,-19088,6502,5638,57511,59348,34622,60212,59348
40083,OK,11868,8489,8887,11553,6723,5178,7136,10287,9428.674144,9460,11497,57719,6671,-17727,8063,6671,59834,64390,39992,65782,64390
40085,OK,10020,8489,8887,11553,6723,5178,6904,8489,8950.869711,9460,11553,53651,5638,-19088,6502,5638,57754,59289,34563,60153,59289
40087,OK,11868,8489,8887,11553,6723,5178,7136,10066,9237.552371,9460,11499,57309,6671,-17727,8063,6671,59834,63980,39582,65372,63980
40089,OK,9804,8489,8887,11553,6723,5178,6877,8489,9014.576969,9460,11553,53499,5638,-19088,6502,5638,57511,59137,34411,60001,59137
40091,OK,9000,8489,8887,11553,6723,5178,6777,8489,9173.845113,9460,11553,52854,5638,-19088,6502,5638,56607,58492,33766,59356,58492
40093,OK,10608,8489,8887,11553,6723,5178,6978,8489,8632.333423,9460,11553,53920,6155,-18571,7283,6155,58416,60075,35349,61203,60075
40095,OK,10152,8489,8887,11553,6723,5178,6921,8489,8696.04068,9460,11553,53528,5638,-19088,6502,5638,57903,59166,34440,60030,59166
40097,OK,9900,8489,8887,11553,6723,5178,6889,8489,8887.162454,9460,11553,53467,5638,-19088,6502,5638,57619,59105,34379,59969,59105
40099,OK,9252,8489,8887,11553,6723,5178,6808,8489,8823.455196,9460,11553,52755,5638,-19088,6502,5638,56890,58393,33667,59257,58393
40101,OK,10068,8489,8887,11553,6723,5178,6910,8566,9046.430598,9460,10306,52624,5638,-19088,6502,5638,57808,58262,33536,59126,58262
40103,OK,9732,8489,8887,11553,6723,5178,6868,8489,8855.308825,9460,11553,53267,5638,-19088,6502,5638,57430,58905,34179,59769,58905
40105,OK,9024,8489,8887,11553,6723,5178,6780,8489,8855.308825,9460,11553,52559,5638,-19088,6502,5638,56634,58197,33471,59061,58197
40107,OK,10020,8489,8887,11553,6723,5178,6904,8489,9141.991484,9460,11553,53842,5638,-19088,6502,5638,57754,59480,34754,60344,59480
40109,OK,11868,8489,8887,11553,6723,5178,7136,10250,8855.308825,9460,11500,57111,6671,-17727,8063,6671,59834,63782,39384,65174,63782
40111,OK,9036,8489,8887,11553,6723,5178,6781,8411,8791.601567,9460,11343,52220,5638,-19088,6502,5638,56647,57858,33132,58722,57858
40113,OK,12024,8489,8887,11553,6723,5178,7155,8940,9141.991484,9460,11356,56100,6155,-18571,7283,6155,60009,62255,37529,63383,62255
40115,OK,9372,8489,8887,11553,6723,5178,6823,7754,8313.797134,9460,10401,50479,5122,-19604,5722,5122,57025,55601,30875,56201,55601
40117,OK,9024,8489,8887,11553,6723,5178,6780,9098,8982.72334,9460,11348,53092,5638,-19088,6502,5638,56634,58730,34004,59594,58730
40119,OK,12288,8489,8887,11553,6723,5178,7188,10304,9810.917691,9460,10323,57364,6671,-17727,8063,6671,60306,64035,39637,65427,64035
40121,OK,9852,8489,8887,11553,6723,5178,6883,8056,8982.72334,9460,10589,52118,5638,-19088,6502,5638,57565,57756,33030,58620,57756
40123,OK,9672,8489,8887,11553,6723,5178,6861,8022,9269.406,9460,11079,52680,5638,-19088,6502,5638,57363,58318,33592,59182,58318
40125,OK,11028,8489,8887,11553,6723,5178,7030,8477,9651.649546,9460,11034,54828,6155,-18571,7283,6155,58888,60983,36257,62111,60983
40127,OK,9480,8489,8887,11553,6723,5178,6837,8489,9014.576969,9460,11553,53175,5638,-19088,6502,5638,57147,58813,34087,59677,58813
40129,OK,9576,8489,8887,11553,6723,5178,6849,8489,9492.381402,9460,11553,53748,5638,-19088,6502,5638,57255,59386,34660,60250,59386
40131,OK,12024,8489,8887,11553,6723,5178,7155,9927,9237.552371,9460,11346,57173,6671,-17727,8063,6671,60009,63844,39446,65236,63844
40133,OK,10584,8489,8887,11553,6723,5178,6975,8489,8919.016082,9460,11553,54183,6155,-18571,7283,6155,58389,60338,35612,61466,60338
40135,OK,9588,8489,8887,11553,6723,5178,6850,7989,8568.626165,9460,10601,51384,5122,-19604,5722,5122,57268,56506,31780,57106,56506
40137,OK,10080,8489,8887,11553,6723,5178,6912,7766,9333.113258,9460,10973,52791,5638,-19088,6502,5638,57822,58429,33703,59293,58429
40139,OK,9180,8489,8887,11553,6723,5178,6799,9074,8887.162454,9460,12000,53779,5638,-19088,6502,5638,56809,59417,34691,60281,59417
40141,OK,9348,8489,8887,11553,6723,5178,6820,8489,8664.187051,9460,11553,52692,5638,-19088,6502,5638,56998,58330,33604,59194,58330
40143,OK,12024,8489,8887,11553,6723,5178,7155,10474,8791.601567,9460,11336,57263,6671,-17727,8063,6671,60009,63934,39536,65326,63934
40145,OK,12024,8489,8887,11553,6723,5178,7155,9688,9269.406,9460,11354,56974,6671,-17727,8063,6671,60009,63645,39247,65037,63645
40147,OK,11496,8489,8887,11553,6723,5178,7089,8571,8345.650763,9460,11026,54076,6155,-18571,7283,6155,59415,60231,35505,61359,60231
40149,OK,10608,8489,8887,11553,6723,5178,6978,8489,9364.966886,9460,11553,54653,6155,-18571,7283,6155,58416,60808,36082,61936,60808
40151,OK,9000,8489,8887,11553,6723,5178,6777,8489,8600.479794,9460,11553,52280,5638,-19088,6502,5638,56607,57918,33192,58782,57918
40153,OK,10608,8489,8887,11553,6723,5178,6978,8678,9333.113258,9460,11647,54904,6155,-18571,7283,6155,58416,61059,36333,62187,61059
41001,OR,10044,14625,10607,9970,6020,5250,10467,14625,10949.36144,8425,9970,59263,9877,-14098,11533,9877,66983,69140,45165,70796,69140
41003,OR,14568,14625,10607,9970,6020,5250,11305,17210,11785.77099,8425,9546,66785,11776,-10929,14224,11776,72345,78561,55856,81009,78561
41005,OR,16308,14625,10607,9970,6020,5250,11627,18132,11481.62207,8425,10017,69614,13042,-8817,16018,13042,74407,82656,60797,85632,82656
41007,OR,13116,14625,10607,9970,6020,5250,11036,15200,10759.26836,8425,9399,62150,10510,-13042,12430,10510,70624,72660,49108,74580,72660
41009,OR,16308,14625,10607,9970,6020,5250,11627,14835,11823.78961,8425,10024,66666,11776,-10929,14224,11776,74407,78442,55737,80890,78442
41011,OR,11748,14625,10607,9970,6020,5250,10782,13667,11291.52898,8425,8781,59162,9877,-14098,11533,9877,69002,69039,45064,70695,69039
41013,OR,11988,14625,10607,9970,6020,5250,10827,14250,19047.32667,8425,8819,67779,9877,-14098,11533,9877,69287,77656,53681,79312,77656
41015,OR,14100,14625,10607,9970,6020,5250,11218,17118,12089.91992,8425,8602,65585,11776,-10929,14224,11776,71790,77361,54656,79809,77361
41017,OR,13764,14625,10607,9970,6020,5250,11156,15679,11405.58483,8425,9570,64094,11143,-11986,13327,11143,71392,75237,52108,77421,75237
41019,OR,11568,14625,10607,9970,6020,5250,10749,15023,10379.0822,8425,9114,59760,9877,-14098,11533,9877,68789,69637,45662,71293,69637
41021,OR,11028,14625,10607,9970,6020,5250,10649,14625,11101.4359,8425,9970,60399,9877,-14098,11533,9877,68149,70276,46301,71932,70276
41023,OR,11268,14625,10607,9970,6020,5250,10694,14625,10531.15666,8425,9970,60069,10510,-13042,12430,10510,68434,70579,47027,72499,70579
41025,OR,9516,14625,10607,9970,6020,5250,10369,14625,10835.30559,8425,9970,58621,9877,-14098,11533,9877,66357,68498,44523,70154,68498
41027,OR,14760,14625,10607,9970,6020,5250,11340,15503,12508.1247,8425,10126,66572,11776,-10929,14224,11776,72572,78348,55643,80796,78348
41029,OR,14748,14625,10607,9970,6020,5250,11338,16605,10607.19389,8425,9283,64918,11776,-10929,14224,11776,72558,76694,53989,79142,76694
41031,OR,11268,14625,10607,9970,6020,5250,10694,14625,11557.6593,8425,9970,61096,10510,-13042,12430,10510,68434,71606,48054,73526,71606
41033,OR,14124,14625,10607,9970,6020,5250,11222,15064,11253.51037,8425,8637,62753,11143,-11986,13327,11143,71818,73896,50767,76080,73896
41035,OR,11976,14625,10607,9970,6020,5250,10825,14245,11557.6593,8425,8867,60320,9877,-14098,11533,9877,69273,70197,46222,71853,70197
41037,OR,9516,14625,10607,9970,6020,5250,10369,14625,10835.30559,8425,9970,58621,9877,-14098,11533,9877,66357,68498,44523,70154,68498
41039,OR,14400,14625,10607,9970,6020,5250,11274,16359,10873.32421,8425,9262,64569,11776,-10929,14224,11776,72146,76345,53640,78793,76345
41041,OR,13284,14625,10607,9970,6020,5250,11067,15401,12356.05024,8425,9161,63877,11143,-11986,13327,11143,70823,75020,51891,77204,75020
41043,OR,13140,14625,10607,9970,6020,5250,11040,15136,10455.11943,8425,9598,62004,11143,-11986,13327,11143,70652,73147,50018,75331,73147
41045,OR,10776,14625,10607,9970,6020,5250,10602,13686,9618.709876,8425,9035,56791,9244,-15154,10636,9244,67850,66035,41637,67427,66035
41047,OR,13788,14625,10607,9970,6020,5250,11160,16489,10341.06358,8425,9766,64059,11776,-10929,14224,11776,71420,75835,53130,78283,75835
41049,OR,9756,14625,10607,9970,6020,5250,10414,15211,10569.17528,8425,9848,59059,9877,-14098,11533,9877,66642,68936,44961,70592,68936
41051,OR,16308,14625,10607,9970,6020,5250,11627,19077,11633.69653,8425,10025,70718,13042,-8817,16018,13042,74407,83760,61901,86736,83760
41053,OR,13788,14625,10607,9970,6020,5250,11160,15588,11291.52898,8425,9781,64123,11143,-11986,13327,11143,71420,75266,52137,77450,75266
41055,OR,10056,14625,10607,9970,6020,5250,10469,14625,10797.28698,8425,9970,59123,9877,-14098,11533,9877,66997,69000,45025,70656,69000
41057,OR,12600,14625,10607,9970,6020,5250,10940,14625,11899.82684,8425,9970,62770,10510,-13042,12430,10510,70012,73280,49728,75200,73280
41059,OR,11076,14625,10607,9970,6020,5250,10658,14073,11025.39867,8425,9863,59712,9877,-14098,11533,9877,68206,69589,45614,71245,69589
41061,OR,10620,14625,10607,9970,6020,5250,10574,14341,11519.64068,8425,9369,59525,9877,-14098,11533,9877,67666,69402,45427,71058,69402
41063,OR,9516,14625,10607,9970,6020,5250,10369,14625,10835.30559,8425,9970,58621,9877,-14098,11533,9877,66357,68498,44523,70154,68498
41065,OR,12828,14625,10607,9970,6020,5250,10982,15315,11785.77099,8425,9241,62845,10510,-13042,12430,10510,70282,73355,49803,75275,73355
41067,OR,16308,14625,10607,9970,6020,5250,11627,19405,10873.32421,8425,10020,70281,13675,-7761,16915,13675,74407,83956,62520,87196,83956
41069,OR,9516,14625,10607,9970,6020,5250,10369,14625,10873.32421,8425,9970,58659,9877,-14098,11533,9877,66357,68536,44561,70192,68536
41071,OR,16308,14625,10607,9970,6020,5250,11627,16668,11025.39867,8425,10014,67691,12409,-9873,15121,12409,74407,80100,57818,82812,80100
42001,PA,13188,9358,10321,9258,5703,4819,8949,9497,12318.83809,8909,9483,58215,6960,-17438,8352,6960,61596,65175,40777,66567,65175
42003,PA,11892,9358,10321,9258,5703,4819,8760,9255,10580.14322,8909,8882,54337,6445,-18281,7573,6445,60111,60782,36056,61910,60782
42005,PA,9660,9358,10321,9258,5703,4819,8435,8241,10728.11725,8909,8944,51301,5417,-19309,6017,5417,57554,56718,31992,57318,56718
42007,PA,11892,9358,10321,9258,5703,4819,8760,8574,9729.292543,8909,8930,52854,5931,-18795,6795,5931,60111,58785,34059,59649,58785
42009,PA,9900,9358,10321,9258,5703,4819,8470,9358,11541.97442,8909,9258,53786,5931,-18795,6795,5931,57829,59717,34991,60581,59717
42011,PA,12840,9358,10321,9258,5703,4819,8899,9915,10506.15621,8909,9329,56319,6960,-17438,8352,6960,61198,63279,38881,64671,63279
42013,PA,10800,9358,10321,9258,5703,4819,8601,8434,10099.22762,8909,8731,51793,5931,-18795,6795,5931,58860,57724,32998,58588,57724
42015,PA,10248,9358,10321,9258,5703,4819,8520,8572,9544.325004,8909,8964,51056,5417,-19309,6017,5417,58227,56473,31747,57073,56473
42017,PA,16968,9358,10321,9258,5703,4819,9501,11361,11430.9939,8909,9775,63263,8503,-14626,10687,8503,65928,71766,48637,73950,71766
42019,PA,11892,9358,10321,9258,5703,4819,8760,9375,10580.14322,8909,8936,54511,6445,-18281,7573,6445,60111,60956,36230,62084,60956
42021,PA,10140,9358,10321,9258,5703,4819,8505,8116,10062.23411,8909,8506,50552,5417,-19309,6017,5417,58104,55969,31243,56569,55969
42023,PA,11064,9358,10321,9258,5703,4819,8639,9358,10210.20814,8909,9258,53618,5931,-18795,6795,5931,59162,59549,34823,60413,59549
42025,PA,14628,9358,10321,9258,5703,4819,9159,9264,9433.34448,8909,9322,56375,6960,-17438,8352,6960,63246,63335,38937,64727,63335
42027,PA,14364,9358,10321,9258,5703,4819,9121,9592,11541.97442,8909,8973,58199,6960,-17438,8352,6960,62944,65159,40761,66551,65159
42029,PA,16968,9358,10321,9258,5703,4819,9501,11612,12762.76018,8909,9764,64835,8503,-14626,10687,8503,65928,73338,50209,75522,73338
42031,PA,9540,9358,10321,9258,5703,4819,8417,9358,8841.448356,8909,9258,50725,5931,-18795,6795,5931,57416,56656,31930,57520,56656
42033,PA,10236,9358,10321,9258,5703,4819,8519,8171,9692.299035,8909,8591,50419,5417,-19309,6017,5417,58214,55836,31110,56436,55836
42035,PA,11280,9358,10321,9258,5703,4819,8671,8588,10543.14971,8909,8697,52836,5931,-18795,6795,5931,59410,58767,34041,59631,58767
42037,PA,10296,9358,10321,9258,5703,4819,8527,8734,10247.20165,8909,8865,51870,5417,-19309,6017,5417,58282,57287,32561,57887,57287
42039,PA,10212,9358,10321,9258,5703,4819,8515,8346,9766.28605,8909,8671,50724,5417,-19309,6017,5417,58186,56141,31415,56741,56141
42041,PA,13080,9358,10321,9258,5703,4819,8934,9751,10987.07181,8909,9209,56755,6960,-17438,8352,6960,61473,63715,39317,65107,63715
42043,PA,13080,9358,10321,9258,5703,4819,8934,9777,10395.17568,8909,9206,56186,6960,-17438,8352,6960,61473,63146,38748,64538,63146
42045,PA,16968,9358,10321,9258,5703,4819,9501,11223,11615.96144,8909,9814,63349,8503,-14626,10687,8503,65928,71852,48723,74036,71852
42047,PA,9516,9358,10321,9258,5703,4819,8414,9358,10691.12374,8909,9258,52551,5931,-18795,6795,5931,57389,58482,33756,59346,58482
42049,PA,9984,9358,10321,9258,5703,4819,8482,8716,10284.19516,8909,8877,51589,5417,-19309,6017,5417,57925,57006,32280,57606,57006
42051,PA,11892,9358,10321,9258,5703,4819,8760,8174,9840.273066,8909,8944,52578,5931,-18795,6795,5931,60111,58509,33783,59373,58509
42053,PA,12288,9358,10321,9258,5703,4819,8818,9358,9396.350973,8909,9258,54028,6445,-18281,7573,6445,60565,60473,35747,61601,60473
42055,PA,11904,9358,10321,9258,5703,4819,8762,9231,10321.18867,8909,9181,54365,6445,-18281,7573,6445,60125,60810,36084,61938,60810
42057,PA,9564,9358,10321,9258,5703,4819,8421,9358,10432.16919,8909,9258,52340,5931,-18795,6795,5931,57444,58271,33545,59135,58271
42059,PA,9516,9358,10321,9258,5703,4819,8414,9358,9248.376942,8909,9258,51108,5931,-18795,6795,5931,57389,57039,32313,57903,57039
42061,PA,10896,9358,10321,9258,5703,4819,8615,8193,10358.18217,8909,8618,51793,5417,-19309,6017,5417,58970,57210,32484,57810,57210
42063,PA,11064,9358,10321,9258,5703,4819,8639,8520,11172.03935,8909,8744,53227,5931,-18795,6795,5931,59162,59158,34432,60022,59158
42065,PA,9516,9358,10321,9258,5703,4819,8414,9358,8656.480817,8909,9258,50516,5931,-18795,6795,5931,57389,56447,31721,57311,56447
42067,PA,10860,9358,10321,9258,5703,4819,8610,9358,11209.03285,8909,9258,54413,5931,-18795,6795,5931,58929,60344,35618,61208,60344
42069,PA,10572,9358,10321,9258,5703,4819,8568,9106,10580.14322,8909,8797,52783,5931,-18795,6795,5931,58599,58714,33988,59578,58714
42071,PA,13884,9358,10321,9258,5703,4819,9051,9881,10839.09778,8909,9409,57742,6960,-17438,8352,6960,62394,64702,40304,66094,64702
42073,PA,10656,9358,10321,9258,5703,4819,8580,8272,9840.273066,8909,8707,51204,5417,-19309,6017,5417,58695,56621,31895,57221,56621
42075,PA,10992,9358,10321,9258,5703,4819,8629,9446,10173.21464,8909,9266,53605,5931,-18795,6795,5931,59080,59536,34810,60400,59536
42077,PA,14628,9358,10321,9258,5703,4819,9159,10378,10728.11725,8909,9326,58788,7474,-16501,9130,7474,63246,66262,42287,67918,66262
42079,PA,10572,9358,10321,9258,5703,4819,8568,8931,10136.22113,8909,8801,52168,5931,-18795,6795,5931,58599,58099,33373,58963,58099
42081,PA,10404,9358,10321,9258,5703,4819,8543,8671,9988.247097,8909,8863,51654,5417,-19309,6017,5417,58406,57071,32345,57671,57071
42083,PA,9672,9358,10321,9258,5703,4819,8436,7856,10950.0783,8909,8525,50731,5417,-19309,6017,5417,57567,56148,31422,56748,56148
42085,PA,9708,9358,10321,9258,5703,4819,8442,8355,9026.415895,8909,8601,49418,5417,-19309,6017,5417,57609,54835,30109,55435,54835
42087,PA,9600,9358,10321,9258,5703,4819,8426,8288,9137.396418,8909,8616,49369,5417,-19309,6017,5417,57485,54786,30060,55386,54786
42089,PA,14508,9358,10321,9258,5703,4819,9142,9855,10284.19516,8909,9489,57864,6960,-17438,8352,6960,63109,64824,40426,66216,64824
42091,PA,16968,9358,10321,9258,5703,4819,9501,11531,11024.06531,8909,9790,63041,8503,-14626,10687,8503,65928,71544,48415,73728,71544
42093,PA,10992,9358,10321,9258,5703,4819,8629,8986,10247.20165,8909,8867,52821,5931,-18795,6795,5931,59080,58752,34026,59616,58752
42095,PA,14628,9358,10321,9258,5703,4819,9159,10327,10839.09778,8909,9323,58845,7474,-16501,9130,7474,63246,66319,42344,67975,66319
42097,PA,10020,9358,10321,9258,5703,4819,8487,8749,10617.13673,8909,8452,51566,5417,-19309,6017,5417,57966,56983,32257,57583,56983
42099,PA,13080,9358,10321,9258,5703,4819,8934,9083,10913.08479,8909,9219,56023,6445,-18281,7573,6445,61473,62468,37742,63596,62468
42101,PA,16968,9358,10321,9258,5703,4819,9501,10797,10617.13673,8909,9900,62010,7989,-15563,9909,7989,65928,69999,46447,71919,69999
42103,PA,17520,9358,10321,9258,5703,4819,9581,9310,11578.96793,8909,9940,62077,7989,-15563,9909,7989,66560,70066,46514,71986,70066
42105,PA,9924,9358,10321,9258,5703,4819,8473,9358,9729.292543,8909,9258,51997,5931,-18795,6795,5931,57856,57928,33202,58792,57928
42107,PA,10488,9358,10321,9258,5703,4819,8555,8995,9877.266574,8909,8666,51754,5931,-18795,6795,5931,58502,57685,32959,58549,57685
42109,PA,9984,9358,10321,9258,5703,4819,8482,8520,9618.312019,8909,9069,50920,5417,-19309,6017,5417,57925,56337,31611,56937,56337
42111,PA,9516,9358,10321,9258,5703,4819,8414,8308,9433.34448,8909,8747,49733,5417,-19309,6017,5417,57389,55150,30424,55750,55150
42113,PA,10560,9358,10321,9258,5703,4819,8566,9358,10321.18867,8909,9258,53225,5931,-18795,6795,5931,58585,59156,34430,60020,59156
42115,PA,10644,9358,10321,9258,5703,4819,8578,9358,12281.84458,8909,9258,55270,5931,-18795,6795,5931,58681,61201,36475,62065,61201
42117,PA,9672,9358,10321,9258,5703,4819,8436,9358,10617.13673,8909,9258,52633,5931,-18795,6795,5931,57567,58564,33838,59428,58564
42119,PA,11400,9358,10321,9258,5703,4819,8689,8854,11430.9939,8909,8542,53954,5931,-18795,6795,5931,59548,59885,35159,60749,59885
42121,PA,9600,9358,10321,9258,5703,4819,8426,7916,9211.383434,8909,8654,49109,5417,-19309,6017,5417,57485,54526,29800,55126,54526
42123,PA,9600,9358,10321,9258,5703,4819,8426,8127,8730.467833,8909,8730,48916,5417,-19309,6017,5417,57485,54333,29607,54933,54333
42125,PA,11892,9358,10321,9258,5703,4819,8760,8819,11061.05882,8909,8930,54430,5931,-18795,6795,5931,60111,60361,35635,61225,60361
42127,PA,12540,9358,10321,9258,5703,4819,8855,9358,11209.03285,8909,9258,56093,6445,-18281,7573,6445,60854,62538,37812,63666,62538
42129,PA,11892,9358,10321,9258,5703,4819,8760,8652,10358.18217,8909,8935,53565,5931,-18795,6795,5931,60111,59496,34770,60360,59496
42131,PA,10572,9358,10321,9258,5703,4819,8568,8738,10765.11076,8909,8849,52653,5931,-18795,6795,5931,58599,58584,33858,59448,58584
42133,PA,12960,9358,10321,9258,5703,4819,8916,9778,10765.11076,8909,9437,56668,6960,-17438,8352,6960,61335,63628,39230,65020,63628
44001,RI,13644,8028,10321,9258,5936,4819,9792,9683,14612.43557,8561,9258,60577,6453,-17945,7845,6453,61798,67030,42632,68422,67030
44003,RI,13644,8028,10321,9258,5936,4819,9792,8279,10913.08479,8561,9258,55474,5925,-18801,7053,5925,61798,61399,36673,62527,61399
44005,RI,17959,8028,10321,9258,5936,4819,10451,9150,11504.98092,8561,9258,61252,7509,-16043,9429,7509,66772,68761,45209,70681,68761
44007,RI,13644,8028,10321,9258,5936,4819,9792,8582,10358.18217,8561,9258,55222,5925,-18801,7053,5925,61798,61147,36421,62275,61147
44009,RI,13859,8028,10321,9258,5936,4819,9825,8726,13095.70175,8561,9259,58319,5925,-18801,7053,5925,62046,64244,39518,65372,64244
45001,SC,10332,15085,8887,11553,6178,5178,7753,14159,8727.894309,9988,10281,58665,7609,-16366,9265,7609,64966,66274,42299,67930,66274
45003,SC,11916,15085,8887,11553,6178,5178,7998,15483,8536.772536,9988,11256,62358,8795,-14334,10979,8795,66795,71153,48024,73337,71153
45005,SC,9492,15085,8887,11553,6178,5178,7622,15085,8504.918907,9988,11553,59801,8202,-15350,10122,8202,63995,68003,44451,69923,68003
45007,SC,10716,15085,8887,11553,6178,5178,7812,14611,8313.797134,9988,11163,59970,8202,-15350,10122,8202,65409,68172,44620,70092,68172
45009,SC,9480,15085,8887,11553,6178,5178,7620,15085,8632.333423,9988,11553,59916,8202,-15350,10122,8202,63981,68118,44566,70038,68118
45011,SC,10728,15085,8887,11553,6178,5178,7814,15085,8504.918907,9988,11553,61037,8202,-15350,10122,8202,65423,69239,45687,71159,69239
45013,SC,13440,15085,8887,11553,6178,5178,8235,19007,9970.185835,9988,11326,68910,9981,-12301,12693,9981,68556,78891,56609,81603,78891
45015,SC,13920,15085,8887,11553,6178,5178,8309,17102,9046.430598,9988,11523,66758,9981,-12301,12693,9981,69110,76739,54457,79451,76739
45017,SC,12552,15085,8887,11553,6178,5178,8097,15620,8504.918907,9988,11373,63216,8795,-14334,10979,8795,67530,72011,48882,74195,72011
45019,SC,13920,15085,8887,11553,6178,5178,8309,19448,9428.674144,9988,11522,69485,10574,-11285,13550,10574,69110,80059,58200,83035,80059
45021,SC,10296,15085,8887,11553,6178,5178,7747,15764,7517.456412,9988,10268,59012,8202,-15350,10122,8202,64924,67214,43662,69134,67214
45023,SC,9924,15085,8887,11553,6178,5178,7689,13853,8791.601567,9988,11532,59266,7609,-16366,9265,7609,64494,66875,42900,68531,66875
45025,SC,10032,15085,8887,11553,6178,5178,7706,15085,8473.065278,9988,11553,60309,8202,-15350,10122,8202,64619,68511,44959,70431,68511
45027,SC,9480,15085,8887,11553,6178,5178,7620,15085,8441.211649,9988,11553,59725,8202,-15350,10122,8202,63981,67927,44375,69847,67927
45029,SC,10872,15085,8887,11553,6178,5178,7836,15085,8855.308825,9988,11553,61531,8202,-15350,10122,8202,65589,69733,46181,71653,69733
45031,SC,9816,15085,8887,11553,6178,5178,7673,15199,8664.187051,9988,10957,59801,8202,-15350,10122,8202,64370,68003,44451,69923,68003
45033,SC,10860,15085,8887,11553,6178,5178,7835,15085,8536.772536,9988,11553,61201,8202,-15350,10122,8202,65576,69403,45851,71323,69403
45035,SC,13920,15085,8887,11553,6178,5178,8309,16916,8919.016082,9988,11522,66443,9981,-12301,12693,9981,69110,76424,54142,79136,76424
45037,SC,11916,15085,8887,11553,6178,5178,7998,15622,8982.72334,9988,11270,62956,8795,-14334,10979,8795,66795,71751,48622,73935,71751
45039,SC,12552,15085,8887,11553,6178,5178,8097,14708,8377.504392,9988,11368,62171,8795,-14334,10979,8795,67530,70966,47837,73150,70966
45041,SC,9720,15085,8887,11553,6178,5178,7658,15444,8345.650763,9988,10936,59612,8202,-15350,10122,8202,64259,67814,44262,69734,67814
45043,SC,11496,15085,8887,11553,6178,5178,7933,18128,9301.259629,9988,10713,64804,9388,-13317,11836,9388,66310,74192,51487,76640,74192
45045,SC,11700,15085,8887,11553,6178,5178,7965,15778,8473.065278,9988,11149,62266,8795,-14334,10979,8795,66546,71061,47932,73245,71061
45047,SC,10044,15085,8887,11553,6178,5178,7708,14664,8090.821732,9988,10212,58176,7609,-16366,9265,7609,64633,65785,41810,67441,65785
45049,SC,9576,15085,8887,11553,6178,5178,7635,15085,8250.089876,9988,11553,59630,8202,-15350,10122,8202,64092,67832,44280,69752,67832
45051,SC,12036,15085,8887,11553,6178,5178,8017,18793,9078.284227,9988,10818,65892,9388,-13317,11836,9388,66934,75280,52575,77728,75280
45053,SC,11772,15085,8887,11553,6178,5178,7976,16497,9396.820515,9988,11345,64178,8795,-14334,10979,8795,66629,72973,49844,75157,72973
45055,SC,10272,15085,8887,11553,6178,5178,7743,15423,8855.308825,9988,11364,61080,8202,-15350,10122,8202,64896,69282,45730,71202,69282
45057,SC,10716,15085,8887,11553,6178,5178,7812,13790,8345.650763,9988,11531,59549,8202,-15350,10122,8202,65409,67751,44199,69671,67751
45059,SC,9792,15085,8887,11553,6178,5178,7669,15503,7485.602783,9988,11147,59093,8202,-15350,10122,8202,64342,67295,43743,69215,67295
45061,SC,11208,15085,8887,11553,6178,5178,7889,15085,8345.650763,9988,11553,61358,8202,-15350,10122,8202,65978,69560,46008,71480,69560
45063,SC,12552,15085,8887,11553,6178,5178,8097,15985,8504.918907,9988,11362,63570,8795,-14334,10979,8795,67530,72365,49236,74549,72365
45065,SC,11208,15085,8887,11553,6178,5178,7889,15085,8536.772536,9988,11553,61549,8202,-15350,10122,8202,65978,69751,46199,71671,69751
45067,SC,9564,15085,8887,11553,6178,5178,7633,15085,8250.089876,9988,11553,59618,8202,-15350,10122,8202,64078,67820,44268,69740,67820
45069,SC,9480,15085,8887,11553,6178,5178,7620,13934,8218.236247,9988,9899,56697,7016,-17382,8408,7016,63981,63713,39315,65105,63713
45071,SC,10896,15085,8887,11553,6178,5178,7840,14896,8313.797134,9988,11030,60302,8202,-15350,10122,8202,65617,68504,44952,70424,68504
45073,SC,9480,15085,8887,11553,6178,5178,7620,15118,7995.260845,9988,10684,58444,7609,-16366,9265,7609,63981,66053,42078,67709,66053
45075,SC,10068,15085,8887,11553,6178,5178,7712,16125,8600.479794,9988,10180,60140,8202,-15350,10122,8202,64661,68342,44790,70262,68342
45077,SC,11700,15085,8887,11553,6178,5178,7965,15531,9014.576969,9988,11155,62566,8795,-14334,10979,8795,66546,71361,48232,73545,71361
45079,SC,12552,15085,8887,11553,6178,5178,8097,16212,8536.772536,9988,11358,63825,9388,-13317,11836,9388,67530,73213,50508,75661,73213
45081,SC,12552,15085,8887,11553,6178,5178,8097,15151,8504.918907,9988,11370,62744,8795,-14334,10979,8795,67530,71539,48410,73723,71539
45083,SC,10872,15085,8887,11553,6178,5178,7836,14459,8281.943505,9988,11047,59827,8202,-15350,10122,8202,65589,68029,44477,69949,68029
45085,SC,11496,15085,8887,11553,6178,5178,7933,15371,8218.236247,9988,11041,61292,8202,-15350,10122,8202,66310,69494,45942,71414,69494
45087,SC,10164,15085,8887,11553,6178,5178,7727,13693,8664.187051,9988,11030,58717,7609,-16366,9265,7609,64772,66326,42351,67982,66326
45089,SC,9768,15085,8887,11553,6178,5178,7665,15085,8409.358021,9988,11553,59981,8202,-15350,10122,8202,64314,68183,44631,70103,68183
45091,SC,13152,15085,8887,11553,6178,5178,8190,16036,9110.137856,9988,11533,64997,9388,-13317,11836,9388,68223,74385,51680,76833,74385
46003,SD,10620,20250,9078,11236,6611,4891,6332,20250,9240.857091,10056,11236,66294,7505,-14777,10217,7505,69018,73799,51517,76511,73799
46005,SD,9576,20250,9078,11236,6611,4891,6212,19376,9468.624695,10056,10727,64094,6599,-16530,8783,6599,67854,70693,47564,72877,70693
46007,SD,10500,20250,9078,11236,6611,4891,6318,20250,9436.086466,10056,11236,66369,7505,-14777,10217,7505,68884,73874,51592,76586,73874
46009,SD,9996,20250,9078,11236,6611,4891,6260,20250,9566.239383,10056,11236,65995,7052,-15653,9500,7052,68322,73047,50342,75495,73047
46011,SD,11040,20250,9078,11236,6611,4891,6380,23136,9924.159904,10056,11103,70151,7958,-13901,10934,7958,69486,78109,56250,81085,78109
46013,SD,9516,20250,9078,11236,6611,4891,6205,21582,9598.777612,10056,11065,66709,7505,-14777,10217,7505,67787,74214,51932,76926,74214
46015,SD,9840,20250,9078,11236,6611,4891,6242,20250,9273.39532,10056,11236,65546,7052,-15653,9500,7052,68148,72598,49893,75046,72598
46017,SD,10344,20250,9078,11236,6611,4891,6300,20250,9403.548237,10056,11236,66181,7052,-15653,9500,7052,68710,73233,50528,75681,73233
46019,SD,10500,20250,9078,11236,6611,4891,6318,20250,9761.468758,10056,11236,66694,7505,-14777,10217,7505,68884,74199,51917,76911,74199
46021,SD,9840,20250,9078,11236,6611,4891,6242,20250,8817.860111,10056,11236,65091,7052,-15653,9500,7052,68148,72143,49438,74591,72143
46023,SD,9252,20250,9078,11236,6611,4891,6174,20250,9240.857091,10056,11236,64926,7052,-15653,9500,7052,67492,71978,49273,74426,71978
46025,SD,8880,20250,9078,11236,6611,4891,6131,20250,9501.162924,10056,11236,64814,7052,-15653,9500,7052,67077,71866,49161,74314,71866
46027,SD,11496,20250,9078,11236,6611,4891,6433,23578,9045.627716,10056,10112,69179,7958,-13901,10934,7958,69995,77137,55278,80113,77137
46029,SD,9216,20250,9078,11236,6611,4891,6170,21833,9371.010008,10056,11010,66377,7505,-14777,10217,7505,67452,73882,51600,76594,73882
46031,SD,10152,20250,9078,11236,6611,4891,6278,20250,8817.860111,10056,11236,65403,7052,-15653,9500,7052,68496,72455,49750,74903,72455
46033,SD,10536,20250,9078,11236,6611,4891,6322,22260,9728.930529,10056,11122,68593,7505,-14777,10217,7505,68924,76098,53816,78810,76098
46035,SD,10140,20250,9078,11236,6611,4891,6277,20703,9175.780633,10056,10908,65874,7052,-15653,9500,7052,68483,72926,50221,75374,72926
46037,SD,10500,20250,9078,11236,6611,4891,6318,20250,9403.548237,10056,11236,66337,7505,-14777,10217,7505,68884,73842,51560,76554,73842
46039,SD,10308,20250,9078,11236,6611,4891,6296,20250,9598.777612,10056,11236,66340,7052,-15653,9500,7052,68670,73392,50687,75840,73392
46041,SD,9912,20250,9078,11236,6611,4891,6250,20250,9468.624695,10056,11236,65814,7052,-15653,9500,7052,68228,72866,50161,75314,72866
46043,SD,8880,20250,9078,11236,6611,4891,6131,20250,9338.471779,10056,11236,64651,7052,-15653,9500,7052,67077,71703,48998,74151,71703
46045,SD,11604,20250,9078,11236,6611,4891,6445,18796,9533.701154,10056,11096,65977,7052,-15653,9500,7052,70115,73029,50324,75477,73029
46047,SD,12192,20250,9078,11236,6611,4891,6513,20250,9598.777612,10056,11236,68224,7505,-14777,10217,7505,70771,75729,53447,78441,75729
46049,SD,9840,20250,9078,11236,6611,4891,6242,20250,9371.010008,10056,11236,65644,7052,-15653,9500,7052,68148,72696,49991,75144,72696
46051,SD,9864,20250,9078,11236,6611,4891,6245,20250,9566.239383,10056,11236,65863,7052,-15653,9500,7052,68175,72915,50210,75363,72915
46053,SD,10500,20250,9078,11236,6611,4891,6318,20250,8850.398341,10056,11236,65783,7505,-14777,10217,7505,68884,73288,51006,76000,73288
46055,SD,10500,20250,9078,11236,6611,4891,6318,20250,9566.239383,10056,11236,66499,7505,-14777,10217,7505,68884,74004,51722,76716,74004
46057,SD,10500,20250,9078,11236,6611,4891,6318,20250,9598.777612,10056,11236,66532,7505,-14777,10217,7505,68884,74037,51755,76749,74037
46059,SD,10392,20250,9078,11236,6611,4891,6306,20250,9371.010008,10056,11236,66196,7052,-15653,9500,7052,68764,73248,50543,75696,73248
46061,SD,8964,20250,9078,11236,6611,4891,6141,18888,9273.39532,10056,10962,63034,6599,-16530,8783,6599,67171,69633,46504,71817,69633
46063,SD,9840,20250,9078,11236,6611,4891,6242,20250,10249.5422,10056,11236,66523,7052,-15653,9500,7052,68148,73575,50870,76023,73575
46065,SD,11316,20250,9078,11236,6611,4891,6412,23628,9305.933549,10056,11371,70567,8411,-13025,11651,8411,69794,78978,57542,82218,78978
46067,SD,9528,20250,9078,11236,6611,4891,6206,20250,9208.318862,10056,11236,65169,7052,-15653,9500,7052,67800,72221,49516,74669,72221
46069,SD,10500,20250,9078,11236,6611,4891,6318,20250,9403.548237,10056,11236,66337,7505,-14777,10217,7505,68884,73842,51560,76554,73842
46071,SD,10500,20250,9078,11236,6611,4891,6318,20250,9598.777612,10056,11236,66532,7505,-14777,10217,7505,68884,74037,51755,76749,74037
46073,SD,10500,20250,9078,11236,6611,4891,6318,20250,9240.857091,10056,11236,66174,7505,-14777,10217,7505,68884,73679,51397,76391,73679
46075,SD,10500,20250,9078,11236,6611,4891,6318,20250,9371.010008,10056,11236,66304,7505,-14777,10217,7505,68884,73809,51527,76521,73809
46077,SD,10500,20250,9078,11236,6611,4891,6318,20250,9468.624695,10056,11236,66402,7505,-14777,10217,7505,68884,73907,51625,76619,73907
46079,SD,10500,20250,9078,11236,6611,4891,6318,20250,9208.318862,10056,11236,66141,7505,-14777,10217,7505,68884,73646,51364,76358,73646
46081,SD,10392,20250,9078,11236,6611,4891,6306,23296,10705.0774,10056,10515,69855,7958,-13901,10934,7958,68764,77813,55954,80789,77813
46083,SD,12828,20250,9078,11236,6611,4891,6586,26005,10965.38324,10056,11572,76317,9317,-11272,13085,9317,71480,85634,65045,89402,85634
46085,SD,10500,20250,9078,11236,6611,4891,6318,20250,9371.010008,10056,11236,66304,7505,-14777,10217,7505,68884,73809,51527,76521,73809
46087,SD,12828,20250,9078,11236,6611,4891,6586,18480,9240.857091,10056,11542,67037,7505,-14777,10217,7505,71480,74542,52260,77254,74542
46089,SD,9840,20250,9078,11236,6611,4891,6242,20250,9696.3923,10056,11236,65969,7052,-15653,9500,7052,68148,73021,50316,75469,73021
46091,SD,10500,20250,9078,11236,6611,4891,6318,20250,9566.239383,10056,11236,66499,7505,-14777,10217,7505,68884,74004,51722,76716,74004
46093,SD,11076,20250,9078,11236,6611,4891,6384,24015,8134.557298,10056,11112,69285,8411,-13025,11651,8411,69526,77696,56260,80936,77696
46095,SD,10500,20250,9078,11236,6611,4891,6318,20250,9728.930529,10056,11236,66662,7505,-14777,10217,7505,68884,74167,51885,76879,74167
46097,SD,9840,20250,9078,11236,6611,4891,6242,20250,9501.162924,10056,11236,65774,7052,-15653,9500,7052,68148,72826,50121,75274,72826
46099,SD,12828,20250,9078,11236,6611,4891,6586,23121,9143.242403,10056,11605,71645,8411,-13025,11651,8411,71480,80056,58620,83296,80056
46101,SD,10476,20250,9078,11236,6611,4891,6315,20250,9208.318862,10056,11236,66117,7052,-15653,9500,7052,68857,73169,50464,75617,73169
46103,SD,12576,20250,9078,11236,6611,4891,6557,24377,9631.315841,10056,11100,72631,8864,-12149,12368,8864,71199,81495,60482,84999,81495
46105,SD,9564,20250,9078,11236,6611,4891,6210,20250,9403.548237,10056,11236,65401,7052,-15653,9500,7052,67840,72453,49748,74901,72453
46107,SD,8880,20250,9078,11236,6611,4891,6131,20250,9371.010008,10056,11236,64684,7052,-15653,9500,7052,67077,71736,49031,74184,71736
46109,SD,9948,20250,9078,11236,6611,4891,6254,20250,9371.010008,10056,11236,65752,7052,-15653,9500,7052,68268,72804,50099,75252,72804
46111,SD,10500,20250,9078,11236,6611,4891,6318,20250,9240.857091,10056,11236,66174,7505,-14777,10217,7505,68884,73679,51397,76391,73679
46113,SD,9480,20250,9078,11236,6611,4891,6201,20250,9598.777612,10056,11236,65512,7052,-15653,9500,7052,67747,72564,49859,75012,72564
46115,SD,10500,20250,9078,11236,6611,4891,6318,20250,9338.471779,10056,11236,66271,7505,-14777,10217,7505,68884,73776,51494,76488,73776
46117,SD,12468,20250,9078,11236,6611,4891,6545,23902,9468.624695,10056,11360,72146,8411,-13025,11651,8411,71079,80557,59121,83797,80557
46119,SD,10188,20250,9078,11236,6611,4891,6282,21102,9371.010008,10056,11349,66957,7505,-14777,10217,7505,68536,74462,52180,77174,74462
46121,SD,8880,20250,9078,11236,6611,4891,6131,20250,9208.318862,10056,11236,64521,7052,-15653,9500,7052,67077,71573,48868,74021,71573
46123,SD,9660,20250,9078,11236,6611,4891,6221,20250,9305.933549,10056,11236,65399,7052,-15653,9500,7052,67947,72451,49746,74899,72451
46125,SD,12828,20250,9078,11236,6611,4891,6586,19185,9208.318862,10056,11543,67711,7505,-14777,10217,7505,71480,75216,52934,77928,75216
46127,SD,10968,20250,9078,11236,6611,4891,6372,22528,9013.089487,10056,11294,68750,7958,-13901,10934,7958,69406,76708,54849,79684,76708
46129,SD,10500,20250,9078,11236,6611,4891,6318,20250,9403.548237,10056,11236,66337,7505,-14777,10217,7505,68884,73842,51560,76554,73842
46135,SD,9948,20250,9078,11236,6611,4891,6254,21870,9305.933549,10056,11003,67074,7505,-14777,10217,7505,68268,74579,52297,77291,74579
46137,SD,10416,20250,9078,11236,6611,4891,6308,20250,9566.239383,10056,11236,66415,7052,-15653,9500,7052,68790,73467,50762,75915,73467
47001,TN,12408,6239,8887,11553,6054,5178,9327,6102,9874.624948,9028,10949,53539,7380,-17346,8244,7380,59646,60919,36193,61783,60919
47003,TN,10416,6239,8887,11553,6054,5178,8978,5806,9110.137856,9028,11163,50701,6807,-17919,7407,6807,57305,57508,32782,58108,57508
47005,TN,9960,6239,8887,11553,6054,5178,8898,6239,9173.845113,9028,11553,51132,6807,-17919,7407,6807,56769,57939,33213,58539,57939
47007,TN,8412,6239,8887,11553,6054,5178,8627,6239,9333.113258,9028,11553,49743,6520,-18206,6988,6520,54950,56263,31537,56731,56263
47009,TN,12408,6239,8887,11553,6054,5178,9327,6098,9842.771319,9028,10949,53503,7380,-17346,8244,7380,59646,60883,36157,61747,60883
47011,TN,10020,6239,8887,11553,6054,5178,8908,5984,8982.72334,9028,10902,50095,6520,-18206,6988,6520,56839,56615,31889,57083,56615
47013,TN,8868,6239,8887,11553,6054,5178,8706,5633,9269.406,9028,10965,48941,6234,-18492,6570,6234,55485,55175,30449,55511,55175
47015,TN,13572,6239,8887,11553,6054,5178,9531,5694,8919.016082,9028,11568,53959,7380,-17346,8244,7380,61014,61339,36613,62203,61339
47017,TN,8412,6239,8887,11553,6054,5178,8627,6239,9110.137856,9028,11553,49520,6520,-18206,6988,6520,54950,56040,31314,56508,56040
47019,TN,10596,6239,8887,11553,6054,5178,9009,5887,9460.527773,9028,10248,50397,6520,-18206,6988,6520,57516,56917,32191,57385,56917
47021,TN,13572,6239,8887,11553,6054,5178,9531,5892,9396.820515,9028,11568,54635,7953,-16773,9081,7953,61014,62588,37862,63716,62588
47023,TN,10956,6239,8887,11553,6054,5178,9072,5731,9078.284227,9028,11059,51030,6807,-17919,7407,6807,57939,57837,33111,58437,57837
47025,TN,8412,6239,8887,11553,6054,5178,8627,6239,8727.894309,9028,11553,49138,6520,-18206,6988,6520,54950,55658,30932,56126,55658
47027,TN,9960,6239,8887,11553,6054,5178,8898,6239,8791.601567,9028,11553,50750,6807,-17919,7407,6807,56769,57557,32831,58157,57557
47029,TN,9768,6239,8887,11553,6054,5178,8864,6223,9078.284227,9028,9745,49021,6234,-18492,6570,6234,56543,55255,30529,55591,55255
47031,TN,10128,6239,8887,11553,6054,5178,8927,6002,9364.966886,9028,10726,50427,6520,-18206,6988,6520,56966,56947,32221,57415,56947
47033,TN,8820,6239,8887,11553,6054,5178,8698,5192,9078.284227,9028,11065,48362,6234,-18492,6570,6234,55429,54596,29870,54932,54596
47035,TN,8832,6239,8887,11553,6054,5178,8700,5813,9587.942289,9028,9938,48377,1232,-23494,1573,1232,55443,49609,24883,49950,49609
47037,TN,13572,6239,8887,11553,6054,5178,9531,7482,9269.406,9028,11573,56103,7953,-16773,9081,7953,61014,64056,39330,65184,64056
47039,TN,8796,6239,8887,11553,6054,5178,8694,6239,9173.845113,9028,11553,49968,6520,-18206,6988,6520,55401,56488,31762,56956,56488
47041,TN,9864,6239,8887,11553,6054,5178,8881,6239,8759.747938,9028,11553,50622,6807,-17919,7407,6807,56656,57429,32703,58029,57429
47043,TN,13572,6239,8887,11553,6054,5178,9531,6009,8409.358021,9028,11569,53765,7953,-16773,9081,7953,61014,61718,36992,62846,61718
47045,TN,9336,6239,8887,11553,6054,5178,8788,5448,9046.430598,9028,10485,48521,6234,-18492,6570,6234,56035,54755,30029,55091,54755
47047,TN,12792,6239,8887,11553,6054,5178,9394,5976,9587.942289,9028,11454,54016,7380,-17346,8244,7380,60097,61396,36670,62260,61396
47049,TN,8604,6239,8887,11553,6054,5178,8660,6239,8950.869711,9028,11553,49553,6520,-18206,6988,6520,55175,56073,31347,56541,56073
47051,TN,9348,6239,8887,11553,6054,5178,8791,5438,9205.698742,9028,10762,48960,6234,-18492,6570,6234,56050,55194,30468,55530,55194
47053,TN,9252,6239,8887,11553,6054,5178,8774,6239,9301.259629,9028,11553,50551,6807,-17919,7407,6807,55937,57358,32632,57958,57358
47055,TN,10656,6239,8887,11553,6054,5178,9020,6239,9141.991484,9028,11553,51796,6807,-17919,7407,6807,57587,58603,33877,59203,58603
47057,TN,10248,6239,8887,11553,6054,5178,8948,6060,9938.332206,9028,10979,51431,6807,-17919,7407,6807,57107,58238,33512,58838,58238
47059,TN,9312,6239,8887,11553,6054,5178,8784,5967,9110.137856,9028,10019,48615,6234,-18492,6570,6234,56007,54849,30123,55185,54849
47061,TN,9960,6239,8887,11553,6054,5178,8898,6239,9364.966886,9028,11553,51323,6807,-17919,7407,6807,56769,58130,33404,58730,58130
47063,TN,10248,6239,8887,11553,6054,5178,8948,5761,9046.430598,9028,10482,49743,6520,-18206,6988,6520,57107,56263,31537,56731,56263
47065,TN,11076,6239,8887,11553,6054,5178,9093,6303,9492.381402,9028,11116,52194,6807,-17919,7407,6807,58080,59001,34275,59601,59001
47067,TN,9276,6239,8887,11553,6054,5178,8778,6239,9046.430598,9028,11553,50320,6807,-17919,7407,6807,55965,57127,32401,57727,57127
47069,TN,8496,6239,8887,11553,6054,5178,8641,6239,9141.991484,9028,11553,49636,6520,-18206,6988,6520,55048,56156,31430,56624,56156
47071,TN,8460,6239,8887,11553,6054,5178,8635,6239,9046.430598,9028,11553,49504,6520,-18206,6988,6520,55006,56024,31298,56492,56024
47073,TN,9684,6239,8887,11553,6054,5178,8849,5921,9110.137856,9028,10281,49203,6234,-18492,6570,6234,56444,55437,30711,55773,55437
47075,TN,9540,6239,8887,11553,6054,5178,8824,6239,9141.991484,9028,11553,50680,6807,-17919,7407,6807,56275,57487,32761,58087,57487
47077,TN,8448,6239,8887,11553,6054,5178,8633,6239,9269.406,9028,11553,49715,6520,-18206,6988,6520,54992,56235,31509,56703,56235
47079,TN,8652,6239,8887,11553,6054,5178,8669,5946,8982.72334,9028,10076,47863,1232,-23494,1573,1232,55232,49095,24369,49436,49095
47081,TN,11172,6239,8887,11553,6054,5178,9110,6081,9715.356804,9028,11568,52742,6807,-17919,7407,6807,58193,59549,34823,60149,59549
47083,TN,8520,6239,8887,11553,6054,5178,8645,6239,8919.016082,9028,11553,49437,6520,-18206,6988,6520,55076,55957,31231,56425,55957
47085,TN,8844,6239,8887,11553,6054,5178,8702,6239,8727.894309,9028,11553,49570,6520,-18206,6988,6520,55457,56090,31364,56558,56090
47087,TN,9960,6239,8887,11553,6054,5178,8898,5817,8855.308825,9028,10152,48990,6520,-18206,6988,6520,56769,55510,30784,55978,55510
47089,TN,10248,6239,8887,11553,6054,5178,8948,6250,9556.08866,9028,10510,50770,6807,-17919,7407,6807,57107,57577,32851,58177,57577
47091,TN,8412,6239,8887,11553,6054,5178,8627,6239,9524.235031,9028,11553,49934,6520,-18206,6988,6520,54950,56454,31728,56922,56454
47093,TN,12408,6239,8887,11553,6054,5178,9327,6544,9428.674144,9028,10948,53535,7380,-17346,8244,7380,59646,60915,36189,61779,60915
47095,TN,9960,6239,8887,11553,6054,5178,8898,6239,8281.943505,9028,11553,50240,6807,-17919,7407,6807,56769,57047,32321,57647,57047
47097,TN,9576,6239,8887,11553,6054,5178,8830,6239,8855.308825,9028,11553,50429,6807,-17919,7407,6807,56317,57236,32510,57836,57236
47099,TN,8412,6239,8887,11553,6054,5178,8627,5598,8791.601567,9028,10502,47509,1232,-23494,1573,1232,54950,48741,24015,49082,48741
47101,TN,9960,6239,8887,11553,6054,5178,8898,6239,8887.162454,9028,11553,50845,6807,-17919,7407,6807,56769,57652,32926,58252,57652
47103,TN,8412,6239,8887,11553,6054,5178,8627,6239,9269.406,9028,11553,49679,6520,-18206,6988,6520,54950,56199,31473,56667,56199
47105,TN,12408,6239,8887,11553,6054,5178,9327,6069,9651.649546,9028,10965,53299,7380,-17346,8244,7380,59646,60679,35953,61543,60679
47107,TN,9240,6239,8887,11553,6054,5178,8772,5958,9428.674144,9028,10441,49274,6234,-18492,6570,6234,55923,55508,30782,55844,55508
47109,TN,8412,6239,8887,11553,6054,5178,8627,6239,8887.162454,9028,11553,49297,6520,-18206,6988,6520,54950,55817,31091,56285,55817
47111,TN,8412,6239,8887,11553,6054,5178,8627,5831,9110.137856,9028,11568,49127,6234,-18492,6570,6234,54950,55361,30635,55697,55361
47113,TN,10956,6239,8887,11553,6054,5178,9072,5834,9046.430598,9028,11016,51058,6807,-17919,7407,6807,57939,57865,33139,58465,57865
47115,TN,11076,6239,8887,11553,6054,5178,9093,5754,9301.259629,9028,11141,51478,6807,-17919,7407,6807,58080,58285,33559,58885,58285
47117,TN,9948,6239,8887,11553,6054,5178,8896,5592,8950.869711,9028,11170,49866,6520,-18206,6988,6520,56755,56386,31660,56854,56386
47119,TN,9960,6239,8887,11553,6054,5178,8898,5959,8919.016082,9028,11569,50613,6807,-17919,7407,6807,56769,57420,32694,58020,57420
47121,TN,9960,6239,8887,11553,6054,5178,8898,6239,9364.966886,9028,11553,51323,6807,-17919,7407,6807,56769,58130,33404,58730,58130
47123,TN,9036,6239,8887,11553,6054,5178,8736,6239,9587.942289,9028,11553,50622,6520,-18206,6988,6520,55683,57142,32416,57610,57142
47125,TN,12192,6239,8887,11553,6054,5178,9289,6127,9014.576969,9028,11382,52921,7380,-17346,8244,7380,59392,60301,35575,61165,60301
47127,TN,9660,6239,8887,11553,6054,5178,8845,5252,9205.698742,9028,10797,49121,6234,-18492,6570,6234,56416,55355,30629,55691,55355
47129,TN,8412,6239,8887,11553,6054,5178,8627,6044,9906.478577,9028,10998,49567,6234,-18492,6570,6234,54950,55801,31075,56137,55801
47131,TN,8424,6239,8887,11553,6054,5178,8629,5556,9078.284227,9028,10272,47536,1232,-23494,1573,1232,54964,48768,24042,49109,48768
47133,TN,9960,6239,8887,11553,6054,5178,8898,5711,9970.185835,9028,10130,49977,6234,-18492,6570,6234,56769,56211,31485,56547,56211
47135,TN,8412,6239,8887,11553,6054,5178,8627,6239,9269.406,9028,11553,49679,6520,-18206,6988,6520,54950,56199,31473,56667,56199
47137,TN,8412,6239,8887,11553,6054,5178,8627,6239,8791.601567,9028,11553,49202,6520,-18206,6988,6520,54950,55722,30996,56190,55722
47139,TN,10020,6239,8887,11553,6054,5178,8908,5754,9046.430598,9028,10962,49988,6520,-18206,6988,6520,56839,56508,31782,56976,56508
47141,TN,10260,6239,8887,11553,6054,5178,8950,6058,8696.04068,9028,10023,49243,6520,-18206,6988,6520,57121,55763,31037,56231,55763
47143,TN,9036,6239,8887,11553,6054,5178,8736,6137,9492.381402,9028,10312,49182,6234,-18492,6570,6234,55683,55416,30690,55752,55416
47145,TN,9948,6239,8887,11553,6054,5178,8896,5988,9460.527773,9028,10960,50562,6520,-18206,6988,6520,56755,57082,32356,57550,57082
47147,TN,13572,6239,8887,11553,6054,5178,9531,5763,8600.479794,9028,11569,53710,7380,-17346,8244,7380,61014,61090,36364,61954,61090
47149,TN,13572,6239,8887,11553,6054,5178,9531,6376,9046.430598,9028,11570,54771,7953,-16773,9081,7953,61014,62724,37998,63852,62724
47151,TN,9492,6239,8887,11553,6054,5178,8816,6239,9333.113258,9028,11553,50823,6807,-17919,7407,6807,56219,57630,32904,58230,57630
47153,TN,11076,6239,8887,11553,6054,5178,9093,5971,9205.698742,9028,11137,51596,6807,-17919,7407,6807,58080,58403,33677,59003,58403
47155,TN,10800,6239,8887,11553,6054,5178,9045,6325,9906.478577,9028,11136,52373,6807,-17919,7407,6807,57756,59180,34454,59780,59180
47157,TN,12792,6239,8887,11553,6054,5178,9394,6628,8887.162454,9028,11458,53971,7380,-17346,8244,7380,60097,61351,36625,62215,61351
47159,TN,9324,6239,8887,11553,6054,5178,8786,5931,8727.894309,9028,11568,49757,6520,-18206,6988,6520,56021,56277,31551,56745,56277
47161,TN,9276,6239,8887,11553,6054,5178,8778,6239,8950.869711,9028,11553,50225,6807,-17919,7407,6807,55965,57032,32306,57632,57032
47163,TN,9684,6239,8887,11553,6054,5178,8849,5904,9683.503175,9028,10270,49747,6234,-18492,6570,6234,56444,55981,31255,56317,55981
47165,TN,13572,6239,8887,11553,6054,5178,9531,6295,8727.894309,9028,11570,54371,7953,-16773,9081,7953,61014,62324,37598,63452,62324
47167,TN,12792,6239,8887,11553,6054,5178,9394,5871,9237.552371,9028,11452,53558,7380,-17346,8244,7380,60097,60938,36212,61802,60938
47169,TN,13572,6239,8887,11553,6054,5178,9531,5946,8696.04068,9028,11568,53989,7953,-16773,9081,7953,61014,61942,37216,63070,61942
47171,TN,10596,6239,8887,11553,6054,5178,9009,5523,9333.113258,9028,10254,49912,6520,-18206,6988,6520,57516,56432,31706,56900,56432
47173,TN,12408,6239,8887,11553,6054,5178,9327,6196,9460.527773,9028,10976,53247,7380,-17346,8244,7380,59646,60627,35901,61491,60627
47175,TN,8412,6239,8887,11553,6054,5178,8627,6239,9046.430598,9028,11553,49456,6520,-18206,6988,6520,54950,55976,31250,56444,55976
47177,TN,9744,6239,8887,11553,6054,5178,8860,5561,9014.576969,9028,10279,48805,6234,-18492,6570,6234,56515,55039,30313,55375,55039
47179,TN,10596,6239,8887,11553,6054,5178,9009,6419,9364.966886,9028,10233,50819,6807,-17919,7407,6807,57516,57626,32900,58226,57626
47181,TN,9852,6239,8887,11553,6054,5178,8879,6239,8855.308825,9028,11553,50705,6807,-17919,7407,6807,56642,57512,32786,58112,57512
47183,TN,9432,6239,8887,11553,6054,5178,8805,5686,9556.08866,9028,10131,49011,6234,-18492,6570,6234,56148,55245,30519,55581,55245
47185,TN,9252,6239,8887,11553,6054,5178,8774,6239,8887.162454,9028,11553,50137,6807,-17919,7407,6807,55937,56944,32218,57544,56944
47187,TN,13572,6239,8887,11553,6054,5178,9531,7243,9492.381402,9028,11570,56083,7953,-16773,9081,7953,61014,64036,39310,65164,64036
47189,TN,13572,6239,8887,11553,6054,5178,9531,6155,8600.479794,9028,11570,54103,7953,-16773,9081,7953,61014,62056,37330,63184,62056
48001,TX,10500,12784,8887,11553,6597,5178,6146,13506,8409.358021,8320,10973,56886,5240,-19158,6632,5240,61645,62126,37728,63518,62126
48003,TX,11268,12784,8887,11553,6597,5178,6235,12895,8250.089876,8320,12149,58060,5693,-18282,7349,5693,62502,63753,39778,65409,63753
48005,TX,11196,12784,8887,11553,6597,5178,6226,13337,8154.52899,8320,11186,57371,5693,-18282,7349,5693,62421,63064,39089,64720,63064
48007,TX,12408,12784,8887,11553,6597,5178,6366,14690,7963.407216,8320,11511,60071,6146,-17406,8066,6146,63773,66217,42665,68137,66217
48009,TX,12108,12784,8887,11553,6597,5178,6331,12452,8154.52899,8320,11233,57446,5693,-18282,7349,5693,63438,63139,39164,64795,63139
48011,TX,12048,12784,8887,11553,6597,5178,6325,11347,8727.894309,8320,11519,57140,5240,-19158,6632,5240,63372,62380,37982,63772,62380
48013,TX,11064,12784,8887,11553,6597,5178,6211,14059,7995.260845,8320,11803,58418,5693,-18282,7349,5693,62274,64111,40136,65767,64111
48015,TX,12372,12784,8887,11553,6597,5178,6362,14138,8982.72334,8320,12085,61076,6146,-17406,8066,6146,63733,67222,43670,69142,67222
48017,TX,9780,12784,8887,11553,6597,5178,6063,12784,8919.016082,8320,11553,56534,5240,-19158,6632,5240,60842,61774,37376,63166,61774
48019,TX,13404,12784,8887,11553,6597,5178,6481,14326,9078.284227,8320,11801,62107,6146,-17406,8066,6146,64884,68253,44701,70173,68253
48021,TX,17448,12784,8887,11553,6597,5178,6947,14665,7549.310041,8320,12285,65445,7505,-14777,10217,7505,69394,72950,50668,75662,72950
48023,TX,9516,12784,8887,11553,6597,5178,6033,12784,8090.821732,8320,11553,55442,5240,-19158,6632,5240,60548,60682,36284,62074,60682
48025,TX,11688,12784,8887,11553,6597,5178,6283,12675,7103.359237,8320,10893,55858,5240,-19158,6632,5240,62970,61098,36700,62490,61098
48027,TX,12984,12784,8887,11553,6597,5178,6432,14165,7549.310041,8320,11930,60126,6146,-17406,8066,6146,64415,66272,42720,68192,66272
48029,TX,13404,12784,8887,11553,6597,5178,6481,14189,7835.992701,8320,11852,60780,6146,-17406,8066,6146,64884,66926,43374,68846,66926
48031,TX,12036,12784,8887,11553,6597,5178,6323,12784,8250.089876,8320,11553,58121,5693,-18282,7349,5693,63358,63814,39839,65470,63814
48033,TX,9756,12784,8887,11553,6597,5178,6060,12784,7804.139072,8320,11553,55395,5240,-19158,6632,5240,60815,60635,36237,62027,60635
48035,TX,11220,12784,8887,11553,6597,5178,6229,12784,7676.724557,8320,11553,56732,5240,-19158,6632,5240,62448,61972,37574,63364,61972
48037,TX,10524,12784,8887,11553,6597,5178,6149,13351,8027.114474,8320,10978,56379,5240,-19158,6632,5240,61672,61619,37221,63011,61619
48039,TX,13692,12784,8887,11553,6597,5178,6514,14816,8473.065278,8320,12132,62611,6599,-16530,8783,6599,65205,69210,46081,71394,69210
48041,TX,15060,12784,8887,11553,6597,5178,6671,15396,8186.382618,8320,10825,62965,6599,-16530,8783,6599,66730,69564,46435,71748,69564
48043,TX,11100,12784,8887,11553,6597,5178,6215,12784,9014.576969,8320,11553,57950,5240,-19158,6632,5240,62314,63190,38792,64582,63190
48045,TX,10188,12784,8887,11553,6597,5178,6110,12784,8600.479794,8320,11553,56623,5240,-19158,6632,5240,61297,61863,37465,63255,61863
48047,TX,11268,12784,8887,11553,6597,5178,6235,12784,7039.651979,8320,11553,56143,5240,-19158,6632,5240,62502,61383,36985,62775,61383
48049,TX,10296,12784,8887,11553,6597,5178,6123,13034,8504.918907,8320,10670,56003,5240,-19158,6632,5240,61418,61243,36845,62635,61243
48051,TX,15060,12784,8887,11553,6597,5178,6671,13515,8218.236247,8320,10844,61135,6146,-17406,8066,6146,66730,67281,43729,69201,67281
48053,TX,12060,12784,8887,11553,6597,5178,6326,12784,7867.84633,8320,11553,57763,5693,-18282,7349,5693,63385,63456,39481,65112,63456
48055,TX,17448,12784,8887,11553,6597,5178,6947,14324,7039.651979,8320,12313,64623,7505,-14777,10217,7505,69394,72128,49846,74840,72128
48057,TX,10644,12784,8887,11553,6597,5178,6163,13278,7390.041897,8320,11296,56106,5240,-19158,6632,5240,61806,61346,36948,62738,61346
48059,TX,12000,12784,8887,11553,6597,5178,6319,13058,7995.260845,8320,11189,57741,5693,-18282,7349,5693,63318,63434,39459,65090,63434
48061,TX,10620,12784,8887,11553,6597,5178,6160,13243,6721.115691,8320,11110,55192,5240,-19158,6632,5240,61779,60432,36034,61824,60432
48063,TX,9888,12784,8887,11553,6597,5178,6076,12784,8473.065278,8320,11553,56196,5240,-19158,6632,5240,60963,61436,37038,62828,61436
48065,TX,12048,12784,8887,11553,6597,5178,6325,12149,8727.894309,8320,11520,57942,5693,-18282,7349,5693,63372,63635,39660,65291,63635
48067,TX,10524,12784,8887,11553,6597,5178,6149,12784,8504.918907,8320,11553,56864,5240,-19158,6632,5240,61672,62104,37706,63496,62104
48069,TX,9516,12784,8887,11553,6597,5178,6033,12784,9078.284227,8320,11553,56429,5240,-19158,6632,5240,60548,61669,37271,63061,61669
48071,TX,15168,12784,8887,11553,6597,5178,6684,14469,9842.771319,8320,12091,65069,7052,-15653,9500,7052,66851,72121,49416,74569,72121
48073,TX,9936,12784,8887,11553,6597,5178,6081,13169,8377.504392,8320,10647,55628,5240,-19158,6632,5240,61016,60868,36470,62260,60868
48075,TX,9924,12784,8887,11553,6597,5178,6080,12784,8664.187051,8320,11553,56423,5240,-19158,6632,5240,61003,61663,37265,63055,61663
48077,TX,12108,12784,8887,11553,6597,5178,6331,12401,8027.114474,8320,11229,57263,5693,-18282,7349,5693,63438,62956,38981,64612,62956
48079,TX,11268,12784,8887,11553,6597,5178,6235,12784,8600.479794,8320,11553,57703,5240,-19158,6632,5240,62502,62943,38545,64335,62943
48081,TX,9516,12784,8887,11553,6597,5178,6033,12784,7804.139072,8320,11553,55155,5240,-19158,6632,5240,60548,60395,35997,61787,60395
48083,TX,11268,12784,8887,11553,6597,5178,6235,12784,7963.407216,8320,11553,57066,5240,-19158,6632,5240,62502,62306,37908,63698,62306
48085,TX,14616,12784,8887,11553,6597,5178,6620,15982,9173.845113,8320,12042,65312,7052,-15653,9500,7052,66235,72364,49659,74812,72364
48087,TX,11268,12784,8887,11553,6597,5178,6235,12784,8759.747938,8320,11553,57863,5240,-19158,6632,5240,62502,63103,38705,64495,63103
48089,TX,10968,12784,8887,11553,6597,5178,6200,12784,7581.16367,8320,11553,56384,5240,-19158,6632,5240,62167,61624,37226,63016,61624
48091,TX,13404,12784,8887,11553,6597,5178,6481,14794,8664.187051,8320,11813,62172,6599,-16530,8783,6599,64884,68771,45642,70955,68771
48093,TX,9516,12784,8887,11553,6597,5178,6033,12784,8345.650763,8320,11553,55697,5240,-19158,6632,5240,60548,60937,36539,62329,60937
48095,TX,15204,12784,8887,11553,6597,5178,6688,12784,7867.84633,8320,11553,60907,6146,-17406,8066,6146,66891,67053,43501,68973,67053
48097,TX,12744,12784,8887,11553,6597,5178,6405,13313,9333.113258,8320,11437,60324,5693,-18282,7349,5693,64148,66017,42042,67673,66017
48099,TX,12984,12784,8887,11553,6597,5178,6432,13637,7835.992701,8320,11903,59858,6146,-17406,8066,6146,64415,66004,42452,67924,66004
48101,TX,11268,12784,8887,11553,6597,5178,6235,12784,8664.187051,8320,11553,57767,5240,-19158,6632,5240,62502,63007,38609,64399,63007
48103,TX,11148,12784,8887,11553,6597,5178,6221,12784,8122.675361,8320,11553,57106,5240,-19158,6632,5240,62368,62346,37948,63738,62346
48105,TX,11268,12784,8887,11553,6597,5178,6235,12784,7390.041897,8320,11553,56493,5240,-19158,6632,5240,62502,61733,37335,63125,61733
48107,TX,13560,12784,8887,11553,6597,5178,6499,11217,8441.211649,8320,11354,58070,5693,-18282,7349,5693,65058,63763,39788,65419,63763
48109,TX,10944,12784,8887,11553,6597,5178,6197,12784,8313.797134,8320,11553,57093,5240,-19158,6632,5240,62140,62333,37935,63725,62333
48111,TX,11160,12784,8887,11553,6597,5178,6222,12784,8664.187051,8320,11553,57659,5240,-19158,6632,5240,62381,62899,38501,64291,62899
48113,TX,14616,12784,8887,11553,6597,5178,6620,15517,8696.04068,8320,12082,64410,7052,-15653,9500,7052,66235,71462,48757,73910,71462
48115,TX,11268,12784,8887,11553,6597,5178,6235,11362,8281.943505,8320,10282,54692,4787,-19939,5915,4787,62502,59479,34753,60607,59479
48117,TX,10668,12784,8887,11553,6597,5178,6166,12447,8727.894309,8320,11591,56932,5240,-19158,6632,5240,61833,62172,37774,63564,62172
48119,TX,14616,12784,8887,11553,6597,5178,6620,12784,8632.333423,8320,11553,61083,6146,-17406,8066,6146,66235,67229,43677,69149,67229
48121,TX,14616,12784,8887,11553,6597,5178,6620,15696,9141.991484,8320,12053,65005,7052,-15653,9500,7052,66235,72057,49352,74505,72057
48123,TX,9516,12784,8887,11553,6597,5178,6033,12784,6784.822948,8320,11553,54136,5240,-19158,6632,5240,60548,59376,34978,60768,59376
48125,TX,9516,12784,8887,11553,6597,5178,6033,12784,8441.211649,8320,11553,55792,5240,-19158,6632,5240,60548,61032,36634,62424,61032
48127,TX,9516,12784,8887,11553,6597,5178,6033,12784,6657.408433,8320,11553,54008,5240,-19158,6632,5240,60548,59248,34850,60640,59248
48129,TX,9516,12784,8887,11553,6597,5178,6033,12784,8982.72334,8320,11553,56334,5240,-19158,6632,5240,60548,61574,37176,62966,61574
48131,TX,10584,12784,8887,11553,6597,5178,6156,12784,7135.212866,8320,11553,55554,5240,-19158,6632,5240,61739,60794,36396,62186,60794
48133,TX,9516,12784,8887,11553,6597,5178,6033,12784,8377.504392,8320,11553,55729,5240,-19158,6632,5240,60548,60969,36571,62361,60969
48135,TX,15156,12784,8887,11553,6597,5178,6683,14176,7931.553588,8320,11840,62602,6599,-16530,8783,6599,66838,69201,46072,71385,69201
48137,TX,9516,12784,8887,11553,6597,5178,6033,12784,7390.041897,8320,11553,54741,5240,-19158,6632,5240,60548,59981,35583,61373,59981
48139,TX,14616,12784,8887,11553,6597,5178,6620,14055,8250.089876,8320,12005,62424,6599,-16530,8783,6599,66235,69023,45894,71207,69023
48141,TX,12708,12784,8887,11553,6597,5178,6401,13453,8090.821732,8320,11663,59413,6146,-17406,8066,6146,64108,65559,42007,67479,65559
48143,TX,11184,12784,8887,11553,6597,5178,6225,13965,8122.675361,8320,10806,57575,5693,-18282,7349,5693,62408,63268,39293,64924,63268
48145,TX,10788,12784,8887,11553,6597,5178,6179,12342,7517.456412,8320,11253,55398,5240,-19158,6632,5240,61966,60638,36240,62030,60638
48147,TX,10752,12784,8887,11553,6597,5178,6175,12784,8504.918907,8320,11553,57092,5240,-19158,6632,5240,61926,62332,37934,63724,62332
48149,TX,9996,12784,8887,11553,6597,5178,6088,12784,7453.749155,8320,11553,55285,5240,-19158,6632,5240,61083,60525,36127,61917,60525
48151,TX,11268,12784,8887,11553,6597,5178,6235,12784,7899.699959,8320,11553,57003,5240,-19158,6632,5240,62502,62243,37845,63635,62243
48153,TX,11268,12784,8887,11553,6597,5178,6235,12784,8441.211649,8320,11553,57544,5240,-19158,6632,5240,62502,62784,38386,64176,62784
48155,TX,11268,12784,8887,11553,6597,5178,6235,12784,8887.162454,8320,11553,57990,5240,-19158,6632,5240,62502,63230,38832,64622,63230
48157,TX,15168,12784,8887,11553,6597,5178,6684,15028,8568.626165,8320,12122,64384,7052,-15653,9500,7052,66851,71436,48731,73884,71436
48159,TX,11268,12784,8887,11553,6597,5178,6235,12784,8536.772536,8320,11553,57640,5240,-19158,6632,5240,62502,62880,38482,64272,62880
48161,TX,11736,12784,8887,11553,6597,5178,6289,12784,8122.675361,8320,11553,57694,5693,-18282,7349,5693,63024,63387,39412,65043,63387
48163,TX,11268,12784,8887,11553,6597,5178,6235,12784,7835.992701,8320,11553,56939,5240,-19158,6632,5240,62502,62179,37781,63571,62179
48165,TX,10776,12784,8887,11553,6597,5178,6178,12784,8250.089876,8320,11553,56861,5240,-19158,6632,5240,61953,62101,37703,63493,62101
48167,TX,15168,12784,8887,11553,6597,5178,6684,14666,8950.869711,8320,12144,64427,7052,-15653,9500,7052,66851,71479,48774,73927,71479
48169,TX,11268,12784,8887,11553,6597,5178,6235,12784,8441.211649,8320,11553,57544,5240,-19158,6632,5240,62502,62784,38386,64176,62784
48171,TX,13080,12784,8887,11553,6597,5178,6443,14116,8058.968103,8320,11111,59864,6146,-17406,8066,6146,64522,66010,42458,67930,66010
48173,TX,9756,12784,8887,11553,6597,5178,6060,13425,8058.968103,8320,11136,55874,5240,-19158,6632,5240,60815,61114,36716,62506,61114
48175,TX,10920,12784,8887,11553,6597,5178,6195,13180,7453.749155,8320,11582,56634,5693,-18282,7349,5693,62114,62327,38352,63983,62327
48177,TX,11268,12784,8887,11553,6597,5178,6235,12784,7995.260845,8320,11553,57098,5240,-19158,6632,5240,62502,62338,37940,63730,62338
48179,TX,9588,12784,8887,11553,6597,5178,6041,12064,9046.430598,8320,10854,55050,4787,-19939,5915,4787,60628,59837,35111,60965,59837
48181,TX,13020,12784,8887,11553,6597,5178,6436,13364,8281.943505,8320,11143,59307,5693,-18282,7349,5693,64455,65000,41025,66656,65000
48183,TX,11928,12784,8887,11553,6597,5178,6311,13698,8377.504392,8320,11309,58810,5693,-18282,7349,5693,63238,64503,40528,66159,64503
48185,TX,10188,12784,8887,11553,6597,5178,6110,12784,9014.576969,8320,11553,57038,5240,-19158,6632,5240,61297,62278,37880,63670,62278
48187,TX,13404,12784,8887,11553,6597,5178,6481,13909,8122.675361,8320,11815,60749,6146,-17406,8066,6146,64884,66895,43343,68815,66895
48189,TX,10404,12784,8887,11553,6597,5178,6135,11977,8536.772536,8320,11220,55636,4787,-19939,5915,4787,61538,60423,35697,61551,60423
48191,TX,11268,12784,8887,11553,6597,5178,6235,12784,8664.187051,8320,11553,57767,5240,-19158,6632,5240,62502,63007,38609,64399,63007
48193,TX,11268,12784,8887,11553,6597,5178,6235,12784,7740.431814,8320,11553,56843,5240,-19158,6632,5240,62502,62083,37685,63475,62083
48195,TX,10104,12784,8887,11553,6597,5178,6101,12784,8664.187051,8320,11553,56603,5240,-19158,6632,5240,61204,61843,37445,63235,61843
48197,TX,9636,12784,8887,11553,6597,5178,6047,12784,8568.626165,8320,11553,56040,5240,-19158,6632,5240,60682,61280,36882,62672,61280
48199,TX,12672,12784,8887,11553,6597,5178,6396,13869,8250.089876,8320,11096,59385,6146,-17406,8066,6146,64067,65531,41979,67451,65531
48201,TX,15168,12784,8887,11553,6597,5178,6684,15466,8473.065278,8320,12192,64797,7052,-15653,9500,7052,66851,71849,49144,74297,71849
48203,TX,10032,12784,8887,11553,6597,5178,6092,13677,8409.358021,8320,11409,57025,5240,-19158,6632,5240,61123,62265,37867,63657,62265
48205,TX,10608,12784,8887,11553,6597,5178,6159,12784,8632.333423,8320,11553,57075,5240,-19158,6632,5240,61766,62315,37917,63707,62315
48207,TX,11268,12784,8887,11553,6597,5178,6235,12784,8887.162454,8320,11553,57990,5240,-19158,6632,5240,62502,63230,38832,64622,63230
48209,TX,17448,12784,8887,11553,6597,5178,6947,15387,8186.382618,8320,12320,66839,7505,-14777,10217,7505,69394,74344,52062,77056,74344
48211,TX,10476,12784,8887,11553,6597,5178,6143,12784,8919.016082,8320,11553,57230,5240,-19158,6632,5240,61618,62470,38072,63862,62470
48213,TX,10788,12784,8887,11553,6597,5178,6179,14088,8441.211649,8320,10821,57636,5693,-18282,7349,5693,61966,63329,39354,64985,63329
48215,TX,9792,12784,8887,11553,6597,5178,6065,13285,6816.676577,8320,11361,54753,5240,-19158,6632,5240,60856,59993,35595,61385,59993
48217,TX,11400,12784,8887,11553,6597,5178,6250,12784,8727.894309,8320,11553,57963,5693,-18282,7349,5693,62649,63656,39681,65312,63656
48219,TX,10632,12784,8887,11553,6597,5178,6161,12662,8504.918907,8320,11712,57009,5240,-19158,6632,5240,61792,62249,37851,63641,62249
48221,TX,13716,12784,8887,11553,6597,5178,6517,14823,9046.430598,8320,12011,63095,6599,-16530,8783,6599,65232,69694,46565,71878,69694
48223,TX,10860,12784,8887,11553,6597,5178,6188,13031,8536.772536,8320,11057,56983,5240,-19158,6632,5240,62047,62223,37825,63615,62223
48225,TX,11232,12784,8887,11553,6597,5178,6230,12784,7453.749155,8320,11553,56521,5240,-19158,6632,5240,62461,61761,37363,63153,61761
48227,TX,10164,12784,8887,11553,6597,5178,6107,12405,7740.431814,8320,11044,54851,4787,-19939,5915,4787,61270,59638,34912,60766,59638
48229,TX,11268,12784,8887,11553,6597,5178,6235,13364,8281.943505,8320,11586,57998,5693,-18282,7349,5693,62502,63691,39716,65347,63691
48231,TX,14616,12784,8887,11553,6597,5178,6620,13989,8632.333423,8320,12010,62745,6599,-16530,8783,6599,66235,69344,46215,71528,69344
48233,TX,10812,12784,8887,11553,6597,5178,6182,12217,9173.845113,8320,11133,56834,5240,-19158,6632,5240,61993,62074,37676,63466,62074
48235,TX,12156,12784,8887,11553,6597,5178,6337,12095,7708.578185,8320,11283,56740,5240,-19158,6632,5240,63492,61980,37582,63372,61980
48237,TX,9948,12784,8887,11553,6597,5178,6083,12784,9173.845113,8320,11553,56957,5240,-19158,6632,5240,61030,62197,37799,63589,62197
48239,TX,12228,12784,8887,11553,6597,5178,6345,12784,7421.895526,8320,11553,57485,5693,-18282,7349,5693,63572,63178,39203,64834,63178
48241,TX,10860,12784,8887,11553,6597,5178,6188,12784,8122.675361,8320,11553,56818,5240,-19158,6632,5240,62047,62058,37660,63450,62058
48243,TX,10188,12784,8887,11553,6597,5178,6110,12784,9110.137856,8320,11553,57133,5240,-19158,6632,5240,61297,62373,37975,63765,62373
48245,TX,12672,12784,8887,11553,6597,5178,6396,13353,7772.285443,8320,11063,58359,5693,-18282,7349,5693,64067,64052,40077,65708,64052
48247,TX,9696,12784,8887,11553,6597,5178,6054,12784,6816.676577,8320,11553,54348,5240,-19158,6632,5240,60749,59588,35190,60980,59588
48249,TX,11364,12784,8887,11553,6597,5178,6246,13221,7103.359237,8320,11392,56578,5693,-18282,7349,5693,62609,62271,38296,63927,62271
48251,TX,15096,12784,8887,11553,6597,5178,6676,14184,7517.456412,8320,12010,62305,6599,-16530,8783,6599,66771,68904,45775,71088,68904
48253,TX,12000,12784,8887,11553,6597,5178,6319,11939,9301.259629,8320,11198,57936,5240,-19158,6632,5240,63318,63176,38778,64568,63176
48255,TX,11268,12784,8887,11553,6597,5178,6235,12784,7899.699959,8320,11553,57003,5240,-19158,6632,5240,62502,62243,37845,63635,62243
48257,TX,14616,12784,8887,11553,6597,5178,6620,14134,9014.576969,8320,11999,63262,6599,-16530,8783,6599,66235,69861,46732,72045,69861
48259,TX,14928,12784,8887,11553,6597,5178,6656,15536,8632.333423,8320,11803,64397,7052,-15653,9500,7052,66583,71449,48744,73897,71449
48261,TX,11952,12784,8887,11553,6597,5178,6313,10736,7039.651979,8320,11250,54475,5240,-19158,6632,5240,63264,59715,35317,61107,59715
48263,TX,11316,12784,8887,11553,6597,5178,6240,12784,8632.333423,8320,11553,57783,5693,-18282,7349,5693,62555,63476,39501,65132,63476
48265,TX,13368,12784,8887,11553,6597,5178,6477,14073,8058.968103,8320,10667,59665,6146,-17406,8066,6146,64844,65811,42259,67731,65811
48267,TX,10068,12784,8887,11553,6597,5178,6096,12784,8058.968103,8320,11553,55962,5240,-19158,6632,5240,61163,61202,36804,62594,61202
48269,TX,9756,12784,8887,11553,6597,5178,6060,12784,8791.601567,8320,11553,56383,5240,-19158,6632,5240,60815,61623,37225,63015,61623
48271,TX,11268,12784,8887,11553,6597,5178,6235,12784,6593.701175,8320,11553,55697,5240,-19158,6632,5240,62502,60937,36539,62329,60937
48273,TX,11592,12784,8887,11553,6597,5178,6272,13276,7644.870928,8320,11202,57213,5693,-18282,7349,5693,62863,62906,38931,64562,62906
48275,TX,9516,12784,8887,11553,6597,5178,6033,12784,8791.601567,8320,11553,56143,5240,-19158,6632,5240,60548,61383,36985,62775,61383
48277,TX,11136,12784,8887,11553,6597,5178,6219,12382,8664.187051,8320,10882,56563,5240,-19158,6632,5240,62354,61803,37405,63195,61803
48279,TX,10212,12784,8887,11553,6597,5178,6113,12784,8441.211649,8320,11553,56488,5240,-19158,6632,5240,61324,61728,37330,63120,61728
48281,TX,11268,12784,8887,11553,6597,5178,6235,13489,8122.675361,8320,11875,58253,5693,-18282,7349,5693,62502,63946,39971,65602,63946
48283,TX,11268,12784,8887,11553,6597,5178,6235,12784,6944.091093,8320,11553,56047,5240,-19158,6632,5240,62502,61287,36889,62679,61287
48285,TX,10968,12784,8887,11553,6597,5178,6200,12784,7453.749155,8320,11553,56257,5240,-19158,6632,5240,62167,61497,37099,62889,61497
48287,TX,11268,12784,8887,11553,6597,5178,6235,12784,8536.772536,8320,11553,57640,5240,-19158,6632,5240,62502,62880,38482,64272,62880
48289,TX,10176,12784,8887,11553,6597,5178,6109,12784,8122.675361,8320,11553,56134,5240,-19158,6632,5240,61284,61374,36976,62766,61374
48291,TX,15168,12784,8887,11553,6597,5178,6684,14519,7995.260845,8320,12077,63257,7052,-15653,9500,7052,66851,70309,47604,72757,70309
48293,TX,12720,12784,8887,11553,6597,5178,6402,12784,7613.017299,8320,11553,58168,5693,-18282,7349,5693,64121,63861,39886,65517,63861
48295,TX,9516,12784,8887,11553,6597,5178,6033,12784,8791.601567,8320,11553,56143,5240,-19158,6632,5240,60548,61383,36985,62775,61383
48297,TX,9516,12784,8887,11553,6597,5178,6033,12784,7517.456412,8320,11553,54868,5240,-19158,6632,5240,60548,60108,35710,61500,60108
48299,TX,11268,12784,8887,11553,6597,5178,6235,12784,7804.139072,8320,11553,56907,5240,-19158,6632,5240,62502,62147,37749,63539,62147
48301,TX,10452,12784,8887,11553,6597,5178,6141,12784,9333.113258,8320,11553,57620,5240,-19158,6632,5240,61592,62860,38462,64252,62860
48303,TX,13560,12784,8887,11553,6597,5178,6499,13841,8441.211649,8320,11354,60694,6146,-17406,8066,6146,65058,66840,43288,68760,66840
48305,TX,11268,12784,8887,11553,6597,5178,6235,12235,8441.211649,8320,11357,56800,5240,-19158,6632,5240,62502,62040,37642,63432,62040
48307,TX,11112,12784,8887,11553,6597,5178,6217,12784,8473.065278,8320,11553,57420,5240,-19158,6632,5240,62328,62660,38262,64052,62660
48309,TX,11868,12784,8887,11553,6597,5178,6304,13672,7485.602783,8320,11275,57798,5693,-18282,7349,5693,63171,63491,39516,65147,63491
48311,TX,11544,12784,8887,11553,6597,5178,6266,12784,7644.870928,8320,11553,57024,5693,-18282,7349,5693,62809,62717,38742,64373,62717
48313,TX,11268,12784,8887,11553,6597,5178,6235,12784,8218.236247,8320,11553,57321,5240,-19158,6632,5240,62502,62561,38163,63953,62561
48315,TX,9516,12784,8887,11553,6597,5178,6033,12784,8632.333423,8320,11553,55983,5240,-19158,6632,5240,60548,61223,36825,62615,61223
48317,TX,9516,12784,8887,11553,6597,5178,6033,12358,8090.821732,8320,12474,55937,5240,-19158,6632,5240,60548,61177,36779,62569,61177
48319,TX,11268,12784,8887,11553,6597,5178,6235,12784,7963.407216,8320,11553,57066,5240,-19158,6632,5240,62502,62306,37908,63698,62306
48321,TX,11664,12784,8887,11553,6597,5178,6280,13252,7326.334639,8320,11279,57019,5693,-18282,7349,5693,62943,62712,38737,64368,62712
48323,TX,10872,12784,8887,11553,6597,5178,6189,12810,6275.164887,8320,10996,54451,5240,-19158,6632,5240,62060,59691,35293,61083,59691
48325,TX,10992,12784,8887,11553,6597,5178,6203,14571,7135.212866,8320,11805,58001,5693,-18282,7349,5693,62194,63694,39719,65350,63694
48327,TX,10368,12784,8887,11553,6597,5178,6131,12784,7740.431814,8320,11553,55943,5240,-19158,6632,5240,61498,61183,36785,62575,61183
48329,TX,13968,12784,8887,11553,6597,5178,6546,14620,8313.797134,8320,12605,63006,6599,-16530,8783,6599,65513,69605,46476,71789,69605
48331,TX,11268,12784,8887,11553,6597,5178,6235,12784,8281.943505,8320,11553,57385,5240,-19158,6632,5240,62502,62625,38227,64017,62625
48333,TX,11268,12784,8887,11553,6597,5178,6235,12784,7963.407216,8320,11553,57066,5240,-19158,6632,5240,62502,62306,37908,63698,62306
48335,TX,10992,12784,8887,11553,6597,5178,6203,12784,8027.114474,8320,11553,56854,5240,-19158,6632,5240,62194,62094,37696,63486,62094
48337,TX,11184,12784,8887,11553,6597,5178,6225,12784,8313.797134,8320,11553,57333,5240,-19158,6632,5240,62408,62573,38175,63965,62573
48339,TX,15168,12784,8887,11553,6597,5178,6684,15331,8919.016082,8320,12122,65038,7052,-15653,9500,7052,66851,72090,49385,74538,72090
48341,TX,10212,12784,8887,11553,6597,5178,6113,13007,8664.187051,8320,12473,57854,5693,-18282,7349,5693,61324,63547,39572,65203,63547
48343,TX,10956,12784,8887,11553,6597,5178,6199,12784,8313.797134,8320,11553,57105,5240,-19158,6632,5240,62154,62345,37947,63737,62345
48345,TX,9516,12784,8887,11553,6597,5178,6033,12784,8600.479794,8320,11553,55951,5240,-19158,6632,5240,60548,61191,36793,62583,61191
48347,TX,10704,12784,8887,11553,6597,5178,6170,13860,8759.747938,8320,10454,57275,5240,-19158,6632,5240,61873,62515,38117,63907,62515
48349,TX,11016,12784,8887,11553,6597,5178,6206,13232,7517.456412,8320,11084,56347,5240,-19158,6632,5240,62221,61587,37189,62979,61587
48351,TX,9516,12784,8887,11553,6597,5178,6033,13046,8154.52899,8320,11127,55341,5240,-19158,6632,5240,60548,60581,36183,61973,60581
48353,TX,11268,12784,8887,11553,6597,5178,6235,11659,7899.699959,8320,10615,54939,4787,-19939,5915,4787,62502,59726,35000,60854,59726
48355,TX,13332,12784,8887,11553,6597,5178,6472,14090,7613.017299,8320,11522,60054,6146,-17406,8066,6146,64803,66200,42648,68120,66200
48357,TX,10884,12784,8887,11553,6597,5178,6190,12784,8441.211649,8320,11553,57160,5240,-19158,6632,5240,62073,62400,38002,63792,62400
48359,TX,12072,12784,8887,11553,6597,5178,6327,12565,8664.187051,8320,11520,58319,5693,-18282,7349,5693,63398,64012,40037,65668,64012
48361,TX,12672,12784,8887,11553,6597,5178,6396,13302,8154.52899,8320,11085,58711,5693,-18282,7349,5693,64067,64404,40429,66060,64404
48363,TX,11556,12784,8887,11553,6597,5178,6268,13718,8441.211649,8320,11051,58264,5693,-18282,7349,5693,62823,63957,39982,65613,63957
48365,TX,9756,12784,8887,11553,6597,5178,6060,12784,7931.553588,8320,11553,55523,5240,-19158,6632,5240,60815,60763,36365,62155,60763
48367,TX,15096,12784,8887,11553,6597,5178,6676,14718,9556.08866,8320,12002,64870,7052,-15653,9500,7052,66771,71922,49217,74370,71922
48369,TX,10020,12784,8887,11553,6597,5178,6091,12784,8982.72334,8320,11553,56838,5240,-19158,6632,5240,61110,62078,37680,63470,62078
48371,TX,10248,12784,8887,11553,6597,5178,6117,12784,8154.52899,8320,11553,56238,5240,-19158,6632,5240,61364,61478,37080,62870,61478
48373,TX,11196,12784,8887,11553,6597,5178,6226,12784,7931.553588,8320,11553,56963,5240,-19158,6632,5240,62421,62203,37805,63595,62203
48375,TX,12048,12784,8887,11553,6597,5178,6325,13220,8281.943505,8320,11530,58579,5693,-18282,7349,5693,63372,64272,40297,65928,64272
48377,TX,11268,12784,8887,11553,6597,5178,6235,12784,9460.527773,8320,11553,58564,5240,-19158,6632,5240,62502,63804,39406,65196,63804
48379,TX,11268,12784,8887,11553,6597,5178,6235,12784,8791.601567,8320,11553,57895,5240,-19158,6632,5240,62502,63135,38737,64527,63135
48381,TX,12048,12784,8887,11553,6597,5178,6325,13983,9396.820515,8320,11527,60453,5693,-18282,7349,5693,63372,66146,42171,67802,66146
48383,TX,9528,12784,8887,11553,6597,5178,6034,12784,7963.407216,8320,11553,55326,5240,-19158,6632,5240,60561,60566,36168,61958,60566
48385,TX,11268,12784,8887,11553,6597,5178,6235,12784,7835.992701,8320,11553,56939,5240,-19158,6632,5240,62502,62179,37781,63571,62179
48387,TX,10008,12784,8887,11553,6597,5178,6089,12784,8281.943505,8320,11553,56125,5240,-19158,6632,5240,61096,61365,36967,62757,61365
48389,TX,11268,12784,8887,11553,6597,5178,6235,12161,8250.089876,8320,11431,56608,5240,-19158,6632,5240,62502,61848,37450,63240,61848
48391,TX,11160,12784,8887,11553,6597,5178,6222,12784,7517.456412,8320,11553,56512,5240,-19158,6632,5240,62381,61752,37354,63144,61752
48393,TX,9756,12784,8887,11553,6597,5178,6060,12784,8982.72334,8320,11553,56574,5240,-19158,6632,5240,60815,61814,37416,63206,61814
48395,TX,15060,12784,8887,11553,6597,5178,6671,13495,7835.992701,8320,10843,60732,6146,-17406,8066,6146,66730,66878,43326,68798,66878
48397,TX,14616,12784,8887,11553,6597,5178,6620,15111,8950.869711,8320,11999,64174,7052,-15653,9500,7052,66235,71226,48521,73674,71226
48399,TX,11268,12784,8887,11553,6597,5178,6235,12784,7804.139072,8320,11553,56907,5240,-19158,6632,5240,62502,62147,37749,63539,62147
48401,TX,10824,12784,8887,11553,6597,5178,6183,13005,8441.211649,8320,11308,57076,5240,-19158,6632,5240,62006,62316,37918,63708,62316
48403,TX,11268,12784,8887,11553,6597,5178,6235,12784,8377.504392,8320,11553,57481,5240,-19158,6632,5240,62502,62721,38323,64113,62721
48405,TX,9516,12784,8887,11553,6597,5178,6033,12784,8377.504392,8320,11553,55729,5240,-19158,6632,5240,60548,60969,36571,62361,60969
48407,TX,15168,12784,8887,11553,6597,5178,6684,12784,9269.406,8320,11553,62272,6146,-17406,8066,6146,66851,68418,44866,70338,68418
48409,TX,13332,12784,8887,11553,6597,5178,6472,13517,7358.188268,8320,11518,59223,6146,-17406,8066,6146,64803,65369,41817,67289,65369
48411,TX,10392,12784,8887,11553,6597,5178,6134,12784,7931.553588,8320,11553,56159,5240,-19158,6632,5240,61525,61399,37001,62791,61399
48413,TX,9516,12784,8887,11553,6597,5178,6033,12784,7708.578185,8320,11553,55060,5240,-19158,6632,5240,60548,60300,35902,61692,60300
48415,TX,11268,12784,8887,11553,6597,5178,6235,12357,7995.260845,8320,11285,56403,5240,-19158,6632,5240,62502,61643,37245,63035,61643
48417,TX,11268,12784,8887,11553,6597,5178,6235,12784,7899.699959,8320,11553,57003,5240,-19158,6632,5240,62502,62243,37845,63635,62243
48419,TX,9516,12784,8887,11553,6597,5178,6033,12784,8504.918907,8320,11553,55856,5240,-19158,6632,5240,60548,61096,36698,62488,61096
48421,TX,10560,12784,8887,11553,6597,5178,6153,12784,8536.772536,8320,11553,56932,5240,-19158,6632,5240,61712,62172,37774,63564,62172
48423,TX,13932,12784,8887,11553,6597,5178,6542,14176,8759.747938,8320,11371,61737,6146,-17406,8066,6146,65473,67883,44331,69803,67883
48425,TX,11268,12784,8887,11553,6597,5178,6235,13961,7931.553588,8320,11991,58650,5693,-18282,7349,5693,62502,64343,40368,65999,64343
48427,TX,9516,12784,8887,11553,6597,5178,6033,11379,7390.041897,8320,10865,52648,4787,-19939,5915,4787,60548,57435,32709,58563,57435
48429,TX,10380,12784,8887,11553,6597,5178,6132,12784,8600.479794,8320,11553,56815,5240,-19158,6632,5240,61511,62055,37657,63447,62055
48431,TX,11940,12784,8887,11553,6597,5178,6312,12784,8027.114474,8320,11553,57802,5693,-18282,7349,5693,63251,63495,39520,65151,63495
48433,TX,11172,12784,8887,11553,6597,5178,6224,12784,8664.187051,8320,11553,57671,5240,-19158,6632,5240,62395,62911,38513,64303,62911
48435,TX,9780,12784,8887,11553,6597,5178,6063,12784,7294.48101,8320,11553,54909,5240,-19158,6632,5240,60842,60149,35751,61541,60149
48437,TX,10272,12784,8887,11553,6597,5178,6120,12784,8632.333423,8320,11553,56739,5240,-19158,6632,5240,61391,61979,37581,63371,61979
48439,TX,15096,12784,8887,11553,6597,5178,6676,14794,8664.187051,8320,12048,64099,7052,-15653,9500,7052,66771,71151,48446,73599,71151
48441,TX,12000,12784,8887,11553,6597,5178,6319,13180,7804.139072,8320,11137,57619,5693,-18282,7349,5693,63318,63312,39337,64968,63312
48443,TX,10188,12784,8887,11553,6597,5178,6110,12784,7103.359237,8320,11553,55126,5240,-19158,6632,5240,61297,60366,35968,61758,60366
48445,TX,9792,12784,8887,11553,6597,5178,6065,12784,8441.211649,8320,11553,56068,5240,-19158,6632,5240,60856,61308,36910,62700,61308
48447,TX,11268,12784,8887,11553,6597,5178,6235,12784,8823.455196,8320,11553,57926,5240,-19158,6632,5240,62502,63166,38768,64558,63166
48449,TX,9576,12784,8887,11553,6597,5178,6040,13084,8154.52899,8320,11547,55860,5240,-19158,6632,5240,60615,61100,36702,62492,61100
48451,TX,12156,12784,8887,11553,6597,5178,6337,13158,7708.578185,8320,11231,57751,5693,-18282,7349,5693,63492,63444,39469,65100,63444
48453,TX,17448,12784,8887,11553,6597,5178,6947,16518,8727.894309,8320,12367,68558,7958,-13901,10934,7958,69394,76516,54657,79492,76516
48455,TX,11268,12784,8887,11553,6597,5178,6235,13714,8090.821732,8320,9864,56435,5240,-19158,6632,5240,62502,61675,37277,63067,61675
48457,TX,11268,12784,8887,11553,6597,5178,6235,12784,8281.943505,8320,11553,57385,5240,-19158,6632,5240,62502,62625,38227,64017,62625
48459,TX,11928,12784,8887,11553,6597,5178,6311,13517,8281.943505,8320,11312,58537,5693,-18282,7349,5693,63238,64230,40255,65886,64230
48461,TX,10368,12784,8887,11553,6597,5178,6131,12784,8154.52899,8320,11553,56358,5240,-19158,6632,5240,61498,61598,37200,62990,61598
48463,TX,10500,12784,8887,11553,6597,5178,6146,12758,7230.773752,8320,10735,54722,5240,-19158,6632,5240,61645,59962,35564,61354,59962
48465,TX,11076,12784,8887,11553,6597,5178,6213,13213,6721.115691,8320,11635,56143,5693,-18282,7349,5693,62288,61836,37861,63492,61836
48467,TX,11244,12784,8887,11553,6597,5178,6232,12784,8632.333423,8320,11553,57711,5240,-19158,6632,5240,62475,62951,38553,64343,62951
48469,TX,10920,12784,8887,11553,6597,5178,6195,13723,7644.870928,8320,11587,57373,5693,-18282,7349,5693,62114,63066,39091,64722,63066
48471,TX,11640,12784,8887,11553,6597,5178,6278,15088,8377.504392,8320,9723,58327,5693,-18282,7349,5693,62917,64020,40045,65676,64020
48473,TX,15168,12784,8887,11553,6597,5178,6684,14980,9524.235031,8320,12099,65269,7052,-15653,9500,7052,66851,72321,49616,74769,72321
48475,TX,9516,12784,8887,11553,6597,5178,6033,12784,7995.260845,8320,11553,55346,5240,-19158,6632,5240,60548,60586,36188,61978,60586
48477,TX,11172,12784,8887,11553,6597,5178,6224,13755,8154.52899,8320,11178,57757,5693,-18282,7349,5693,62395,63450,39475,65106,63450
48479,TX,12252,12784,8887,11553,6597,5178,6348,13909,6625.554804,8320,11813,58098,6146,-17406,8066,6146,63599,64244,40692,66164,64244
48481,TX,11160,12784,8887,11553,6597,5178,6222,13165,7485.602783,8320,11331,56640,5693,-18282,7349,5693,62381,62333,38358,63989,62333
48483,TX,10980,12784,8887,11553,6597,5178,6201,12784,8919.016082,8320,11553,57734,5240,-19158,6632,5240,62180,62974,38576,64366,62974
48485,TX,12108,12784,8887,11553,6597,5178,6331,13178,7963.407216,8320,11183,57931,5693,-18282,7349,5693,63438,63624,39649,65280,63624
48487,TX,10944,12784,8887,11553,6597,5178,6197,11601,8090.821732,8320,10886,55021,4787,-19939,5915,4787,62140,59808,35082,60936,59808
48489,TX,10236,12784,8887,11553,6597,5178,6116,12182,6370.725773,8320,10324,52611,4787,-19939,5915,4787,61351,57398,32672,58526,57398
48491,TX,17448,12784,8887,11553,6597,5178,6947,14843,8568.626165,8320,12324,66682,7505,-14777,10217,7505,69394,74187,51905,76899,74187
48493,TX,13404,12784,8887,11553,6597,5178,6481,14466,8058.968103,8320,11797,61224,6599,-16530,8783,6599,64884,67823,44694,70007,67823
48495,TX,11268,12784,8887,11553,6597,5178,6235,12784,8250.089876,8320,11553,57353,5240,-19158,6632,5240,62502,62593,38195,63985,62593
48497,TX,11880,12784,8887,11553,6597,5178,6305,14714,9046.430598,8320,11997,61136,6146,-17406,8066,6146,63184,67282,43730,69202,67282
48499,TX,10692,12784,8887,11553,6597,5178,6168,12784,8727.894309,8320,11553,57255,5240,-19158,6632,5240,61859,62495,38097,63887,62495
48501,TX,10608,12784,8887,11553,6597,5178,6159,12784,9173.845113,8320,11553,57617,5240,-19158,6632,5240,61766,62857,38459,64249,62857
48503,TX,11280,12784,8887,11553,6597,5178,6236,12784,8090.821732,8320,11553,57206,5693,-18282,7349,5693,62515,62899,38924,64555,62899
48505,TX,9516,12784,8887,11553,6597,5178,6033,13576,6784.822948,8320,10707,54082,5240,-19158,6632,5240,60548,59322,34924,60714,59322
48507,TX,11268,12784,8887,11553,6597,5178,6235,12784,6784.822948,8320,11553,55888,5240,-19158,6632,5240,62502,61128,36730,62520,61128
49001,UT,10356,10636,10607,9970,5285,5250,8735,10636,10493.13805,7957,9970,54662,6888,-17838,8016,6888,60839,61550,36824,62678,61550
49003,UT,11016,10636,10607,9970,5285,5250,8844,10238,11063.41729,7957,10992,56517,7441,-16957,8833,7441,61608,63958,39560,65350,63958
49005,UT,11004,10636,10607,9970,5285,5250,8842,11212,10417.10081,7957,10470,56310,7441,-16957,8833,7441,61594,63751,39353,65143,63751
49007,UT,9312,10636,10607,9970,5285,5250,8562,10331,10797.28698,7957,9679,53327,6335,-18391,7199,6335,59622,59662,34936,60526,59662
49009,UT,11532,10636,10607,9970,5285,5250,8929,10636,11785.77099,7957,9970,57131,6888,-17838,8016,6888,62209,64019,39293,65147,64019
49011,UT,13068,10636,10607,9970,5285,5250,9183,11741,10379.0822,7957,11092,59487,7994,-15981,9650,7994,63999,67481,43506,69137,67481
49013,UT,11880,10636,10607,9970,5285,5250,8986,10636,10265.02635,7957,9970,55958,7441,-16957,8833,7441,62614,63399,39001,64791,63399
49015,UT,9312,10636,10607,9970,5285,5250,8562,10636,10341.06358,7957,9970,53466,6335,-18391,7199,6335,59622,59801,35075,60665,59801
49017,UT,9792,10636,10607,9970,5285,5250,8641,10636,10493.13805,7957,9970,54098,6888,-17838,8016,6888,60181,60986,36260,62114,60986
49019,UT,12372,10636,10607,9970,5285,5250,9068,10636,11671.71515,7957,9970,57857,7441,-16957,8833,7441,63188,65298,40900,66690,65298
49021,UT,10536,10636,10607,9970,5285,5250,8764,11672,10683.23113,7957,9845,55944,6888,-17838,8016,6888,61048,62832,38106,63960,62832
49023,UT,12648,10636,10607,9970,5285,5250,9113,9821,10265.02635,7957,10918,56859,7441,-16957,8833,7441,63509,64300,39902,65692,64300
49025,UT,13968,10636,10607,9970,5285,5250,9331,10636,11139.45452,7957,9970,58920,7994,-15981,9650,7994,65047,66914,42939,68570,66914
49027,UT,11016,10636,10607,9970,5285,5250,8844,10636,10227.00773,7957,9970,55056,6888,-17838,8016,6888,61608,61944,37218,63072,61944
49029,UT,13068,10636,10607,9970,5285,5250,9183,10964,10227.00773,7957,10938,58404,7994,-15981,9650,7994,63999,66398,42423,68054,66398
49031,UT,11640,10636,10607,9970,5285,5250,8947,10636,10417.10081,7957,9970,55870,7441,-16957,8833,7441,62335,63311,38913,64703,63311
49033,UT,11760,10636,10607,9970,5285,5250,8966,10636,10303.04497,7957,9970,55876,7441,-16957,8833,7441,62474,63317,38919,64709,63317
49035,UT,14988,10636,10607,9970,5285,5250,9500,12705,10188.98912,7957,11156,62245,9100,-14029,11284,9100,66236,71345,48216,73529,71345
49037,UT,10092,10636,10607,9970,5285,5250,8691,10636,11443.60345,7957,9970,55349,6888,-17838,8016,6888,60531,62237,37511,63365,62237
49039,UT,9516,10636,10607,9970,5285,5250,8596,10636,10455.11943,7957,9970,53784,6335,-18391,7199,6335,59860,60119,35393,60983,60119
49041,UT,9660,10636,10607,9970,5285,5250,8620,10636,10341.06358,7957,9970,53814,6888,-17838,8016,6888,60028,60702,35976,61830,60702
49043,UT,15216,10636,10607,9970,5285,5250,9537,14225,13458.5901,7957,11037,67144,9653,-13052,12101,9653,66501,76797,54092,79245,76797
49045,UT,11880,10636,10607,9970,5285,5250,8986,10697,10607.19389,7957,10999,57390,7441,-16957,8833,7441,62614,64831,40433,66223,64831
49047,UT,14724,10636,10607,9970,5285,5250,9456,11340,11101.4359,7957,10830,61203,8547,-15005,10467,8547,65928,69750,46198,71670,69750
49049,UT,12648,10636,10607,9970,5285,5250,9113,12434,10074.93327,7957,11096,59460,7994,-15981,9650,7994,63509,67454,43479,69110,67454
49051,UT,14868,10636,10607,9970,5285,5250,9480,11847,11823.78961,7957,11104,62850,8547,-15005,10467,8547,66096,71397,47845,73317,71397
49053,UT,12396,10636,10607,9970,5285,5250,9072,11576,10455.11943,7957,9957,57591,7441,-16957,8833,7441,63216,65032,40634,66424,65032
49055,UT,10620,10636,10607,9970,5285,5250,8778,10636,11101.4359,7957,9970,55534,6888,-17838,8016,6888,61146,62422,37696,63550,62422
49057,UT,13068,10636,10607,9970,5285,5250,9183,11462,9884.840189,7957,11097,58719,7994,-15981,9650,7994,63999,66713,42738,68369,66713
50001,VT,14472,18051,10321,9258,6033,4819,9341,18051,13909.55892,14405,9258,74915,11446,-9990,14686,11446,72295,86361,64925,89601,86361
50003,VT,12672,18051,10321,9258,6033,4819,9069,20890,11098.05233,14405,8847,72731,11446,-9990,14686,11446,70223,84177,62741,87417,84177
50005,VT,10128,18051,10321,9258,6033,4819,8686,18051,12799.75369,14405,9258,69461,10340,-11942,13052,10340,67296,79801,57519,82513,79801
50007,VT,19668,18051,10321,9258,6033,4819,10124,16592,12096.87704,14405,9692,77273,12552,-8037,16320,12552,78274,89825,69236,93593,89825
50009,VT,10068,18051,10321,9258,6033,4819,8677,17135,12392.8251,14405,8494,67313,9787,-12918,12235,9787,67227,77100,54395,79548,77100
50011,VT,19668,18051,10321,9258,6033,4819,10124,16220,12947.72772,14405,9667,77726,12552,-8037,16320,12552,78274,90278,69689,94046,90278
50013,VT,19668,18051,10321,9258,6033,4819,10124,20125,11467.98741,14405,9679,80165,14138,-5155,17984,14138,78274,94303,75010,98149,94303
50015,VT,16428,18051,10321,9258,6033,4819,9635,18051,13761.58489,14405,9258,76723,11999,-9014,15503,11999,74545,88722,67709,92226,88722
50017,VT,12168,18051,10321,9258,6033,4819,8993,24083,13391.64981,14405,9078,77944,12552,-8037,16320,12552,69643,90496,69907,94264,90496
50019,VT,10620,18051,10321,9258,6033,4819,8760,18051,12170.86406,14405,9258,69324,10340,-11942,13052,10340,67862,79664,57382,82376,79664
50021,VT,12324,18051,10321,9258,6033,4819,9017,16273,11098.05233,14405,8878,67797,10340,-11942,13052,10340,69823,78137,55855,80849,78137
50023,VT,13704,18051,10321,9258,6033,4819,9225,21842,13613.61086,14405,9159,77543,12552,-8037,16320,12552,71411,90095,69506,93863,90095
50025,VT,12636,18051,10321,9258,6033,4819,9064,18051,13095.70175,14405,9258,72265,10893,-10966,13869,10893,70182,83158,61299,86134,83158
50027,VT,13452,18051,10321,9258,6033,4819,9187,20517,13946.55243,14405,9068,76207,11999,-9014,15503,11999,71121,88206,67193,91710,88206
51001,VA,10968,7312,8887,11553,6594,5178,8490,7312,8759.747938,8896,11553,52667,560,-24166,1424,560,58982,53227,28501,54091,53227
51003,VA,15396,7312,8887,11553,6594,5178,9133,7394,9906.478577,8896,11376,58147,1608,-22790,3000,1608,64053,59755,35357,61147,59755
51005,VA,10908,7312,8887,11553,6594,5178,8481,7312,9237.552371,8896,11553,53085,560,-24166,1424,560,58913,53645,28919,54509,53645
51007,VA,15528,7312,8887,11553,6594,5178,9152,8096,9269.406,8896,11717,58684,2132,-21843,3788,2132,64204,60816,36841,62472,60816
51009,VA,10092,7312,8887,11553,6594,5178,8363,6659,8823.455196,8896,11158,50807,36,-24690,636,36,57979,50843,26117,51443,50843
51011,VA,10092,7312,8887,11553,6594,5178,8363,7340,8982.72334,8896,11152,51641,36,-24690,636,36,57979,51677,26951,52277,51677
51013,VA,23592,7312,8887,11553,6594,5178,10323,7459,11722.13542,8896,13864,70711,4228,-18054,6940,4228,73439,74939,52657,77651,74939
51015,VA,11376,7312,8887,11553,6594,5178,8549,7107,9110.137856,8896,11126,52793,560,-24166,1424,560,59449,53353,28627,54217,53353
51017,VA,9540,7312,8887,11553,6594,5178,8283,7312,9173.845113,8896,11553,51653,36,-24690,636,36,57347,51689,26963,52289,51689
51019,VA,10092,7312,8887,11553,6594,5178,8363,7310,9651.649546,8896,11150,52278,36,-24690,636,36,57979,52314,27588,52914,52314
51021,VA,9216,7312,8887,11553,6594,5178,8236,7312,8823.455196,8896,11553,50978,36,-24690,636,36,56976,51014,26288,51614,51014
51023,VA,11316,7312,8887,11553,6594,5178,8540,7518,9683.503175,8896,11144,53736,560,-24166,1424,560,59380,54296,29570,55160,54296
51025,VA,9216,7312,8887,11553,6594,5178,8236,7312,8441.211649,8896,11553,50596,36,-24690,636,36,56976,50632,25906,51232,50632
51027,VA,9216,7312,8887,11553,6594,5178,8236,7312,8568.626165,8896,11553,50724,36,-24690,636,36,56976,50760,26034,51360,50760
51029,VA,11436,7312,8887,11553,6594,5178,8558,7493,9396.820515,8896,11404,53804,560,-24166,1424,560,59518,54364,29638,55228,54364
51031,VA,10092,7312,8887,11553,6594,5178,8363,7923,8727.894309,8896,11144,51960,560,-24166,1424,560,57979,52520,27794,53384,52520
51033,VA,15528,7312,8887,11553,6594,5178,9152,7049,9014.576969,8896,11701,57366,1608,-22790,3000,1608,64204,58974,34576,60366,58974
51035,VA,10020,7312,8887,11553,6594,5178,8352,7312,8568.626165,8896,11553,51528,36,-24690,636,36,57896,51564,26838,52164,51564
51036,VA,15528,7312,8887,11553,6594,5178,9152,6738,9556.08866,8896,11710,57606,1608,-22790,3000,1608,64204,59214,34816,60606,59214
51037,VA,10020,7312,8887,11553,6594,5178,8352,7312,8759.747938,8896,11553,51719,36,-24690,636,36,57896,51755,27029,52355,51755
51041,VA,15528,7312,8887,11553,6594,5178,9152,6720,9428.674144,8896,11719,57469,1608,-22790,3000,1608,64204,59077,34679,60469,59077
51043,VA,23592,7312,8887,11553,6594,5178,10323,9493,9842.771319,8896,13104,70106,4752,-17107,7728,4752,73439,74858,52999,77834,74858
51045,VA,11316,7312,8887,11553,6594,5178,8540,6936,9333.113258,8896,11162,52821,560,-24166,1424,560,59380,53381,28655,54245,53381
51047,VA,14568,7312,8887,11553,6594,5178,9013,7051,8696.04068,8896,13141,57530,1608,-22790,3000,1608,63105,59138,34740,60530,59138
51049,VA,15528,7312,8887,11553,6594,5178,9152,7312,8950.869711,8896,11553,57418,1608,-22790,3000,1608,64204,59026,34628,60418,59026
51051,VA,9216,7312,8887,11553,6594,5178,8236,7040,8759.747938,8896,10011,49102,-227,-24953,241,-227,56976,48875,24149,49343,48875
51053,VA,15528,7312,8887,11553,6594,5178,9152,6894,8696.04068,8896,11709,56901,1608,-22790,3000,1608,64204,58509,34111,59901,58509
51057,VA,12432,7312,8887,11553,6594,5178,8702,7312,9110.137856,8896,11553,54481,1084,-23642,2212,1084,60658,55565,30839,56693,55565
51059,VA,23592,7312,8887,11553,6594,5178,10323,6943,10925.7947,8896,13440,68975,4228,-18054,6940,4228,73439,73203,50921,75915,73203
51061,VA,23592,7312,8887,11553,6594,5178,10323,7004,10957.64833,8896,13117,68745,4228,-18054,6940,4228,73439,72973,50691,75685,72973
51063,VA,9216,7312,8887,11553,6594,5178,8236,6802,9141.991484,8896,11022,50257,36,-24690,636,36,56976,50293,25567,50893,50293
51065,VA,15396,7312,8887,11553,6594,5178,9133,7459,9906.478577,8896,11401,58236,1608,-22790,3000,1608,64053,59844,35446,61236,59844
51067,VA,9456,7312,8887,11553,6594,5178,8270,7507,9046.430598,8896,11140,51224,36,-24690,636,36,57250,51260,26534,51860,51260
51069,VA,13116,7312,8887,11553,6594,5178,8802,6825,8855.308825,8896,11454,54324,1084,-23642,2212,1084,61442,55408,30682,56536,55408
51071,VA,10788,7312,8887,11553,6594,5178,8464,7539,9460.527773,8896,11005,52866,560,-24166,1424,560,58776,53426,28700,54290,53426
51073,VA,18744,7312,8887,11553,6594,5178,9619,6910,9396.820515,8896,11845,60971,2656,-20896,4576,2656,67887,63627,40075,65547,63627
51075,VA,15528,7312,8887,11553,6594,5178,9152,6947,9619.795917,8896,11711,57879,1608,-22790,3000,1608,64204,59487,35089,60879,59487
51077,VA,9768,7312,8887,11553,6594,5178,8316,7312,8950.869711,8896,11553,51658,36,-24690,636,36,57608,51694,26968,52294,51694
51079,VA,15396,7312,8887,11553,6594,5178,9133,9269,9747.210433,8896,11400,59887,2132,-21843,3788,2132,64053,62019,38044,63675,62019
51081,VA,10908,7312,8887,11553,6594,5178,8481,7312,8473.065278,8896,11553,52320,560,-24166,1424,560,58913,52880,28154,53744,52880
51083,VA,9444,7312,8887,11553,6594,5178,8269,7312,8536.772536,8896,11553,50920,36,-24690,636,36,57237,50956,26230,51556,50956
51085,VA,15528,7312,8887,11553,6594,5178,9152,8004,9428.674144,8896,11713,58748,2132,-21843,3788,2132,64204,60880,36905,62536,60880
51087,VA,15528,7312,8887,11553,6594,5178,9152,6686,9428.674144,8896,11730,57446,1608,-22790,3000,1608,64204,59054,34656,60446,59054
51089,VA,9516,7312,8887,11553,6594,5178,8279,6942,8664.187051,8896,9908,49104,-227,-24953,241,-227,57319,48877,24151,49345,48877
51091,VA,10908,7312,8887,11553,6594,5178,8481,7312,9046.430598,8896,11553,52893,560,-24166,1424,560,58913,53453,28727,54317,53453
51093,VA,18744,7312,8887,11553,6594,5178,9619,6995,9524.235031,8896,11835,61173,2656,-20896,4576,2656,67887,63829,40277,65749,63829
51095,VA,18744,7312,8887,11553,6594,5178,9619,7473,11594.72091,8896,11850,63736,2656,-20896,4576,2656,67887,66392,42840,68312,66392
51097,VA,15528,7312,8887,11553,6594,5178,9152,7312,9715.356804,8896,11553,58182,1608,-22790,3000,1608,64204,59790,35392,61182,59790
51099,VA,15264,7312,8887,11553,6594,5178,9114,7312,9428.674144,8896,11553,57632,1608,-22790,3000,1608,63902,59240,34842,60632,59240
51101,VA,15528,7312,8887,11553,6594,5178,9152,6625,9619.795917,8896,11719,57566,1608,-22790,3000,1608,64204,59174,34776,60566,59174
51103,VA,11988,7312,8887,11553,6594,5178,8638,7312,9428.674144,8896,11553,54356,560,-24166,1424,560,60150,54916,30190,55780,54916
51105,VA,9216,7312,8887,11553,6594,5178,8236,7312,8504.918907,8896,11553,50660,36,-24690,636,36,56976,50696,25970,51296,50696
51107,VA,23592,7312,8887,11553,6594,5178,10323,7244,10639.11204,8896,13289,68838,4228,-18054,6940,4228,73439,73066,50784,75778,73066
51109,VA,12684,7312,8887,11553,6594,5178,8739,7312,9205.698742,8896,11553,54829,1084,-23642,2212,1084,60947,55913,31187,57041,55913
51111,VA,9216,7312,8887,11553,6594,5178,8236,7312,8441.211649,8896,11553,50596,36,-24690,636,36,56976,50632,25906,51232,50632
51113,VA,12096,7312,8887,11553,6594,5178,8654,7312,8919.016082,8896,11553,53954,560,-24166,1424,560,60274,54514,29788,55378,54514
51115,VA,18744,7312,8887,11553,6594,5178,9619,7744,9747.210433,8896,11846,62156,2656,-20896,4576,2656,67887,64812,41260,66732,64812
51117,VA,9780,7312,8887,11553,6594,5178,8317,7312,8473.065278,8896,11553,51192,36,-24690,636,36,57621,51228,26502,51828,51228
51119,VA,11124,7312,8887,11553,6594,5178,8513,7312,9970.185835,8896,11553,54033,560,-24166,1424,560,59161,54593,29867,55457,54593
51121,VA,12024,7312,8887,11553,6594,5178,8643,7050,10161.30761,8896,10967,54276,560,-24166,1424,560,60191,54836,30110,55700,54836
51125,VA,15396,7312,8887,11553,6594,5178,9133,7400,9524.235031,8896,11400,57794,1608,-22790,3000,1608,64053,59402,35004,60794,59402
51127,VA,15528,7312,8887,11553,6594,5178,9152,7654,9619.795917,8896,11709,58585,1608,-22790,3000,1608,64204,60193,35795,61585,60193
51131,VA,10584,7312,8887,11553,6594,5178,8434,7312,9301.259629,8896,11553,52824,560,-24166,1424,560,58542,53384,28658,54248,53384
51133,VA,11640,7312,8887,11553,6594,5178,8587,7312,9492.381402,8896,11553,54071,560,-24166,1424,560,59751,54631,29905,55495,54631
51135,VA,11820,7312,8887,11553,6594,5178,8614,7312,8473.065278,8896,11553,53232,560,-24166,1424,560,59958,53792,29066,54656,53792
51137,VA,12972,7312,8887,11553,6594,5178,8781,7312,9333.113258,8896,11553,55244,1084,-23642,2212,1084,61277,56328,31602,57456,56328
51139,VA,9744,7312,8887,11553,6594,5178,8312,7312,8823.455196,8896,11553,51506,36,-24690,636,36,57580,51542,26816,52142,51542
51141,VA,9480,7312,8887,11553,6594,5178,8274,7312,8982.72334,8896,11553,51402,36,-24690,636,36,57278,51438,26712,52038,51438
51143,VA,10488,7312,8887,11553,6594,5178,8420,6664,8950.869711,8896,10157,50334,36,-24690,636,36,58432,50370,25644,50970,50370
51145,VA,15528,7312,8887,11553,6594,5178,9152,7548,9237.552371,8896,11717,58105,1608,-22790,3000,1608,64204,59713,35315,61105,59713
51147,VA,10896,7312,8887,11553,6594,5178,8479,7312,8536.772536,8896,11553,52372,560,-24166,1424,560,58899,52932,28206,53796,52932
51149,VA,15528,7312,8887,11553,6594,5178,9152,8022,8473.065278,8896,11706,57803,2132,-21843,3788,2132,64204,59935,35960,61591,59935
51153,VA,23592,7312,8887,11553,6594,5178,10323,7094,9524.235031,8896,13290,67575,4228,-18054,6940,4228,73439,71803,49521,74515,71803
51155,VA,9444,7312,8887,11553,6594,5178,8269,9461,9046.430598,8896,10966,52992,560,-24166,1424,560,57237,53552,28826,54416,53552
51157,VA,17436,7312,8887,11553,6594,5178,9429,7004,9524.235031,8896,13035,61073,2656,-20896,4576,2656,66389,63729,40177,65649,63729
51159,VA,12708,7312,8887,11553,6594,5178,8743,7312,9078.284227,8896,11553,54725,1084,-23642,2212,1084,60975,55809,31083,56937,55809
51161,VA,11316,7312,8887,11553,6594,5178,8540,7610,9715.356804,8896,11100,53815,560,-24166,1424,560,59380,54375,29649,55239,54375
51163,VA,9540,7312,8887,11553,6594,5178,8283,7312,9014.576969,8896,11553,51494,36,-24690,636,36,57347,51530,26804,52130,51530
51165,VA,11280,7312,8887,11553,6594,5178,8535,7082,8696.04068,8896,11419,52551,560,-24166,1424,560,59339,53111,28385,53975,53111
51167,VA,10176,7312,8887,11553,6594,5178,8375,7312,8823.455196,8896,11553,51938,560,-24166,1424,560,58075,52498,27772,53362,52498
51169,VA,9684,7312,8887,11553,6594,5178,8303,7349,9014.576969,8896,10339,50461,36,-24690,636,36,57511,50497,25771,51097,50497
51171,VA,11664,7312,8887,11553,6594,5178,8591,7312,9078.284227,8896,11553,53681,560,-24166,1424,560,59779,54241,29515,55105,54241
51173,VA,9228,7312,8887,11553,6594,5178,8237,7312,8568.626165,8896,11553,50736,36,-24690,636,36,56989,50772,26046,51372,50772
51175,VA,11184,7312,8887,11553,6594,5178,8521,7312,9110.137856,8896,11553,53233,560,-24166,1424,560,59229,53793,29067,54657,53793
51177,VA,23592,7312,8887,11553,6594,5178,10323,6798,8600.479794,8896,13128,66192,4228,-18054,6940,4228,73439,70420,48138,73132,70420
51179,VA,23592,7312,8887,11553,6594,5178,10323,7202,9110.137856,8896,13149,67127,4228,-18054,6940,4228,73439,71355,49073,74067,71355
51181,VA,18744,7312,8887,11553,6594,5178,9619,7312,9173.845113,8896,11553,60857,2656,-20896,4576,2656,67887,63513,39961,65433,63513
51183,VA,15528,7312,8887,11553,6594,5178,9152,7280,9301.259629,8896,11718,57902,1608,-22790,3000,1608,64204,59510,35112,60902,59510
51185,VA,9360,7312,8887,11553,6594,5178,8256,8746,8568.626165,8896,9975,50724,36,-24690,636,36,57140,50760,26034,51360,50760
51187,VA,15564,7312,8887,11553,6594,5178,9157,6807,9842.771319,8896,13167,59455,2132,-21843,3788,2132,64245,61587,37612,63243,61587
51191,VA,9684,7312,8887,11553,6594,5178,8303,7295,8664.187051,8896,10274,49991,36,-24690,636,36,57511,50027,25301,50627,50027
51193,VA,10848,7312,8887,11553,6594,5178,8472,7312,9460.527773,8896,11553,53248,560,-24166,1424,560,58844,53808,29082,54672,53808
51195,VA,9216,7312,8887,11553,6594,5178,8236,7146,8887.162454,8896,9984,49307,-227,-24953,241,-227,56976,49080,24354,49548,49080
51197,VA,9516,7312,8887,11553,6594,5178,8279,7312,9301.259629,8896,11553,51756,36,-24690,636,36,57319,51792,27066,52392,51792
51199,VA,18744,7312,8887,11553,6594,5178,9619,7087,9715.356804,8896,11855,61475,2656,-20896,4576,2656,67887,64131,40579,66051,64131
51510,VA,23592,7312,8887,11553,6594,5178,10323,6602,11976.96445,8896,13818,70062,4228,-18054,6940,4228,73439,74290,52008,77002,74290
51515,VA,10092,7312,8887,11553,6594,5178,8363,7704,9269.406,8896,11089,52228,36,-24690,636,36,57979,52264,27538,52864,52264
51520,VA,9684,7312,8887,11553,6594,5178,8303,8215,8982.72334,8896,10203,51158,36,-24690,636,36,57511,51194,26468,51794,51194
51530,VA,9540,7312,8887,11553,6594,5178,8283,7312,9110.137856,8896,11553,51589,36,-24690,636,36,57347,51625,26899,52225,51625
51540,VA,15396,7312,8887,11553,6594,5178,9133,6839,11403.59913,8896,11337,59050,1608,-22790,3000,1608,64053,60658,36260,62050,60658
51550,VA,18744,7312,8887,11553,6594,5178,9619,6769,9173.845113,8896,11871,60632,2656,-20896,4576,2656,67887,63288,39736,65208,63288
51560,VA,10908,7312,8887,11553,6594,5178,8481,7312,8887,8896,11553,52734,560,-24166,1424,560,58913,53294,28568,54158,53294
51570,VA,15528,7312,8887,11553,6594,5178,9152,7281,9173.845113,8896,11722,57779,1608,-22790,3000,1608,64204,59387,34989,60779,59387
51580,VA,10908,7312,8887,11553,6594,5178,8481,7312,8600.479794,8896,11553,52447,560,-24166,1424,560,58913,53007,28281,53871,53007
51590,VA,10488,7312,8887,11553,6594,5178,8420,6902,7963.407216,8896,10014,49441,36,-24690,636,36,58432,49477,24751,50077,49477
51595,VA,10908,7312,8887,11553,6594,5178,8481,7312,8377.504392,8896,11553,52225,560,-24166,1424,560,58913,52785,28059,53649,52785
51600,VA,23592,7312,8887,11553,6594,5178,10323,6698,12327.35437,8896,13436,70127,4228,-18054,6940,4228,73439,74355,52073,77067,74355
51610,VA,23592,7312,8887,11553,6594,5178,10323,7992,11116.91647,8896,13614,70389,4752,-17107,7728,4752,73439,75141,53282,78117,75141
51620,VA,11184,7312,8887,11553,6594,5178,8521,7312,9046.430598,8896,11553,53169,560,-24166,1424,560,59229,53729,29003,54593,53729
51630,VA,23592,7312,8887,11553,6594,5178,10323,9575,10575.40478,8896,13367,71183,4752,-17107,7728,4752,73439,75935,54076,78911,75935
51640,VA,10020,7312,8887,11553,6594,5178,8352,7312,8823.455196,8896,11553,51782,36,-24690,636,36,57896,51818,27092,52418,51818
51650,VA,18744,7312,8887,11553,6594,5178,9619,6933,9078.284227,8896,11887,60716,2656,-20896,4576,2656,67887,63372,39820,65292,63372
51660,VA,11280,7312,8887,11553,6594,5178,8535,6733,9046.430598,8896,11397,52530,560,-24166,1424,560,59339,53090,28364,53954,53090
51670,VA,15528,7312,8887,11553,6594,5178,9152,7848,9173.845113,8896,11728,58352,2132,-21843,3788,2132,64204,60484,36509,62140,60484
51678,VA,9540,7312,8887,11553,6594,5178,8283,7312,9173.845113,8896,11553,51653,36,-24690,636,36,57347,51689,26963,52289,51689
51680,VA,10092,7312,8887,11553,6594,5178,8363,7887,9110.137856,8896,11094,52257,560,-24166,1424,560,57979,52817,28091,53681,52817
51683,VA,23592,7312,8887,11553,6594,5178,10323,7010,8664.187051,8896,13407,66747,4228,-18054,6940,4228,73439,70975,48693,73687,70975
51685,VA,23592,7312,8887,11553,6594,5178,10323,6675,9556.08866,8896,13378,67276,4228,-18054,6940,4228,73439,71504,49222,74216,71504
51690,VA,9516,7312,8887,11553,6594,5178,8279,8899,8504.918907,8896,9793,50787,36,-24690,636,36,57319,50823,26097,51423,50823
51700,VA,18744,7312,8887,11553,6594,5178,9619,9588,8791.601567,8896,11892,63090,3180,-19949,5364,3180,67887,66270,43141,68454,66270
51710,VA,18744,7312,8887,11553,6594,5178,9619,8000,9141.991484,8896,11926,61885,2656,-20896,4576,2656,67887,64541,40989,66461,64541
51720,VA,9216,7312,8887,11553,6594,5178,8236,7428,8855.308825,8896,9863,49437,-227,-24953,241,-227,56976,49210,24484,49678,49210
51730,VA,15528,7312,8887,11553,6594,5178,9152,7790,8887.162454,8896,11731,58010,2132,-21843,3788,2132,64204,60142,36167,61798,60142
51735,VA,18744,7312,8887,11553,6594,5178,9619,6906,9046.430598,8896,11843,60613,2656,-20896,4576,2656,67887,63269,39717,65189,63269
51740,VA,18744,7312,8887,11553,6594,5178,9619,7253,9301.259629,8896,11894,61267,2656,-20896,4576,2656,67887,63923,40371,65843,63923
51750,VA,12024,7312,8887,11553,6594,5178,8643,8500,9715.356804,8896,10909,55223,1084,-23642,2212,1084,60191,56307,31581,57435,56307
51760,VA,15528,7312,8887,11553,6594,5178,9152,8401,10766.52656,8896,11760,60530,2132,-21843,3788,2132,64204,62662,38687,64318,62662
51770,VA,11316,7312,8887,11553,6594,5178,8540,6529,8791.601567,8896,11046,51756,36,-24690,636,36,59380,51792,27066,52392,51792
51775,VA,11316,7312,8887,11553,6594,5178,8540,7670,9364.966886,8896,11078,53503,560,-24166,1424,560,59380,54063,29337,54927,54063
51790,VA,11376,7312,8887,11553,6594,5178,8549,7817,9492.381402,8896,11061,53820,560,-24166,1424,560,59449,54380,29654,55244,54380
51800,VA,18744,7312,8887,11553,6594,5178,9619,6961,9460.527773,8896,11860,61100,2656,-20896,4576,2656,67887,63756,40204,65676,63756
51810,VA,18744,7312,8887,11553,6594,5178,9619,6987,9715.356804,8896,11892,61413,2656,-20896,4576,2656,67887,64069,40517,65989,64069
51820,VA,11376,7312,8887,11553,6594,5178,8549,7833,9396.820515,8896,11058,53738,560,-24166,1424,560,59449,54298,29572,55162,54298
51830,VA,18744,7312,8887,11553,6594,5178,9619,7466,10256.86849,8896,11888,62429,2656,-20896,4576,2656,67887,65085,41533,67005,65085
51840,VA,13116,7312,8887,11553,6594,5178,8802,7144,9428.674144,8896,11438,55201,1084,-23642,2212,1084,61442,56285,31559,57413,56285
53001,WA,10668,14727,10607,9970,5614,5250,6630,14023,10721.24974,7489,10133,58285,5693,-18282,7349,5693,63466,63978,40003,65634,63978
53003,WA,10236,14727,10607,9970,5614,5250,6580,13911,9960.877421,7489,9440,56286,5240,-19158,6632,5240,62984,61526,37128,62918,61526
53005,WA,12084,14727,10607,9970,5614,5250,6793,15279,10227.00773,7489,10361,60690,6146,-17406,8066,6146,65045,66836,43284,68756,66836
53007,WA,12216,14727,10607,9970,5614,5250,6808,14805,12318.03162,7489,9952,62030,6146,-17406,8066,6146,65192,68176,44624,70096,68176
53009,WA,13008,14727,10607,9970,5614,5250,6900,14027,10949.36144,7489,9093,59816,5693,-18282,7349,5693,66076,65509,41534,67165,65509
53011,WA,16308,14727,10607,9970,5614,5250,7280,16205,10683.23113,7489,10018,65954,7052,-15653,9500,7052,69756,73006,50301,75454,73006
53013,WA,10968,14727,10607,9970,5614,5250,6665,12287,10531.15666,7489,9539,56064,5240,-19158,6632,5240,63801,61304,36906,62696,61304
53015,WA,12072,14727,10607,9970,5614,5250,6792,14584,10949.36144,7489,9457,59801,5693,-18282,7349,5693,65032,65494,41519,67150,65494
53017,WA,12216,14727,10607,9970,5614,5250,6808,15032,10341.06358,7489,9952,60280,6146,-17406,8066,6146,65192,66426,42874,68346,66426
53019,WA,11256,14727,10607,9970,5614,5250,6698,14727,10873.32421,7489,9970,59565,5693,-18282,7349,5693,64122,65258,41283,66914,65258
53021,WA,12084,14727,10607,9970,5614,5250,6793,14010,10493.13805,7489,10349,59675,5693,-18282,7349,5693,65045,65368,41393,67024,65368
53023,WA,9516,14727,10607,9970,5614,5250,6497,14727,10721.24974,7489,9970,57673,5240,-19158,6632,5240,62181,62913,38515,64305,62913
53025,WA,10704,14727,10607,9970,5614,5250,6634,14949,11291.52898,7489,9931,59615,5693,-18282,7349,5693,63506,65308,41333,66964,65308
53027,WA,11748,14727,10607,9970,5614,5250,6754,13198,12241.99439,7489,9199,59127,5240,-19158,6632,5240,64670,64367,39969,65759,64367
53029,WA,15840,14727,10607,9970,5614,5250,7226,15139,12432.08747,7489,9652,65803,6599,-16530,8783,6599,69234,72402,49273,74586,72402
53031,WA,13524,14727,10607,9970,5614,5250,6959,14727,14104.90658,7489,9970,65065,6146,-17406,8066,6146,66651,71211,47659,73131,71211
53033,WA,19860,14727,10607,9970,5614,5250,7689,20002,12241.99439,7489,10633,75477,8864,-12149,12368,8864,73717,84341,63328,87845,84341
53035,WA,16392,14727,10607,9970,5614,5250,7289,16276,11253.51037,7489,10314,66975,7505,-14777,10217,7505,69849,74480,52198,77192,74480
53037,WA,14052,14727,10607,9970,5614,5250,7020,15304,13268.49702,7489,9374,64738,6599,-16530,8783,6599,67240,71337,48208,73521,71337
53039,WA,9924,14727,10607,9970,5614,5250,6544,14727,11025.39867,7489,9970,58385,5240,-19158,6632,5240,62636,63625,39227,65017,63625
53041,WA,11556,14727,10607,9970,5614,5250,6732,14194,11367.56622,7489,9290,59147,5693,-18282,7349,5693,64456,64840,40865,66496,64840
53043,WA,9696,14727,10607,9970,5614,5250,6518,14727,10721.24974,7489,9970,57853,5240,-19158,6632,5240,62382,63093,38695,64485,63093
53045,WA,13380,14727,10607,9970,5614,5250,6942,14207,11405.58483,7489,9407,61138,6146,-17406,8066,6146,66490,67284,43732,69204,67284
53047,WA,9720,14727,10607,9970,5614,5250,6521,14727,10531.15666,7489,9970,57687,5240,-19158,6632,5240,62409,62927,38529,64319,62927
53049,WA,11160,14727,10607,9970,5614,5250,6687,14727,10987.38006,7489,9970,59583,5693,-18282,7349,5693,64015,65276,41301,66932,65276
53051,WA,10056,14727,10607,9970,5614,5250,6560,12547,10607.19389,7489,9571,55520,4787,-19939,5915,4787,62784,60307,35581,61435,60307
53053,WA,17664,14727,10607,9970,5614,5250,7436,16889,11177.47314,7489,10590,69059,7958,-13901,10934,7958,71268,77017,55158,79993,77017
53055,WA,13512,14727,10607,9970,5614,5250,6958,14727,10949.36144,7489,9970,61897,6146,-17406,8066,6146,66638,68043,44491,69963,68043
53057,WA,15300,14727,10607,9970,5614,5250,7164,15912,10873.32421,7489,9858,64682,7052,-15653,9500,7052,68632,71734,49029,74182,71734
53059,WA,16308,14727,10607,9970,5614,5250,7280,14001,10949.36144,7489,10017,64014,6599,-16530,8783,6599,69756,70613,47484,72797,70613
53061,WA,19860,14727,10607,9970,5614,5250,7689,18152,11443.60345,7489,10592,72787,8411,-13025,11651,8411,73717,81198,59762,84438,81198
53063,WA,12684,14727,10607,9970,5614,5250,6862,14519,10607.19389,7489,9503,60051,6146,-17406,8066,6146,65714,66197,42645,68117,66197
53065,WA,10680,14727,10607,9970,5614,5250,6631,13276,10797.28698,7489,9569,57061,5240,-19158,6632,5240,63479,62301,37903,63693,62301
53067,WA,16380,14727,10607,9970,5614,5250,7288,16153,11025.39867,7489,10332,66629,7505,-14777,10217,7505,69836,74134,51852,76846,74134
53069,WA,9516,14727,10607,9970,5614,5250,6497,14727,10949.36144,7489,9970,57901,5240,-19158,6632,5240,62181,63141,38743,64533,63141
53071,WA,11304,14727,10607,9970,5614,5250,6703,14310,11975.86407,7489,9508,59836,5693,-18282,7349,5693,64175,65529,41554,67185,65529
53073,WA,15372,14727,10607,9970,5614,5250,7172,16298,10531.15666,7489,9816,64756,7052,-15653,9500,7052,68712,71808,49103,74256,71808
53075,WA,12468,14727,10607,9970,5614,5250,6837,15785,12546.14332,7489,8806,62344,6146,-17406,8066,6146,65473,68490,44938,70410,68490
53077,WA,11724,14727,10607,9970,5614,5250,6752,13923,10569.17528,7489,9971,58926,5693,-18282,7349,5693,64644,64619,40644,66275,64619
54001,WV,9504,12528,8887,11553,4592,5178,8640,12528,8409.358021,10780,11553,57952,7783,-16192,9439,7783,60882,65735,41760,67391,65735
54003,WV,11484,12528,8887,11553,4592,5178,8947,12005,8504.918907,10780,11484,59436,7783,-16192,9439,7783,63169,67219,43244,68875,67219
54005,WV,8568,12528,8887,11553,4592,5178,8495,13147,8441.211649,10780,10871,56985,7205,-17193,8597,7205,59801,64190,39792,65582,64190
54007,WV,8568,12528,8887,11553,4592,5178,8495,12528,8473.065278,10780,11553,57080,7205,-17193,8597,7205,59801,64285,39887,65677,64285
54009,WV,9876,12528,8887,11553,4592,5178,8698,13089,8791.601567,10780,10647,58362,7783,-16192,9439,7783,61312,66145,42170,67801,66145
54011,WV,10188,12528,8887,11553,4592,5178,8746,13968,8504.918907,10780,10740,59359,7783,-16192,9439,7783,61672,67142,43167,68798,67142
54013,WV,8568,12528,8887,11553,4592,5178,8495,12528,8281.943505,10780,11553,56889,7205,-17193,8597,7205,59801,64094,39696,65486,64094
54015,WV,11388,12528,8887,11553,4592,5178,8932,14450,8504.918907,10780,10897,61198,8362,-15190,10282,8362,63058,69560,46008,71480,69560
54017,WV,8748,12528,8887,11553,4592,5178,8522,12000,8186.382618,10780,10915,55808,7205,-17193,8597,7205,60008,63013,38615,64405,63013
54019,WV,9216,12528,8887,11553,4592,5178,8595,13903,8504.918907,10780,10168,57750,7783,-16192,9439,7783,60549,65533,41558,67189,65533
54021,WV,8760,12528,8887,11553,4592,5178,8524,12528,8536.772536,10780,11553,57336,7205,-17193,8597,7205,60022,64541,40143,65933,64541
54023,WV,10356,12528,8887,11553,4592,5178,8772,12528,8600.479794,10780,11553,58995,7783,-16192,9439,7783,61866,66778,42803,68434,66778
54025,WV,9192,12528,8887,11553,4592,5178,8591,12528,8664.187051,10780,11553,57895,7783,-16192,9439,7783,60521,65678,41703,67334,65678
54027,WV,13116,12528,8887,11553,4592,5178,9200,11856,8504.918907,10780,11462,60896,8362,-15190,10282,8362,65054,69258,45706,71178,69258
54029,WV,9876,12528,8887,11553,4592,5178,8698,12340,9173.845113,10780,10627,57974,7205,-17193,8597,7205,61312,65179,40781,66571,65179
54031,WV,9060,12528,8887,11553,4592,5178,8571,12528,8823.455196,10780,11553,57922,7205,-17193,8597,7205,60369,65127,40729,66519,65127
54033,WV,11592,12528,8887,11553,4592,5178,8964,12598,8058.968103,10780,10882,59089,7783,-16192,9439,7783,63294,66872,42897,68528,66872
54035,WV,8808,12528,8887,11553,4592,5178,8532,12528,8441.211649,10780,11553,57288,7205,-17193,8597,7205,60078,64493,40095,65885,64493
54037,WV,14148,12528,8887,11553,4592,5178,9361,11704,8664.187051,10780,13094,63568,8940,-14189,11124,8940,66247,72508,49379,74692,72508
54039,WV,11388,12528,8887,11553,4592,5178,8932,10055,8536.772536,10780,10815,56752,7205,-17193,8597,7205,63058,63957,39559,65349,63957
54041,WV,9516,12528,8887,11553,4592,5178,8642,12528,8377.504392,10780,11553,57933,7783,-16192,9439,7783,60896,65716,41741,67372,65716
54043,WV,11388,12528,8887,11553,4592,5178,8932,15477,9906.478577,10780,10809,63538,8940,-14189,11124,8940,63058,72478,49349,74662,72478
54045,WV,9732,12528,8887,11553,4592,5178,8675,12040,8313.797134,10780,9871,55915,7205,-17193,8597,7205,61145,63120,38722,64512,63120
54047,WV,8724,12528,8887,11553,4592,5178,8519,12528,8218.236247,10780,11553,56981,7205,-17193,8597,7205,59981,64186,39788,65578,64186
54049,WV,11412,12528,8887,11553,4592,5178,8936,13242,9333.113258,10780,11024,60970,8362,-15190,10282,8362,63086,69332,45780,71252,69332
54051,WV,9456,12528,8887,11553,4592,5178,8632,15555,8855.308825,10780,10723,60547,8362,-15190,10282,8362,60826,68909,45357,70829,68909
54053,WV,9984,12528,8887,11553,4592,5178,8714,14073,8377.504392,10780,10355,58748,7783,-16192,9439,7783,61436,66531,42556,68187,66531
54055,WV,8568,12528,8887,11553,4592,5178,8495,12877,8504.918907,10780,9921,55828,7205,-17193,8597,7205,59801,63033,38635,64425,63033
54057,WV,10404,12528,8887,11553,4592,5178,8779,13901,8568.626165,10780,10235,59066,7783,-16192,9439,7783,61921,66849,42874,68505,66849
54059,WV,8568,12528,8887,11553,4592,5178,8495,12528,9524.235031,10780,11553,58131,7205,-17193,8597,7205,59801,65336,40938,66728,65336
54061,WV,12168,12528,8887,11553,4592,5178,9053,12693,8919.016082,10780,11167,60905,8362,-15190,10282,8362,63959,69267,45715,71187,69267
54063,WV,8568,12528,8887,11553,4592,5178,8495,12528,8919.016082,10780,11553,57526,7205,-17193,8597,7205,59801,64731,40333,66123,64731
54065,WV,11484,12528,8887,11553,4592,5178,8947,12528,8791.601567,10780,11553,60315,8362,-15190,10282,8362,63169,68677,45125,70597,68677
54067,WV,9156,12528,8887,11553,4592,5178,8586,12528,8473.065278,10780,11553,57668,7783,-16192,9439,7783,60480,65451,41476,67107,65451
54069,WV,9456,12528,8887,11553,4592,5178,8632,14752,9492.381402,10780,10652,60311,7783,-16192,9439,7783,60826,68094,44119,69750,68094
54071,WV,10128,12528,8887,11553,4592,5178,8737,12528,8791.601567,10780,11553,58959,7783,-16192,9439,7783,61603,66742,42767,68398,66742
54073,WV,9888,12528,8887,11553,4592,5178,8699,12528,8154.52899,10780,11553,58082,7783,-16192,9439,7783,61325,65865,41890,67521,65865
54075,WV,8568,12528,8887,11553,4592,5178,8495,12528,8504.918907,10780,11553,57112,7205,-17193,8597,7205,59801,64317,39919,65709,64317
54077,WV,12168,12528,8887,11553,4592,5178,9053,13447,8664.187051,10780,11225,61462,8362,-15190,10282,8362,63959,69824,46272,71744,69824
54079,WV,11388,12528,8887,11553,4592,5178,8932,12014,9396.820515,10780,10795,59551,7783,-16192,9439,7783,63058,67334,43359,68990,67334
54081,WV,9948,12528,8887,11553,4592,5178,8709,13435,8186.382618,10780,10096,57623,7783,-16192,9439,7783,61395,65406,41431,67062,65406
54083,WV,10848,12528,8887,11553,4592,5178,8848,14229,8536.772536,10780,10240,59812,8362,-15190,10282,8362,62434,68174,44622,70094,68174
54085,WV,9720,12528,8887,11553,4592,5178,8673,12528,8090.821732,10780,11553,57850,7783,-16192,9439,7783,61131,65633,41658,67289,65633
54087,WV,10128,12528,8887,11553,4592,5178,8737,12528,8504.918907,10780,11553,58672,7783,-16192,9439,7783,61603,66455,42480,68111,66455
54089,WV,9096,12528,8887,11553,4592,5178,8576,12528,8377.504392,10780,11553,57513,7783,-16192,9439,7783,60410,65296,41321,66952,65296
54091,WV,10020,12528,8887,11553,4592,5178,8720,14978,8632.333423,10780,10899,60487,8362,-15190,10282,8362,61478,68849,45297,70769,68849
54093,WV,10128,12528,8887,11553,4592,5178,8737,12528,8696.04068,10780,11553,58863,7783,-16192,9439,7783,61603,66646,42671,68302,66646
54095,WV,8568,12528,8887,11553,4592,5178,8495,12528,8473.065278,10780,11553,57080,7205,-17193,8597,7205,59801,64285,39887,65677,64285
54097,WV,9228,12528,8887,11553,4592,5178,8597,12528,8441.211649,10780,11553,57708,7783,-16192,9439,7783,60563,65491,41516,67147,65491
54099,WV,10188,12528,8887,11553,4592,5178,8746,15469,8186.382618,10780,10797,60598,8362,-15190,10282,8362,61672,68960,45408,70880,68960
54101,WV,8568,12528,8887,11553,4592,5178,8495,12528,8536.772536,10780,11553,57144,7205,-17193,8597,7205,59801,64349,39951,65741,64349
54103,WV,10272,12528,8887,11553,4592,5178,8759,12528,8441.211649,10780,11553,58752,7783,-16192,9439,7783,61769,66535,42560,68191,66535
54105,WV,9888,12528,8887,11553,4592,5178,8699,13230,8122.675361,10780,10848,58047,7783,-16192,9439,7783,61325,65830,41855,67486,65830
54107,WV,9888,12528,8887,11553,4592,5178,8699,11744,7963.407216,10780,10816,56369,7205,-17193,8597,7205,61325,63574,39176,64966,63574
54109,WV,8568,12528,8887,11553,4592,5178,8495,12528,9810.917691,10780,11553,58418,7205,-17193,8597,7205,59801,65623,41225,67015,65623
55001,WI,10356,4142,9078,11236,5580,4891,11297,4142,8427.401361,10548,11236,49600,4699,-20027,5299,4699,56580,54299,29573,54899,54299
55003,WI,9852,4142,9078,11236,5580,4891,11209,4142,9143.242403,10548,11236,49812,4412,-20314,4880,4412,55988,54224,29498,54692,54224
55005,WI,10056,4142,9078,11236,5580,4891,11245,4142,7679.02209,10548,11236,48552,4412,-20314,4880,4412,56228,52964,28238,53432,52964
55007,WI,10824,4142,9078,11236,5580,4891,11378,4142,9143.242403,10548,11236,50784,4699,-20027,5299,4699,57129,55483,30757,56083,55483
55009,WI,11676,4142,9078,11236,5580,4891,11526,4790,8459.93959,10548,11199,51563,5272,-19454,6136,5272,58129,56835,32109,57699,56835
55011,WI,11292,4142,9078,11236,5580,4891,11459,4142,8655.168965,10548,11236,50764,4699,-20027,5299,4699,57678,55463,30737,56063,55463
55013,WI,11268,4142,9078,11236,5580,4891,11455,4142,8817.860111,10548,11236,50903,4699,-20027,5299,4699,57650,55602,30876,56202,55602
55015,WI,11844,4142,9078,11236,5580,4891,11555,4359,8102.019069,10548,11602,51346,5272,-19454,6136,5272,58326,56618,31892,57482,56618
55017,WI,13080,4142,9078,11236,5580,4891,11770,3586,7744.098548,10548,11090,50938,5272,-19454,6136,5272,59777,56210,31484,57074,56210
55019,WI,9516,4142,9078,11236,5580,4891,11151,4142,8948.013028,10548,11236,49281,4412,-20314,4880,4412,55594,53693,28967,54161,53693
55021,WI,12324,4142,9078,11236,5580,4891,11638,4188,9208.318862,10548,11774,52934,5272,-19454,6136,5272,58889,58206,33480,59070,58206
55023,WI,9576,4142,9078,11236,5580,4891,11161,4142,8167.095528,10548,11236,48560,4412,-20314,4880,4412,55664,52972,28246,53440,52972
55025,WI,14868,4142,9078,11236,5580,4891,12080,4128,9175.780633,10548,11790,55401,5845,-18881,6973,5845,61875,61246,36520,62374,61246
55027,WI,11292,4142,9078,11236,5580,4891,11459,3696,8297.248444,10548,11202,49926,4699,-20027,5299,4699,57678,54625,29899,55225,54625
55029,WI,10824,4142,9078,11236,5580,4891,11378,4142,10542.38626,10548,11236,52183,4699,-20027,5299,4699,57129,56882,32156,57482,56882
55031,WI,10824,4142,9078,11236,5580,4891,11378,3655,9338.471779,10548,10663,49920,4412,-20314,4880,4412,57129,54332,29606,54800,54332
55033,WI,10140,4142,9078,11236,5580,4891,11259,3734,7711.560319,10548,11112,48137,4412,-20314,4880,4412,56326,52549,27823,53017,52549
55035,WI,13080,4142,9078,11236,5580,4891,11770,3743,8134.557298,10548,11080,51476,5272,-19454,6136,5272,59777,56748,32022,57612,56748
55037,WI,9516,4142,9078,11236,5580,4891,11151,3864,8102.019069,10548,10555,47475,4126,-20600,4462,4126,55594,51601,26875,51937,51601
55039,WI,10404,4142,9078,11236,5580,4891,11305,4945,8525.016049,10548,11183,50496,4699,-20027,5299,4699,56636,55195,30469,55795,55195
55041,WI,9972,4142,9078,11236,5580,4891,11230,4142,8167.095528,10548,11236,48956,4412,-20314,4880,4412,56129,53368,28642,53836,53368
55043,WI,9720,4142,9078,11236,5580,4891,11186,4188,8004.404382,10548,10964,48315,4412,-20314,4880,4412,55833,52727,28001,53195,52727
55045,WI,9864,4142,9078,11236,5580,4891,11211,3914,8069.48084,10548,11779,49066,4699,-20027,5299,4699,56002,53765,29039,54365,53765
55047,WI,10452,4142,9078,11236,5580,4891,11313,4142,8687.707195,10548,11236,49957,4699,-20027,5299,4699,56692,54656,29930,55256,54656
55049,WI,11760,4142,9078,11236,5580,4891,11540,3970,9533.701154,10548,11765,52468,5272,-19454,6136,5272,58227,57740,33014,58604,57740
55051,WI,10416,4142,9078,11236,5580,4891,11307,4142,9175.780633,10548,11236,50409,4699,-20027,5299,4699,56650,55108,30382,55708,55108
55053,WI,10116,4142,9078,11236,5580,4891,11255,4142,8915.474799,10548,11236,49848,4699,-20027,5299,4699,56298,54547,29821,55147,54547
55055,WI,12852,4142,9078,11236,5580,4891,11730,3864,8459.93959,10548,11339,51954,5272,-19454,6136,5272,59509,57226,32500,58090,57226
55057,WI,10992,4142,9078,11236,5580,4891,11407,4142,9761.468758,10548,11236,51570,4699,-20027,5299,4699,57326,56269,31543,56869,56269
55059,WI,16908,4142,9078,11236,5580,4891,12434,3629,8655.168965,10548,12003,56634,6418,-17980,7810,6418,64269,63052,38654,64444,63052
55061,WI,11676,4142,9078,11236,5580,4891,11526,3818,9078.165945,10548,11205,51217,4699,-20027,5299,4699,58129,55916,31190,56516,55916
55063,WI,11664,4142,9078,11236,5580,4891,11524,4144,8199.633757,10548,11192,50638,4699,-20027,5299,4699,58115,55337,30611,55937,55337
55065,WI,10404,4142,9078,11236,5580,4891,11305,4142,8459.93959,10548,11236,49681,4699,-20027,5299,4699,56636,54380,29654,54980,54380
55067,WI,11268,4142,9078,11236,5580,4891,11455,4142,8264.710215,10548,11236,50350,4699,-20027,5299,4699,57650,55049,30323,55649,55049
55069,WI,11268,4142,9078,11236,5580,4891,11455,3792,8948.013028,10548,10740,50186,4699,-20027,5299,4699,57650,54885,30159,55485,54885
55071,WI,9516,4142,9078,11236,5580,4891,11151,5023,8362.324903,10548,10948,49287,4699,-20027,5299,4699,55594,53986,29260,54586,53986
55073,WI,10944,4142,9078,11236,5580,4891,11399,4072,8297.248444,10548,11314,50067,4699,-20027,5299,4699,57270,54766,30040,55366,54766
55075,WI,10956,4142,9078,11236,5580,4891,11401,3881,7744.098548,10548,10228,48248,4412,-20314,4880,4412,57284,52660,27934,53128,52660
55077,WI,10296,4142,9078,11236,5580,4891,11286,4142,8687.707195,10548,11236,49801,4699,-20027,5299,4699,56509,54500,29774,55100,54500
55078,WI,9972,4142,9078,11236,5580,4891,11230,4329,8069.48084,10548,10817,48626,4412,-20314,4880,4412,56129,53038,28312,53506,53038
55079,WI,12432,4142,9078,11236,5580,4891,11657,3909,8459.93959,10548,11152,51392,5272,-19454,6136,5272,59016,56664,31938,57528,56664
55081,WI,11556,4142,9078,11236,5580,4891,11505,4142,7809.175006,10548,11236,50182,4699,-20027,5299,4699,57988,54881,30155,55481,54881
55083,WI,10920,4142,9078,11236,5580,4891,11395,3863,8720.245424,10548,11205,50147,4699,-20027,5299,4699,57242,54846,30120,55446,54846
55085,WI,11184,4142,9078,11236,5580,4891,11440,4142,8134.557298,10548,11236,50136,4699,-20027,5299,4699,57551,54835,30109,55435,54835
55087,WI,11844,4142,9078,11236,5580,4891,11555,3721,8720.245424,10548,11615,51339,4699,-20027,5299,4699,58326,56038,31312,56638,56038
55089,WI,12432,4142,9078,11236,5580,4891,11657,3889,8882.93657,10548,11171,51814,5272,-19454,6136,5272,59016,57086,32360,57950,57086
55091,WI,11268,4142,9078,11236,5580,4891,11455,4142,8525.016049,10548,11236,50610,4699,-20027,5299,4699,57650,55309,30583,55909,55309
55093,WI,15984,4142,9078,11236,5580,4891,12274,3823,11160.61261,10548,12051,58457,6418,-17980,7810,6418,63185,64875,40477,66267,64875
55095,WI,12060,4142,9078,11236,5580,4891,11592,4142,9240.857091,10548,11236,52118,4699,-20027,5299,4699,58579,56817,32091,57417,56817
55097,WI,10356,4142,9078,11236,5580,4891,11297,3877,8687.707195,10548,11062,49422,4412,-20314,4880,4412,56580,53834,29108,54302,53834
55099,WI,9516,4142,9078,11236,5580,4891,11151,4142,8297.248444,10548,11236,48630,4412,-20314,4880,4412,55594,53042,28316,53510,53042
55101,WI,11568,4142,9078,11236,5580,4891,11507,4867,8557.554278,10548,11172,51604,5272,-19454,6136,5272,58002,56876,32150,57740,56876
55103,WI,9984,4142,9078,11236,5580,4891,11232,4142,8850.398341,10548,11236,49651,4412,-20314,4880,4412,56143,54063,29337,54531,54063
55105,WI,11664,4142,9078,11236,5580,4891,11524,4552,8004.404382,10548,10971,50630,4699,-20027,5299,4699,58115,55329,30603,55929,55329
55107,WI,10140,4142,9078,11236,5580,4891,11259,4142,8036.942611,10548,11236,48994,4699,-20027,5299,4699,56326,53693,28967,54293,53693
55109,WI,15984,4142,9078,11236,5580,4891,12274,4392,8622.630736,10548,12051,56489,6418,-17980,7810,6418,63185,62907,38509,64299,62907
55111,WI,11592,4142,9078,11236,5580,4891,11511,4789,8297.248444,10548,11223,51340,5272,-19454,6136,5272,58030,56612,31886,57476,56612
55113,WI,9612,4142,9078,11236,5580,4891,11167,4142,8459.93959,10548,11236,48889,4412,-20314,4880,4412,55706,53301,28575,53769,53301
55115,WI,10536,4142,9078,11236,5580,4891,11328,5742,7613.945631,10548,10802,50133,4699,-20027,5299,4699,56791,54832,30106,55432,54832
55117,WI,11328,4142,9078,11236,5580,4891,11465,4753,8948.013028,10548,11179,51646,4699,-20027,5299,4699,57720,56345,31619,56945,56345
55119,WI,9516,4142,9078,11236,5580,4891,11151,4142,9013.089487,10548,11236,49346,4412,-20314,4880,4412,55594,53758,29032,54226,53758
55121,WI,10212,4142,9078,11236,5580,4891,11272,4142,9143.242403,10548,11236,50172,4699,-20027,5299,4699,56411,54871,30145,55471,54871
55123,WI,9732,4142,9078,11236,5580,4891,11188,4142,9013.089487,10548,11236,49562,4412,-20314,4880,4412,55847,53974,29248,54442,53974
55125,WI,10632,4142,9078,11236,5580,4891,11345,4142,9501.162924,10548,11236,50950,4699,-20027,5299,4699,56904,55649,30923,56249,55649
55127,WI,13428,4142,9078,11236,5580,4891,11830,4410,8948.013028,10548,11290,53515,5272,-19454,6136,5272,60185,58787,34061,59651,58787
55129,WI,11352,4142,9078,11236,5580,4891,11470,4142,8590.092507,10548,11236,50759,4699,-20027,5299,4699,57749,55458,30732,56058,55458
55131,WI,12432,4142,9078,11236,5580,4891,11657,4707,8785.321882,10548,11172,52535,5272,-19454,6136,5272,59016,57807,33081,58671,57807
55133,WI,12432,4142,9078,11236,5580,4891,11657,4705,9143.242403,10548,11169,52888,5272,-19454,6136,5272,59016,58160,33434,59024,58160
55135,WI,10380,4142,9078,11236,5580,4891,11301,4142,7841.713236,10548,11236,49039,4699,-20027,5299,4699,56608,53738,29012,54338,53738
55137,WI,9876,4142,9078,11236,5580,4891,11213,4142,9045.627716,10548,11236,49739,4412,-20314,4880,4412,56016,54151,29425,54619,54151
55139,WI,10440,4142,9078,11236,5580,4891,11311,4201,9078.165945,10548,10958,50116,4699,-20027,5299,4699,56678,54815,30089,55415,54815
55141,WI,10236,4142,9078,11236,5580,4891,11276,4665,8297.248444,10548,10747,49384,4699,-20027,5299,4699,56439,54083,29357,54683,54083
56001,WY,12816,6648,10607,9970,5493,5250,7594,7215,12622.18055,13129,9453,60485,2432,-21543,4088,2432,58378,62917,38942,64573,62917
56003,WY,10704,6648,10607,9970,5493,5250,7351,6648,10683.23113,13129,9970,56384,1979,-22419,3371,1979,56023,58363,33965,59755,58363
56005,WY,13464,6648,10607,9970,5493,5250,7669,7704,11481.62207,13129,11346,62375,2885,-20667,4805,2885,59101,65260,41708,67180,65260
56007,WY,10944,6648,10607,9970,5493,5250,7378,6648,11937.84546,13129,9970,57879,1979,-22419,3371,1979,56290,59858,35460,61250,59858
56009,WY,11280,6648,10607,9970,5493,5250,7417,6648,11139.45452,13129,9970,57416,1979,-22419,3371,1979,56665,59395,34997,60787,59395
56011,WY,11268,6648,10607,9970,5493,5250,7416,6648,11481.62207,13129,9970,57747,1979,-22419,3371,1979,56652,59726,35328,61118,59726
56013,WY,11772,6648,10607,9970,5493,5250,7474,5577,11785.77099,13129,9836,57350,1979,-22419,3371,1979,57214,59329,34931,60721,59329
56015,WY,10524,6648,10607,9970,5493,5250,7330,6648,10797.28698,13129,9970,56318,1979,-22419,3371,1979,55822,58297,33899,59689,58297
56017,WY,11268,6648,10607,9970,5493,5250,7416,6648,11633.69653,13129,9970,57899,1979,-22419,3371,1979,56652,59878,35480,61270,59878
56019,WY,11268,6648,10607,9970,5493,5250,7416,6648,11367.56622,13129,9970,57633,1979,-22419,3371,1979,56652,59612,35214,61004,59612
56021,WY,12972,6648,10607,9970,5493,5250,7612,6470,10721.24974,13129,10076,58618,2432,-21543,4088,2432,58552,61050,37075,62706,61050
56023,WY,13476,6648,10607,9970,5493,5250,7670,6648,10112.95189,13129,9970,58586,2432,-21543,4088,2432,59114,61018,37043,62674,61018
56025,WY,13476,6648,10607,9970,5493,5250,7670,5765,11025.39867,13129,10117,58762,2432,-21543,4088,2432,59114,61194,37219,62850,61194
56027,WY,10716,6648,10607,9970,5493,5250,7352,6648,11063.41729,13129,9970,56776,1979,-22419,3371,1979,56036,58755,34357,60147,58755
56029,WY,11352,6648,10607,9970,5493,5250,7425,6648,11443.60345,13129,9970,57793,1979,-22419,3371,1979,56745,59772,35374,61164,59772
56031,WY,10680,6648,10607,9970,5493,5250,7348,6648,11177.47314,13129,9970,56854,1979,-22419,3371,1979,55996,58833,34435,60225,58833
56033,WY,11988,6648,10607,9970,5493,5250,7499,5935,12013.88269,13129,9634,57949,1979,-22419,3371,1979,57455,59928,35530,61320,59928
56035,WY,16860,6648,10607,9970,5493,5250,8060,6648,12241.99439,13129,9970,64099,3338,-19791,5522,3338,62888,67437,44308,69621,67437
56037,WY,13584,6648,10607,9970,5493,5250,7683,7208,11595.67791,13129,10934,61700,2885,-20667,4805,2885,59235,64585,41033,66505,64585
56039,WY,17556,6648,10607,9970,5493,5250,8140,8457,15055.37198,13129,11075,70522,4244,-18038,6956,4244,63664,74766,52484,77478,74766
56041,WY,10932,6648,10607,9970,5493,5250,7377,6573,10835.30559,13129,10440,57159,1979,-22419,3371,1979,56277,59138,34740,60530,59138
56043,WY,10836,6648,10607,9970,5493,5250,7366,6648,11367.56622,13129,9970,57201,1979,-22419,3371,1979,56170,59180,34782,60572,59180
56045,WY,9516,6648,10607,9970,5493,5250,7214,6648,11101.4359,13129,9970,55614,1526,-23200,2654,1526,54698,57140,32414,58268,57140
