FIPS,State,Housing,ChildCare,Food,Transportation,Medical,Other,Taxes,MIDS ChildCare,MIDS Food,MIDS Medical,MIDS Transportation,MIDS Net,MIDS Taxes All,3x EITC Tax,Basic Income Tax,Mids Taxes Universal,MIT LWC,MIDS LWC,3x EITC,Basic Income,MIDS LWC 2
1001,AL,8520,9869,6704,9859,5407,4284,6929,9044,7352.908602,7294,9573,46067,6210,-14108,4608,6536,51572,52277,31959,50675,52603
1003,AL,9924,9869,6704,9859,5407,4284,7147,9913,7593.199732,7294,9634,48642,6763,-13555,5425,7089,53194,55405,35087,54067,55731
1005,AL,6996,9869,6704,9859,5407,4284,6692,9869,7256.792149,7294,9859,45559,5933,-14385,4199,6259,49811,51492,31174,49758,51818
1007,AL,8916,9869,6704,9859,5407,4284,6990,9579,7280.821262,7294,9624,46978,6210,-14108,4608,6536,52029,53188,32870,51586,53514
1009,AL,8916,9869,6704,9859,5407,4284,6990,8743,6824.268114,7294,9626,45687,5933,-14385,4199,6259,52029,51620,31302,49886,51946
1011,AL,6792,9869,6704,9859,5407,4284,6661,9869,6992.471905,7294,9859,45090,5933,-14385,4199,6259,49576,51023,30705,49289,51349
1013,AL,6792,9869,6704,9859,5407,4284,6661,9869,7016.501018,7294,9859,45115,5933,-14385,4199,6259,49576,51048,30730,49314,51374
1015,AL,8148,9869,6704,9859,5407,4284,6871,9732,7256.792149,7294,8928,45643,5933,-14385,4199,6259,51142,51576,31258,49842,51902
1017,AL,7392,9869,6704,9859,5407,4284,6754,9203,6656.064322,7294,8519,43348,5095,-15223,3382,5421,50269,48443,28125,46730,48769
1019,AL,6792,9869,6704,9859,5407,4284,6661,9869,6992.471905,7294,9859,45090,5933,-14385,4199,6259,49576,51023,30705,49289,51349
1021,AL,6792,9869,6704,9859,5407,4284,6661,9702,6704.122548,7294,9623,44399,5583,-14735,3791,5909,49576,49982,29664,48190,50308
1023,AL,8304,9869,6704,9859,5407,4284,6895,9869,6872.32634,7294,9859,46482,6210,-14108,4608,6536,51322,52692,32374,51090,53018
1025,AL,6792,9869,6704,9859,5407,4284,6661,9869,7040.530132,7294,9859,45139,5933,-14385,4199,6259,49576,51072,30754,49338,51398
1027,AL,6792,9869,6704,9859,5407,4284,6661,9869,7136.646584,7294,9859,45235,5933,-14385,4199,6259,49576,51168,30850,49434,51494
1029,AL,7164,9869,6704,9859,5407,4284,6718,9869,6944.413679,7294,9859,45414,5933,-14385,4199,6259,50005,51347,31029,49613,51673
1031,AL,7176,9869,6704,9859,5407,4284,6720,9655,7112.617471,7294,9525,45047,5933,-14385,4199,6259,50019,50980,30662,49246,51306
1033,AL,7632,9869,6704,9859,5407,4284,6791,9714,6848.297227,7294,9134,44906,5583,-14735,3791,5909,50546,50489,30171,48697,50815
1035,AL,6792,9869,6704,9859,5407,4284,6661,9869,7112.617471,7294,9859,45211,5933,-14385,4199,6259,49576,51144,30826,49410,51470
1037,AL,6792,9869,6704,9859,5407,4284,6661,8979,7184.70481,7294,8687,43221,5095,-15223,3382,5421,49576,48316,27998,46603,48642
1039,AL,6792,9869,6704,9859,5407,4284,6661,9869,7232.763036,7294,9859,45331,5933,-14385,4199,6259,49576,51264,30946,49530,51590
1041,AL,6900,9869,6704,9859,5407,4284,6677,9869,6848.297227,7294,9859,45054,5933,-14385,4199,6259,49700,50987,30669,49253,51313
1043,AL,6924,9869,6704,9859,5407,4284,6681,9201,6415.773192,7294,8922,43041,5095,-15223,3382,5421,49728,48136,27818,46423,48462
1045,AL,6792,9869,6704,9859,5407,4284,6661,10124,6535.918757,7294,9454,44483,5583,-14735,3791,5909,49576,50066,29748,48274,50392
1047,AL,6792,9869,6704,9859,5407,4284,6661,9178,6992.471905,7294,8209,42749,4606,-15712,2974,4932,49576,47355,27037,45723,47681
1049,AL,7068,9869,6704,9859,5407,4284,6704,9869,6992.471905,7294,9859,45366,5933,-14385,4199,6259,49895,51299,30981,49565,51625
1051,AL,8520,9869,6704,9859,5407,4284,6929,9352,7304.850375,7294,9578,46333,6210,-14108,4608,6536,51572,52543,32225,50941,52869
1053,AL,6792,9869,6704,9859,5407,4284,6661,9869,7088.588358,7294,9859,45187,5933,-14385,4199,6259,49576,51120,30802,49386,51446
1055,AL,7152,9869,6704,9859,5407,4284,6717,9202,6487.860531,7294,8839,43259,5095,-15223,3382,5421,49992,48354,28036,46641,48680
1057,AL,6792,9869,6704,9859,5407,4284,6661,9869,7064.559245,7294,9859,45163,5933,-14385,4199,6259,49576,51096,30778,49362,51422
1059,AL,6876,9869,6704,9859,5407,4284,6674,9869,6535.918757,7294,9859,44718,5583,-14735,3791,5909,49673,50301,29983,48509,50627
1061,AL,6792,9869,6704,9859,5407,4284,6661,10073,7016.501018,7294,9333,44793,5583,-14735,3791,5909,49576,50376,30058,48584,50702
1063,AL,9780,9869,6704,9859,5407,4284,7124,9869,7256.792149,7294,9859,48343,6763,-13555,5425,7089,53027,55106,34788,53768,55432
1065,AL,9780,9869,6704,9859,5407,4284,7124,8952,7256.792149,7294,9604,47171,6486,-13832,5016,6812,53027,53657,33339,52187,53983
1067,AL,6792,9869,6704,9859,5407,4284,6661,9285,7064.559245,7294,9342,44062,5583,-14735,3791,5909,49576,49645,29327,47853,49971
1069,AL,6792,9869,6704,9859,5407,4284,6661,11050,7136.646584,7294,9291,45848,5933,-14385,4199,6259,49576,51781,31463,50047,52107
1071,AL,6792,9869,6704,9859,5407,4284,6661,9180,6944.413679,7294,8866,43361,5095,-15223,3382,5421,49576,48456,28138,46743,48782
1073,AL,8916,9869,6704,9859,5407,4284,6990,9854,6487.860531,7294,9611,46447,6210,-14108,4608,6536,52029,52657,32339,51055,52983
1075,AL,6792,9869,6704,9859,5407,4284,6661,9869,6872.32634,7294,9859,44970,5583,-14735,3791,5909,49576,50553,30235,48761,50879
1077,AL,7632,9869,6704,9859,5407,4284,6791,9756,6367.714965,7294,9134,44468,5583,-14735,3791,5909,50546,50051,29733,48259,50377
1079,AL,7140,9869,6704,9859,5407,4284,6715,8936,6824.268114,7294,9447,43926,5095,-15223,3382,5421,49978,49021,28703,47308,49347
1081,AL,8688,9869,6704,9859,5407,4284,6955,9529,7400.966828,7294,9459,46655,6210,-14108,4608,6536,51766,52865,32547,51263,53191
1083,AL,8268,9869,6704,9859,5407,4284,6890,9642,7112.617471,7294,9845,46446,6210,-14108,4608,6536,51281,52656,32338,51054,52982
1085,AL,8520,9869,6704,9859,5407,4284,6929,9362,6992.471905,7294,9592,46044,6210,-14108,4608,6536,51572,52254,31936,50652,52580
1087,AL,6792,9869,6704,9859,5407,4284,6661,9869,7785.432637,7294,9859,45883,5933,-14385,4199,6259,49576,51816,31498,50082,52142
1089,AL,8268,9869,6704,9859,5407,4284,6890,8933,6511.889644,7294,9839,45130,5933,-14385,4199,6259,51281,51063,30745,49329,51389
1091,AL,6792,9869,6704,9859,5407,4284,6661,9869,7232.763036,7294,9859,45331,5933,-14385,4199,6259,49576,51264,30946,49530,51590
1093,AL,6792,9869,6704,9859,5407,4284,6661,9869,6824.268114,7294,9859,44922,5583,-14735,3791,5909,49576,50505,30187,48713,50831
1095,AL,6816,9869,6704,9859,5407,4284,6664,10268,6776.209888,7294,9079,44518,5583,-14735,3791,5909,49603,50101,29783,48309,50427
1097,AL,9240,9869,6704,9859,5407,4284,7041,9828,7160.675697,7294,9433,47240,6486,-13832,5016,6812,52404,53726,33408,52256,54052
1099,AL,6792,9869,6704,9859,5407,4284,6661,9869,7064.559245,7294,9859,45163,5933,-14385,4199,6259,49576,51096,30778,49362,51422
1101,AL,8520,9869,6704,9859,5407,4284,6929,10091,6728.151662,7294,9564,46481,6210,-14108,4608,6536,51572,52691,32373,51089,53017
1103,AL,7140,9869,6704,9859,5407,4284,6715,10757,6463.831418,7294,9412,45351,5933,-14385,4199,6259,49978,51284,30966,49550,51610
1105,AL,6792,9869,6704,9859,5407,4284,6661,9869,7040.530132,7294,9859,45139,5933,-14385,4199,6259,49576,51072,30754,49338,51398
1107,AL,6792,9869,6704,9859,5407,4284,6661,9860,7184.70481,7294,9611,45026,5933,-14385,4199,6259,49576,50959,30641,49225,51285
1109,AL,6792,9869,6704,9859,5407,4284,6661,10429,7256.792149,7294,8667,44723,5583,-14735,3791,5909,49576,50306,29988,48514,50632
1111,AL,7344,9869,6704,9859,5407,4284,6746,9869,6704.122548,7294,9859,45354,5933,-14385,4199,6259,50213,51287,30969,49553,51613
1113,AL,8460,9869,6704,9859,5407,4284,6920,9422,7208.733923,7294,9431,46099,6210,-14108,4608,6536,51503,52309,31991,50707,52635
1115,AL,8916,9869,6704,9859,5407,4284,6990,13577,7208.733923,7294,9618,50898,7316,-13002,6242,7642,52029,58214,37896,57140,58540
1117,AL,8916,9869,6704,9859,5407,4284,6990,12207,7184.70481,7294,9619,49505,7039,-13279,5833,7365,52029,56544,36226,55338,56870
1119,AL,6792,9869,6704,9859,5407,4284,6661,9869,6824.268114,7294,9859,44922,5583,-14735,3791,5909,49576,50505,30187,48713,50831
1121,AL,6792,9869,6704,9859,5407,4284,6661,13988,6944.413679,7294,8628,47931,6486,-13832,5016,6812,49576,54417,34099,52947,54743
1123,AL,6876,9869,6704,9859,5407,4284,6674,9869,7112.617471,7294,9859,45295,5933,-14385,4199,6259,49673,51228,30910,49494,51554
1125,AL,9780,9869,6704,9859,5407,4284,7124,12491,7424.995941,7294,9614,50889,7316,-13002,6242,7642,53027,58205,37887,57131,58531
1127,AL,6792,9869,6704,9859,5407,4284,6661,10272,6872.32634,7294,9620,45134,5933,-14385,4199,6259,49576,51067,30749,49333,51393
1129,AL,6792,9869,6704,9859,5407,4284,6661,9869,7064.559245,7294,9859,45163,5933,-14385,4199,6259,49576,51096,30778,49362,51422
1131,AL,6792,9869,6704,9859,5407,4284,6661,9869,7232.763036,7294,9859,45331,5933,-14385,4199,6259,49576,51264,30946,49530,51590
1133,AL,6792,9869,6704,9859,5407,4284,6661,9869,6920.384566,7294,9859,45018,5933,-14385,4199,6259,49576,50951,30633,49217,51277
2013,AK,8556,13295,8002,8509,6397,4344,5657,13295,11415.24809,17045,8509,63164,2691,-10846,8383,8199,54760,65855,52318,71547,71363
2016,AK,17232,13295,8002,8509,6397,4344,6656,13295,14971.75755,17045,8509,75397,5664,-5332,12940,11172,64435,81061,70065,88337,86569
2020,AK,13752,13295,8002,8509,6397,4344,6255,14599,9092.044335,17045,9534,68366,4050,-8217,10534,9558,60554,72416,60149,78900,77924
2050,AK,14208,13295,8002,8509,6397,4344,6308,13295,9522.267253,17045,8509,66923,3597,-9093,9817,9105,61063,70520,57830,76740,76028
2060,AK,12120,13295,8002,8509,6397,4344,6067,13295,9464.904197,17045,8509,64778,3144,-9970,9100,8652,58734,67922,54808,73878,73430
2068,AK,7644,13295,8002,8509,6397,4344,5552,13295,9407.541141,17045,8509,60245,2238,-11723,7666,7746,53743,62483,48522,67911,67991
2070,AK,12384,13295,8002,8509,6397,4344,6098,13295,9550.948781,17045,8509,65128,3144,-9970,9100,8652,59029,68272,55158,74228,73780
2090,AK,15912,13295,8002,8509,6397,4344,6504,16778,9952.490171,17045,9174,73206,5011,-6409,12023,10519,62963,78217,66797,85229,83725
2100,AK,9816,13295,8002,8509,6397,4344,5802,13295,9120.725863,17045,8509,62130,2691,-10846,8383,8199,56165,64821,51284,70513,70329
2105,AK,8748,13295,8002,8509,6397,4344,5679,13295,8661.821417,17045,8509,60603,2238,-11723,7666,7746,54974,62841,48880,68269,68349
2110,AK,14616,13295,8002,8509,6397,4344,6355,14814,8575.776833,17045,9440,68835,4050,-8217,10534,9558,61518,72885,60618,79369,78393
2122,AK,9912,13295,8002,8509,6397,4344,5813,13295,11673.38184,17045,8509,64778,3144,-9970,9100,8652,56272,67922,54808,73878,73430
2130,AK,11580,13295,8002,8509,6397,4344,6005,12032,8346.32461,17045,8939,62286,2691,-10846,8383,8199,58132,64977,51440,70669,70485
2150,AK,12276,13295,8002,8509,6397,4344,6085,13295,9493.585725,17045,8509,64963,3144,-9970,9100,8652,58908,68107,54993,74063,73615
2164,AK,8520,13295,8002,8509,6397,4344,5653,13295,9464.904197,17045,8509,61178,2238,-11723,7666,7746,54720,63416,49455,68844,68924
2170,AK,12972,13295,8002,8509,6397,4344,6165,11851,10726.89142,17045,9279,66218,3597,-9093,9817,9105,59684,69815,57125,76035,75323
2180,AK,16320,13295,8002,8509,6397,4344,6551,13295,11415.24809,17045,8509,70928,4503,-7340,11251,10011,63418,75431,63588,82179,80939
2185,AK,11232,13295,8002,8509,6397,4344,5965,13295,10067.21628,17045,8509,64492,3144,-9970,9100,8652,57744,67636,54522,73592,73144
2188,AK,13692,13295,8002,8509,6397,4344,6248,13295,10669.52837,17045,8509,67555,3597,-9093,9817,9105,60487,71152,58462,77372,76660
2195,AK,9936,13295,8002,8509,6397,4344,5816,13295,8661.821417,17045,8509,61791,2238,-11723,7666,7746,56299,64029,50068,69457,69537
2198,AK,8700,13295,8002,8509,6397,4344,5673,13295,8661.821417,17045,8509,60555,2238,-11723,7666,7746,54920,62793,48832,68221,68301
2220,AK,13608,13295,8002,8509,6397,4344,6239,13295,9092.044335,17045,8509,65893,3144,-9970,9100,8652,60394,69037,55923,74993,74545
2230,AK,13428,13295,8002,8509,6397,4344,6218,13295,8919.955168,17045,8509,65541,3144,-9970,9100,8652,60193,68685,55571,74641,74193
2240,AK,11112,13295,8002,8509,6397,4344,5951,13295,9436.222669,17045,8509,63741,2691,-10846,8383,8199,57610,66432,52895,72124,71940
2261,AK,10296,13295,8002,8509,6397,4344,5857,13295,9436.222669,17045,8509,62925,2691,-10846,8383,8199,56700,65616,52079,71308,71124
2270,AK,8712,13295,8002,8509,6397,4344,5675,13295,11415.24809,17045,8509,63320,2691,-10846,8383,8199,54934,66011,52474,71703,71519
2275,AK,9648,13295,8002,8509,6397,4344,5783,13295,9264.133502,17045,8509,62105,2691,-10846,8383,8199,55978,64796,51259,70488,70304
2282,AK,8580,13295,8002,8509,6397,4344,5660,13295,9608.311837,17045,8509,61381,2238,-11723,7666,7746,54787,63619,49658,69047,69127
2290,AK,8520,13295,8002,8509,6397,4344,5653,13295,9550.948781,17045,8509,61264,2238,-11723,7666,7746,54720,63502,49541,68930,69010
4001,AZ,7644,16670,8002,8509,6413,4344,6868,16670,8288.961554,5465,8509,50921,6619,-14025,5219,6619,58450,57540,36896,56140,57540
4003,AZ,9936,16670,8002,8509,6413,4344,7198,15764,7944.78322,5465,7947,51401,6619,-14025,5219,6619,61072,58020,37376,56620,58020
4005,AZ,12252,16670,8002,8509,6413,4344,7532,14490,8461.050722,5465,8608,53620,7139,-13505,6003,7139,63722,60759,40115,59623,60759
4007,AZ,8676,16670,8002,8509,6413,4344,7017,14401,8432.369194,5465,7515,48834,6099,-14545,4435,6099,59631,54933,34289,53269,54933
4009,AZ,7752,16670,8002,8509,6413,4344,6884,16638,8174.235443,5465,8218,50592,6619,-14025,5219,6619,58574,57211,36567,55811,57211
4011,AZ,7644,16670,8002,8509,6413,4344,6868,16670,8002.146276,5465,8509,50634,6619,-14025,5219,6619,58450,57253,36609,55853,57253
4012,AZ,7956,16670,8002,8509,6413,4344,6913,16670,8317.643082,5465,8509,51262,6619,-14025,5219,6619,58807,57881,37237,56481,57881
4013,AZ,11484,16670,8002,8509,6413,4344,7421,21778,8174.235443,5465,8533,59778,8700,-11192,8356,8700,62843,68478,48586,68134,68478
4015,AZ,8988,16670,8002,8509,6413,4344,7062,15897,8231.598499,5465,7352,50277,6619,-14025,5219,6619,59988,56896,36252,55496,56896
4017,AZ,7932,16670,8002,8509,6413,4344,6910,19350,8145.553915,5465,7695,52931,7139,-13505,6003,7139,58780,60070,39426,58934,60070
4019,AZ,10224,16670,8002,8509,6413,4344,7240,17023,8145.553915,5465,8085,53287,7139,-13505,6003,7139,61402,60426,39782,59290,60426
4021,AZ,11484,16670,8002,8509,6413,4344,7421,17096,7858.738636,5465,8530,54778,7660,-12984,6788,7660,62843,62438,41794,61566,62438
4023,AZ,7980,16670,8002,8509,6413,4344,6917,22339,6998.2928,5465,8017,55144,7660,-12984,6788,7660,58835,62804,42160,61932,62804
4025,AZ,9408,16670,8002,8509,6413,4344,7122,18666,8375.006138,5465,7685,53943,7139,-13505,6003,7139,60468,61082,40438,59946,61082
4027,AZ,9744,16670,8002,8509,6413,4344,7171,14757,7113.018912,5465,7966,49390,6359,-14285,4827,6359,60853,55749,35105,54217,55749
5001,AR,6984,4705,6704,9859,5571,4284,6182,4705,6776.209888,7810,9859,40418,3463,-16014,2211,4010,44289,43881,24404,42629,44428
5003,AR,6732,4705,6704,9859,5571,4284,6146,4705,6680.093435,7810,9859,40070,3463,-16014,2211,4010,44001,43533,24056,42281,44080
5005,AR,7152,4705,6704,9859,5571,4284,6205,5684,6800.239001,7810,8308,40039,3463,-16014,2211,4010,44480,43502,24025,42250,44049
5007,AR,8220,4705,6704,9859,5571,4284,6355,6286,6511.889644,7810,9760,42872,4479,-15618,3068,5026,45698,47351,27254,45940,47898
5009,AR,6732,4705,6704,9859,5571,4284,6146,5291,5694.899799,7810,8714,38526,-1719,-20395,-2812,-1173,44001,36807,18131,35714,37353
5011,AR,6732,4705,6704,9859,5571,4284,6146,4705,6752.180775,7810,9859,40142,3463,-16014,2211,4010,44001,43605,24128,42353,44152
5013,AR,6732,4705,6704,9859,5571,4284,6146,5224,6704.122548,7810,8604,39358,-1210,-20287,-2384,-664,44001,38148,19071,36974,38694
5015,AR,7620,4705,6704,9859,5571,4284,6271,4705,6271.598513,7810,9859,40550,3463,-16014,2211,4010,45014,44013,24536,42761,44560
5017,AR,6732,4705,6704,9859,5571,4284,6146,4705,6776.209888,7810,9859,40166,3463,-16014,2211,4010,44001,43629,24152,42377,44176
5019,AR,6804,4705,6704,9859,5571,4284,6156,6147,6704.122548,7810,8593,40342,3463,-16014,2211,4010,44083,43805,24328,42553,44352
5021,AR,6732,4705,6704,9859,5571,4284,6146,4705,5863.103591,7810,9859,39253,-1210,-20287,-2384,-664,44001,38043,18966,36869,38589
5023,AR,6996,4705,6704,9859,5571,4284,6183,4705,6800.239001,7810,9859,40454,3463,-16014,2211,4010,44302,43917,24440,42665,44464
5025,AR,7812,4705,6704,9859,5571,4284,6298,5490,6728.151662,7810,8759,40883,3463,-16014,2211,4010,45233,44346,24869,43094,44893
5027,AR,6732,4705,6704,9859,5571,4284,6146,5060,6992.471905,7810,8669,39547,-1210,-20287,-2384,-664,44001,38337,19260,37163,38883
5029,AR,7440,4705,6704,9859,5571,4284,6245,4705,6199.511174,7810,9859,40298,3463,-16014,2211,4010,44808,43761,24284,42509,44308
5031,AR,7368,4705,6704,9859,5571,4284,6235,6067,6559.94787,7810,8951,41040,3971,-15906,2639,4518,44726,45011,25134,43679,45558
5033,AR,7200,4705,6704,9859,5571,4284,6212,5378,6487.860531,7810,9030,40190,3463,-16014,2211,4010,44535,43653,24176,42401,44200
5035,AR,9360,4705,6704,9859,5571,4284,6515,4983,6776.209888,7810,9784,42996,4479,-15618,3068,5026,46998,47475,27378,46064,48022
5037,AR,7164,4705,6704,9859,5571,4284,6207,4705,6656.064322,7810,9859,40478,3463,-16014,2211,4010,44494,43941,24464,42689,44488
5039,AR,6732,4705,6704,9859,5571,4284,6146,4705,6728.151662,7810,9859,40118,3463,-16014,2211,4010,44001,43581,24104,42329,44128
5041,AR,6732,4705,6704,9859,5571,4284,6146,4705,6680.093435,7810,9859,40070,3463,-16014,2211,4010,44001,43533,24056,42281,44080
5043,AR,6732,4705,6704,9859,5571,4284,6146,4705,6848.297227,7810,9859,40238,3463,-16014,2211,4010,44001,43701,24224,42449,44248
5045,AR,8868,4705,6704,9859,5571,4284,6446,5903,6920.384566,7810,9741,43526,4988,-15109,3496,5535,46437,48514,28417,47022,49061
5047,AR,6732,4705,6704,9859,5571,4284,6146,4705,6199.511174,7810,9859,39590,-1210,-20287,-2384,-664,44001,38380,19303,37206,38926
5049,AR,6732,4705,6704,9859,5571,4284,6146,4705,6247.5694,7810,9859,39638,-1210,-20287,-2384,-664,44001,38428,19351,37254,38974
5051,AR,9444,4705,6704,9859,5571,4284,6526,5895,6535.918757,7810,8679,42648,4479,-15618,3068,5026,47093,47127,27030,45716,47674
5053,AR,6732,4705,6704,9859,5571,4284,6146,4530,6776.209888,7810,9752,39884,-1210,-20287,-2384,-664,44001,38674,19597,37500,39220
5055,AR,7392,4705,6704,9859,5571,4284,6239,5082,6728.151662,7810,8897,40193,3463,-16014,2211,4010,44754,43656,24179,42404,44203
5057,AR,6732,4705,6704,9859,5571,4284,6146,4705,6247.5694,7810,9859,39638,-1210,-20287,-2384,-664,44001,38428,19351,37254,38974
5059,AR,6732,4705,6704,9859,5571,4284,6146,4259,6583.976983,7810,9325,38993,-1719,-20395,-2812,-1173,44001,37274,18598,36181,37820
5061,AR,6732,4705,6704,9859,5571,4284,6146,4705,6415.773192,7810,9859,39806,-1210,-20287,-2384,-664,44001,38596,19519,37422,39142
5063,AR,6828,4705,6704,9859,5571,4284,6160,4587,6463.831418,7810,8794,38767,-1719,-20395,-2812,-1173,44111,37048,18372,35955,37594
5065,AR,6732,4705,6704,9859,5571,4284,6146,4705,6463.831418,7810,9859,39854,-1210,-20287,-2384,-664,44001,38644,19567,37470,39190
5067,AR,6732,4705,6704,9859,5571,4284,6146,4705,6632.035209,7810,9859,40022,3463,-16014,2211,4010,44001,43485,24008,42233,44032
5069,AR,7812,4705,6704,9859,5571,4284,6298,5000,6680.093435,7810,8646,40232,3463,-16014,2211,4010,45233,43695,24218,42443,44242
5071,AR,6960,4705,6704,9859,5571,4284,6178,4705,6415.773192,7810,9859,40034,3463,-16014,2211,4010,44261,43497,24020,42245,44044
5073,AR,6732,4705,6704,9859,5571,4284,6146,4705,6776.209888,7810,9859,40166,3463,-16014,2211,4010,44001,43629,24152,42377,44176
5075,AR,6732,4705,6704,9859,5571,4284,6146,4705,6511.889644,7810,9859,39902,-1210,-20287,-2384,-664,44001,38692,19615,37518,39238
5077,AR,6732,4705,6704,9859,5571,4284,6146,4705,6608.006096,7810,9859,39998,-1210,-20287,-2384,-664,44001,38788,19711,37614,39334
5079,AR,7812,4705,6704,9859,5571,4284,6298,4652,6680.093435,7810,8727,39965,-1210,-20287,-2384,-664,45233,38755,19678,37581,39301
5081,AR,7428,4705,6704,9859,5571,4284,6244,4550,6367.714965,7810,9384,39823,-1210,-20287,-2384,-664,44795,38613,19536,37439,39159
5083,AR,6732,4705,6704,9859,5571,4284,6146,4705,5887.132704,7810,9859,39277,-1210,-20287,-2384,-664,44001,38067,18990,36893,38613
5085,AR,8868,4705,6704,9859,5571,4284,6446,4731,6848.297227,7810,9749,42291,4479,-15618,3068,5026,46437,46770,26673,45359,47317
5087,AR,8220,4705,6704,9859,5571,4284,6355,4373,6463.831418,7810,9759,40910,3463,-16014,2211,4010,45698,44373,24896,43121,44920
5089,AR,6732,4705,6704,9859,5571,4284,6146,4705,6367.714965,7810,9859,39758,-1210,-20287,-2384,-664,44001,38548,19471,37374,39094
5091,AR,8448,4705,6704,9859,5571,4284,6387,4836,6800.239001,7810,9382,41560,3971,-15906,2639,4518,45958,45531,25654,44199,46078
5093,AR,6744,4705,6704,9859,5571,4284,6148,5279,6583.976983,7810,8865,39565,-1210,-20287,-2384,-664,44015,38355,19278,37181,38901
5095,AR,6732,4705,6704,9859,5571,4284,6146,4705,6487.860531,7810,9859,39878,-1210,-20287,-2384,-664,44001,38668,19591,37494,39214
5097,AR,6732,4705,6704,9859,5571,4284,6146,4705,6415.773192,7810,9859,39806,-1210,-20287,-2384,-664,44001,38596,19519,37422,39142
5099,AR,6732,4705,6704,9859,5571,4284,6146,4705,6511.889644,7810,9859,39902,-1210,-20287,-2384,-664,44001,38692,19615,37518,39238
5101,AR,6732,4705,6704,9859,5571,4284,6146,5102,6391.744078,7810,8785,39105,-1210,-20287,-2384,-664,44001,37895,18818,36721,38441
5103,AR,6732,4705,6704,9859,5571,4284,6146,4905,6776.209888,7810,8537,39044,-1210,-20287,-2384,-664,44001,37834,18757,36660,38380
5105,AR,8868,4705,6704,9859,5571,4284,6446,4537,6848.297227,7810,9754,42102,4479,-15618,3068,5026,46437,46581,26484,45170,47128
5107,AR,6732,4705,6704,9859,5571,4284,6146,4478,6656.064322,7810,8184,38144,-1719,-20395,-2812,-1173,44001,36425,17749,35332,36971
5109,AR,6732,4705,6704,9859,5571,4284,6146,4705,6487.860531,7810,9859,39878,-1210,-20287,-2384,-664,44001,38668,19591,37494,39214
5111,AR,6732,4705,6704,9859,5571,4284,6146,4495,6415.773192,7810,8990,38727,-1719,-20395,-2812,-1173,44001,37008,18332,35915,37554
5113,AR,6732,4705,6704,9859,5571,4284,6146,4705,6415.773192,7810,9859,39806,-1210,-20287,-2384,-664,44001,38596,19519,37422,39142
5115,AR,7068,4705,6704,9859,5571,4284,6193,4542,6728.151662,7810,9136,39569,-1210,-20287,-2384,-664,44384,38359,19282,37185,38905
5117,AR,6732,4705,6704,9859,5571,4284,6146,4705,6776.209888,7810,9859,40166,3463,-16014,2211,4010,44001,43629,24152,42377,44176
5119,AR,8868,4705,6704,9859,5571,4284,6446,4925,6824.268114,7810,9745,42456,4479,-15618,3068,5026,46437,46935,26838,45524,47482
5121,AR,6732,4705,6704,9859,5571,4284,6146,4705,6463.831418,7810,9859,39854,-1210,-20287,-2384,-664,44001,38644,19567,37470,39190
5123,AR,6732,4705,6704,9859,5571,4284,6146,4341,6680.093435,7810,8411,38258,-1719,-20395,-2812,-1173,44001,36539,17863,35446,37085
5125,AR,8868,4705,6704,9859,5571,4284,6446,4786,6920.384566,7810,9745,42414,4479,-15618,3068,5026,46437,46893,26796,45482,47440
5127,AR,6744,4705,6704,9859,5571,4284,6148,4705,6295.627626,7810,9859,39698,-1210,-20287,-2384,-664,44015,38488,19411,37314,39034
5129,AR,6732,4705,6704,9859,5571,4284,6146,4705,6367.714965,7810,9859,39758,-1210,-20287,-2384,-664,44001,38548,19471,37374,39094
5131,AR,7200,4705,6704,9859,5571,4284,6212,4229,6127.423835,7810,9000,38650,-1719,-20395,-2812,-1173,44535,36931,18255,35838,37477
5133,AR,6732,4705,6704,9859,5571,4284,6146,4705,6391.744078,7810,9859,39782,-1210,-20287,-2384,-664,44001,38572,19495,37398,39118
5135,AR,6732,4705,6704,9859,5571,4284,6146,4705,6319.656739,7810,9859,39710,-1210,-20287,-2384,-664,44001,38500,19423,37326,39046
5137,AR,6744,4705,6704,9859,5571,4284,6148,4705,6559.94787,7810,9859,39962,-1210,-20287,-2384,-664,44015,38752,19675,37578,39298
5139,AR,7440,4705,6704,9859,5571,4284,6245,4883,6728.151662,7810,8767,39912,-1210,-20287,-2384,-664,44808,38702,19625,37528,39248
5141,AR,6732,4705,6704,9859,5571,4284,6146,4705,6800.239001,7810,9859,40190,3463,-16014,2211,4010,44001,43653,24176,42401,44200
5143,AR,8220,4705,6704,9859,5571,4284,6355,4398,6439.802305,7810,9759,40911,3463,-16014,2211,4010,45698,44374,24897,43122,44921
5145,AR,7020,4705,6704,9859,5571,4284,6187,3891,6824.268114,7810,9344,39173,-1210,-20287,-2384,-664,44330,37963,18886,36789,38509
5147,AR,6732,4705,6704,9859,5571,4284,6146,4705,6656.064322,7810,9859,40046,3463,-16014,2211,4010,44001,43509,24032,42257,44056
5149,AR,6732,4705,6704,9859,5571,4284,6146,4018,6223.540287,7810,9163,38230,-1719,-20395,-2812,-1173,44001,36511,17835,35418,37057
6001,CA,18936,12784,8002,8509,6151,4344,7546,14511,9751.719476,6329,9400,63271,11003,-8011,11218,11034,66272,74274,55260,74489,74305
6003,CA,10956,12784,8002,8509,6151,4344,6467,12784,9206.770446,6329,8509,52129,7853,-12761,6747,7883,57213,59982,39368,58876,60012
6005,CA,12576,12784,8002,8509,6151,4344,6686,12784,10612.16531,6329,8509,55154,8466,-12148,7624,8496,59052,63620,43006,62778,63650
6007,CA,10212,12784,8002,8509,6151,4344,6366,11820,8547.095305,6329,7957,49209,6933,-13681,5431,6963,56368,56142,35528,54640,56172
6009,CA,11136,12784,8002,8509,6151,4344,6491,12784,10325.35003,6329,8509,53427,7853,-12761,6747,7883,57417,61280,40666,60174,61310
6011,CA,9744,12784,8002,8509,6151,4344,6303,12784,11472.61115,6329,8509,53183,7853,-12761,6747,7883,55837,61036,40422,59930,61066
6013,CA,18936,12784,8002,8509,6151,4344,7546,14297,9493.585725,6329,9328,62728,11003,-8011,11218,11034,66272,73731,54717,73946,73762
6015,CA,10440,12784,8002,8509,6151,4344,6397,11363,9292.81503,6329,7479,49247,6933,-13681,5431,6963,56627,56180,35566,54678,56210
6017,CA,12864,12784,8002,8509,6151,4344,6725,12891,10956.34365,6329,8571,55956,8466,-12148,7624,8496,59379,64422,43808,63580,64452
6019,CA,9924,12784,8002,8509,6151,4344,6327,11555,7744.012525,6329,8608,48504,6627,-13987,4993,6657,56041,55131,34517,53497,55161
6021,CA,9888,12784,8002,8509,6151,4344,6322,12784,8375.006138,6329,8509,50229,7240,-13374,5870,7270,56000,57469,36855,56099,57499
6023,CA,11832,12784,8002,8509,6151,4344,6585,11625,8461.050722,6329,8016,50607,7240,-13374,5870,7270,58207,57847,37233,56477,57877
6025,CA,9708,12784,8002,8509,6151,4344,6298,11218,7256.426551,6329,8485,47340,6320,-14294,4554,6350,55796,53660,33046,51894,53690
6027,CA,11544,12784,8002,8509,6151,4344,6546,12784,8317.643082,6329,8509,51828,7240,-13374,5870,7270,57880,59068,38454,57698,59098
6029,CA,9780,12784,8002,8509,6151,4344,6308,11270,8030.827804,6329,8677,48431,6627,-13987,4993,6657,55878,55058,34444,53424,55088
6031,CA,10668,12784,8002,8509,6151,4344,6428,11186,7830.057109,6329,8711,49068,6933,-13681,5431,6963,56886,56001,35387,54499,56031
6033,CA,10524,12784,8002,8509,6151,4344,6408,11742,9981.171699,6329,7190,50110,7240,-13374,5870,7270,56722,57350,36736,55980,57380
6035,CA,11340,12784,8002,8509,6151,4344,6519,11372,9665.674892,6329,7717,50768,7240,-13374,5870,7270,57649,58008,37394,56638,58038
6037,CA,16776,12784,8002,8509,6151,4344,7254,14052,8833.910584,6329,9439,59774,9725,-10136,9412,9756,63820,69499,49638,69186,69530
6039,CA,9420,12784,8002,8509,6151,4344,6259,11003,9550.948781,6329,8300,48946,6627,-13987,4993,6657,55469,55573,34959,53939,55603
6041,CA,23472,12784,8002,8509,6151,4344,8159,15832,10726.89142,6329,9321,70025,13559,-3761,14830,13590,71421,83584,66264,84855,83615
6043,CA,9288,12784,8002,8509,6151,4344,6241,12784,8088.190859,6329,8509,49342,6933,-13681,5431,6963,55319,56275,35661,54773,56305
6045,CA,11124,12784,8002,8509,6151,4344,6489,11941,10038.53475,6329,8070,51847,7240,-13374,5870,7270,57403,59087,38473,57717,59117
6047,CA,9540,12784,8002,8509,6151,4344,6275,10914,8116.872387,6329,8626,47870,6320,-14294,4554,6350,55605,54190,33576,52424,54220
6049,CA,7644,12784,8002,8509,6151,4344,6019,12784,8317.643082,6329,8509,47928,6320,-14294,4554,6350,53453,54248,33634,52482,54278
6051,CA,15024,12784,8002,8509,6151,4344,7017,12784,8202.916971,6329,8509,55193,8466,-12148,7624,8496,61831,63659,43045,62817,63689
6053,CA,14808,12784,8002,8509,6151,4344,6988,13256,8633.139889,6329,9097,56467,9086,-11199,8509,9117,61586,65553,45268,64976,65584
6055,CA,16968,12784,8002,8509,6151,4344,7280,13785,10354.03156,6329,9233,61014,10364,-9074,10315,10395,64038,71378,51940,71329,71409
6057,CA,12564,12784,8002,8509,6151,4344,6684,12442,11529.9742,6329,8117,55326,8466,-12148,7624,8496,59038,63792,43178,62950,63822
6059,CA,19728,12784,8002,8509,6151,4344,7653,15047,8948.636696,6329,9398,63794,11003,-8011,11218,11034,67171,74797,55783,75012,74828
6061,CA,12864,12784,8002,8509,6151,4344,6725,13147,9522.267253,6329,8576,54782,8466,-12148,7624,8496,59379,63248,42634,62406,63278
6063,CA,11196,12784,8002,8509,6151,4344,6499,12784,8661.821417,6329,8509,51824,7240,-13374,5870,7270,57485,59064,38450,57694,59094
6065,CA,13440,12784,8002,8509,6151,4344,6803,12633,8145.553915,6329,8945,53837,7853,-12761,6747,7883,60033,61690,41076,60584,61720
6067,CA,12864,12784,8002,8509,6151,4344,6725,12388,8375.006138,6329,8586,52886,7853,-12761,6747,7883,59379,60739,40125,59633,60769
6069,CA,14352,12784,8002,8509,6151,4344,6926,13112,10239.30545,6329,9687,58063,9725,-10136,9412,9756,61068,67788,47927,67475,67819
6071,CA,13440,12784,8002,8509,6151,4344,6803,12244,7944.78322,6329,8954,53257,7853,-12761,6747,7883,60033,61110,40496,60004,61140
6073,CA,16248,12784,8002,8509,6151,4344,7182,14282,9092.044335,6329,9219,59515,9725,-10136,9412,9756,63220,69240,49379,68927,69271
6075,CA,23472,12784,8002,8509,6151,4344,8159,16404,11243.15893,6329,9653,71445,13559,-3761,14830,13590,71421,85004,67684,86275,85035
6077,CA,11160,12784,8002,8509,6151,4344,6494,12091,8174.235443,6329,8762,50860,7240,-13374,5870,7270,57444,58100,37486,56730,58130
6079,CA,14580,12784,8002,8509,6151,4344,6957,13202,9579.630309,6329,8421,56456,9086,-11199,8509,9117,61327,65542,45257,64965,65573
6081,CA,23472,12784,8002,8509,6151,4344,8159,15693,9923.808643,6329,9354,69116,12920,-4824,13927,12951,71421,82036,64292,83043,82067
6083,CA,15264,12784,8002,8509,6151,4344,7049,13948,8776.547528,6329,9237,57899,9086,-11199,8509,9117,62103,66985,46700,66408,67016
6085,CA,19788,12784,8002,8509,6151,4344,7661,15584,9608.311837,6329,9926,65579,11642,-6949,12121,11673,67239,77221,58630,77700,77252
6087,CA,19164,12784,8002,8509,6151,4344,7576,14218,9923.808643,6329,9164,63143,11003,-8011,11218,11034,66530,74146,55132,74361,74177
6089,CA,11280,12784,8002,8509,6151,4344,6511,11638,8088.190859,6329,7971,49651,6933,-13681,5431,6963,57581,56584,35970,55082,56614
6091,CA,10380,12784,8002,8509,6151,4344,6389,12784,8977.318223,6329,8509,51323,7240,-13374,5870,7270,56559,58563,37949,57193,58593
6093,CA,9468,12784,8002,8509,6151,4344,6266,12784,8747.866,6329,8509,50182,7240,-13374,5870,7270,55524,57422,36808,56052,57452
6095,CA,13956,12784,8002,8509,6151,4344,6872,12846,8403.687666,6329,9239,55118,8466,-12148,7624,8496,60618,63584,42970,62742,63614
6097,CA,15012,12784,8002,8509,6151,4344,7015,13446,9751.719476,6329,8897,57780,9086,-11199,8509,9117,61817,66866,46581,66289,66897
6099,CA,10920,12784,8002,8509,6151,4344,6462,11596,8174.235443,6329,8624,49988,6933,-13681,5431,6963,57172,56921,36307,55419,56951
6101,CA,9480,12784,8002,8509,6151,4344,6267,11538,7256.426551,6329,8401,47349,6320,-14294,4554,6350,55537,53669,33055,51903,53699
6103,CA,10080,12784,8002,8509,6151,4344,6348,11306,8575.776833,6329,8016,48651,6627,-13987,4993,6657,56218,55278,34664,53644,55308
6105,CA,11316,12784,8002,8509,6151,4344,6515,12784,8547.095305,6329,8509,51829,7240,-13374,5870,7270,57621,59069,38455,57699,59099
6107,CA,8988,12784,8002,8509,6151,4344,6201,10854,7801.375581,6329,8702,47018,6320,-14294,4554,6350,54979,53338,32724,51572,53368
6109,CA,11328,12784,8002,8509,6151,4344,6517,11664,10325.35003,6329,7705,51695,7240,-13374,5870,7270,57635,58935,38321,57565,58965
6111,CA,17748,12784,8002,8509,6151,4344,7385,14264,9321.496558,6329,9695,61701,10364,-9074,10315,10395,64923,72065,52627,72016,72096
6113,CA,13248,12784,8002,8509,6151,4344,6777,13059,8747.866,6329,8583,54311,8466,-12148,7624,8496,59815,62777,42163,61935,62807
6115,CA,9480,12784,8002,8509,6151,4344,6267,11406,7571.923358,6329,8404,47535,6320,-14294,4554,6350,55537,53855,33241,52089,53885
8001,CO,11520,7312,8002,8509,5956,4344,8247,8031,8030.827804,7085,9030,48040,6512,-13551,5429,7093,53890,54552,34489,53469,55133
8003,CO,7668,7312,8002,8509,5956,4344,7625,7312,8719.184473,7085,8509,43637,4879,-15184,3421,5460,49416,48516,28453,47058,49097
8005,CO,11520,7312,8002,8509,5956,4344,8247,8545,8633.139889,7085,9043,49170,6781,-13282,5830,7362,53890,55951,35888,55000,56532
8007,CO,8772,7312,8002,8509,5956,4344,7803,7312,8633.139889,7085,8509,44655,5360,-14703,3823,5941,50698,50015,29952,48478,50596
8009,CO,7644,7312,8002,8509,5956,4344,7621,7312,7457.197246,7085,8509,42351,4397,-15666,3020,4978,49388,46748,26685,45371,47329
8011,CO,7644,7312,8002,8509,5956,4344,7621,7312,7887.420164,7085,8509,42781,4397,-15666,3020,4978,49388,47178,27115,45801,47759
8013,CO,14136,7312,8002,8509,5956,4344,8669,8772,9723.037948,7085,8936,52996,7590,-12473,7035,8171,56928,60586,40523,60031,61167
8014,CO,11520,7312,8002,8509,5956,4344,8247,8541,10124.57934,7085,9018,50633,7051,-13012,6232,7632,53890,57684,37621,56865,58265
8015,CO,8364,7312,8002,8509,5956,4344,7737,7312,8575.776833,7085,8509,44190,5360,-14703,3823,5941,50224,49550,29487,48013,50131
8017,CO,7644,7312,8002,8509,5956,4344,7621,7312,8002.146276,7085,8509,42896,4397,-15666,3020,4978,49388,47293,27230,45916,47874
8019,CO,11520,7312,8002,8509,5956,4344,8247,7665,8891.27364,7085,8972,48477,6512,-13551,5429,7093,53890,54989,34926,53906,55570
8021,CO,7644,7312,8002,8509,5956,4344,7621,7312,8747.866,7085,8509,43642,4879,-15184,3421,5460,49388,48521,28458,47063,49102
8023,CO,7644,7312,8002,8509,5956,4344,7621,7312,8862.592112,7085,8509,43757,4879,-15184,3421,5460,49388,48636,28573,47178,49217
8025,CO,7644,7312,8002,8509,5956,4344,7621,7312,8346.32461,7085,8509,43240,4879,-15184,3421,5460,49388,48119,28056,46661,48700
8027,CO,7644,7312,8002,8509,5956,4344,7621,7312,7830.057109,7085,8509,42724,4397,-15666,3020,4978,49388,47121,27058,45744,47702
8029,CO,9120,7312,8002,8509,5956,4344,7859,7312,8633.139889,7085,8509,45003,5703,-14360,4224,6284,51102,50706,30643,49227,51287
8031,CO,11520,7312,8002,8509,5956,4344,8247,8491,8919.955168,7085,9075,49435,6781,-13282,5830,7362,53890,56216,36153,55265,56797
8033,CO,7644,7312,8002,8509,5956,4344,7621,7312,9378.859614,7085,8509,44273,5360,-14703,3823,5941,49388,49633,29570,48096,50214
8035,CO,11520,7312,8002,8509,5956,4344,8247,8967,8833.910584,7085,9005,49756,6781,-13282,5830,7362,53890,56537,36474,55586,57118
8037,CO,14328,7312,8002,8509,5956,4344,8700,10212,8518.413777,7085,9824,54311,8129,-11934,7838,8710,57151,62440,42377,62149,63021
8039,CO,11520,7312,8002,8509,5956,4344,8247,8307,9178.088918,7085,8976,49410,6781,-13282,5830,7362,53890,56191,36128,55240,56772
8041,CO,9684,7312,8002,8509,5956,4344,7950,7854,8288.961554,7085,8622,45878,5703,-14360,4224,6284,51757,51581,31518,50102,52162
8043,CO,7968,7312,8002,8509,5956,4344,7673,7007,8174.235443,7085,6971,41550,3916,-15927,2618,4497,49764,45466,25623,44168,46047
8045,CO,13440,7312,8002,8509,5956,4344,8557,8734,9178.088918,7085,9088,51869,7051,-13012,6232,7632,56120,58920,38857,58101,59501
8047,CO,11520,7312,8002,8509,5956,4344,8247,7551,8862.592112,7085,8959,48321,6512,-13551,5429,7093,53890,54833,34770,53750,55414
8049,CO,10680,7312,8002,8509,5956,4344,8111,7312,8977.318223,7085,8509,46907,5973,-14090,4626,6554,52914,52880,32817,51533,53461
8051,CO,10716,7312,8002,8509,5956,4344,8117,7312,8919.955168,7085,8509,46886,5973,-14090,4626,6554,52956,52859,32796,51512,53440
8053,CO,10344,7312,8002,8509,5956,4344,8057,7312,9780.401004,7085,8509,47374,6242,-13821,5027,6823,52524,53616,33553,52401,54197
8055,CO,8364,7312,8002,8509,5956,4344,7737,7312,8088.190859,7085,8509,43702,4879,-15184,3421,5460,50224,48581,28518,47123,49162
8057,CO,8340,7312,8002,8509,5956,4344,7733,7312,9780.401004,7085,8509,45370,5703,-14360,4224,6284,50196,51073,31010,49594,51654
8059,CO,11520,7312,8002,8509,5956,4344,8247,8393,8891.27364,7085,9028,49262,6781,-13282,5830,7362,53890,56043,35980,55092,56624
8061,CO,7644,7312,8002,8509,5956,4344,7621,7312,7944.78322,7085,8509,42839,4397,-15666,3020,4978,49388,47236,27173,45859,47817
8063,CO,7644,7312,8002,8509,5956,4344,7621,7312,7973.464748,7085,8509,42867,4397,-15666,3020,4978,49388,47264,27201,45887,47845
8065,CO,11772,7312,8002,8509,5956,4344,8287,7312,9579.630309,7085,8509,48602,6512,-13551,5429,7093,54182,55114,35051,54031,55695
8067,CO,11064,7312,8002,8509,5956,4344,8173,8277,10153.26087,7085,8480,49404,6781,-13282,5830,7362,53360,56185,36122,55234,56766
8069,CO,10752,7312,8002,8509,5956,4344,8123,8015,8977.318223,7085,8548,47721,6242,-13821,5027,6823,52998,53963,33900,52748,54544
8071,CO,8208,7312,8002,8509,5956,4344,7712,7312,8030.827804,7085,8509,43489,4879,-15184,3421,5460,50043,48368,28305,46910,48949
8073,CO,8256,7312,8002,8509,5956,4344,7720,7312,8719.184473,7085,8509,44225,5360,-14703,3823,5941,50099,49585,29522,48048,50166
8075,CO,7716,7312,8002,8509,5956,4344,7632,6677,8002.146276,7085,8321,42145,4397,-15666,3020,4978,49471,46542,26479,45165,47123
8077,CO,9180,7312,8002,8509,5956,4344,7869,7563,8403.687666,7085,8247,44822,5360,-14703,3823,5941,51172,50182,30119,48645,50763
8079,CO,9468,7312,8002,8509,5956,4344,7915,7312,9550.948781,7085,8509,46269,5973,-14090,4626,6554,51506,52242,32179,50895,52823
8081,CO,8856,7312,8002,8509,5956,4344,7816,7528,8919.955168,7085,8627,45360,5703,-14360,4224,6284,50795,51063,31000,49584,51644
8083,CO,7644,7312,8002,8509,5956,4344,7621,7312,8547.095305,7085,8509,43441,4879,-15184,3421,5460,49388,48320,28257,46862,48901
8085,CO,9120,7312,8002,8509,5956,4344,7859,7435,8833.910584,7085,8064,44882,5360,-14703,3823,5941,51102,50242,30179,48705,50823
8087,CO,7920,7312,8002,8509,5956,4344,7665,7091,8002.146276,7085,8347,42789,4397,-15666,3020,4978,49708,47186,27123,45809,47767
8089,CO,7644,7312,8002,8509,5956,4344,7621,7312,7801.375581,7085,8509,42695,4397,-15666,3020,4978,49388,47092,27029,45715,47673
8091,CO,12168,7312,8002,8509,5956,4344,8351,7312,8948.636696,7085,8509,48367,6512,-13551,5429,7093,54642,54879,34816,53796,55460
8093,CO,11520,7312,8002,8509,5956,4344,8247,7273,8633.139889,7085,8944,47798,6242,-13821,5027,6823,53890,54040,33977,52825,54621
8095,CO,7920,7312,8002,8509,5956,4344,7665,7312,8317.643082,7085,8509,43488,4879,-15184,3421,5460,49708,48367,28304,46909,48948
8097,CO,15972,7312,8002,8509,5956,4344,8966,9576,9292.81503,7085,9084,55354,8129,-11934,7838,8710,59061,63483,43420,63192,64064
8099,CO,7644,7312,8002,8509,5956,4344,7621,7312,7858.738636,7085,8509,42753,4397,-15666,3020,4978,49388,47150,27087,45773,47731
8101,CO,8316,7312,8002,8509,5956,4344,7729,6837,7744.012525,7085,7962,42288,4397,-15666,3020,4978,50168,46685,26622,45308,47266
8103,CO,8604,7312,8002,8509,5956,4344,7776,7312,9034.681279,7085,8509,44889,5360,-14703,3823,5941,50503,50249,30186,48712,50830
8105,CO,7644,7312,8002,8509,5956,4344,7621,7312,8948.636696,7085,8509,43843,4879,-15184,3421,5460,49388,48722,28659,47264,49303
8107,CO,12960,7312,8002,8509,5956,4344,8479,8988,11042.38823,7085,9002,53421,7590,-12473,7035,8171,55562,61011,40948,60456,61592
8109,CO,7644,7312,8002,8509,5956,4344,7621,7312,8862.592112,7085,8509,43757,4879,-15184,3421,5460,49388,48636,28573,47178,49217
8111,CO,10104,7312,8002,8509,5956,4344,8018,7312,9665.674892,7085,8509,47020,6242,-13821,5027,6823,52245,53262,33199,52047,53843
8113,CO,13428,7312,8002,8509,5956,4344,8555,7312,8776.547528,7085,8509,49455,6781,-13282,5830,7362,56106,56236,36173,55285,56817
8115,CO,7644,7312,8002,8509,5956,4344,7621,7312,8432.369194,7085,8509,43326,4879,-15184,3421,5460,49388,48205,28142,46747,48786
8117,CO,14796,7312,8002,8509,5956,4344,8776,9643,11013.7067,7085,9200,56082,8668,-11067,8641,9249,57695,64750,45015,64723,65331
8119,CO,10332,7312,8002,8509,5956,4344,8055,7346,9321.496558,7085,8602,47031,6242,-13821,5027,6823,52510,53273,33210,52058,53854
8121,CO,7740,7312,8002,8509,5956,4344,7636,7312,8375.006138,7085,8509,43365,4879,-15184,3421,5460,49499,48244,28181,46786,48825
8123,CO,8508,7312,8002,8509,5956,4344,7760,7609,8432.369194,7085,8783,44762,5360,-14703,3823,5941,50391,50122,30059,48585,50703
8125,CO,7644,7312,8002,8509,5956,4344,7621,7312,8002.146276,7085,8509,42896,4397,-15666,3020,4978,49388,47293,27230,45916,47874
9001,CT,16851,17079,7786,7901,7178,3987,9543,23298,9097.786375,8002,8837,70073,12489,-4764,13827,12587,70325,82562,65309,83900,82660
9003,CT,14040,17079,7786,7901,7178,3987,9078,18945,8093.122849,8002,8391,61458,9699,-9672,9717,9797,67049,71157,51786,71175,71255
9005,CT,11736,17079,7786,7901,7178,3987,8698,15774,8679.176573,8002,8440,56619,8593,-11625,8083,8691,64365,65212,44994,64702,65310
9007,CT,14512,17079,7786,7901,7178,3987,9156,17384,9209.415656,8002,8361,61456,9699,-9672,9717,9797,67599,71155,51784,71173,71253
9009,CT,13945,17079,7786,7901,7178,3987,9063,19968,8148.93749,8002,8323,62374,10252,-8695,10534,10350,66939,72626,53679,72908,72724
9011,CT,12499,17079,7786,7901,7178,3987,8824,16848,9069.879055,8002,8318,58723,9146,-10648,8900,9244,65254,67869,48075,67623,67967
9013,CT,14040,17079,7786,7901,7178,3987,9078,16441,8707.083893,8002,8365,59542,9146,-10648,8900,9244,67049,68688,48894,68442,68786
9015,CT,11256,17079,7786,7901,7178,3987,8618,15755,7786.142327,8002,8407,55194,8040,-12506,7266,8138,63805,63234,42688,62460,63332
10001,DE,10920,14062,6704,9859,6601,4284,7596,11661,6704.122548,8854,10020,52443,7481,-13163,6345,7481,60026,59924,39280,58788,59924
10003,DE,13620,14062,6704,9859,6601,4284,8012,19931,7328.879488,8854,10420,64438,10988,-8057,11172,10988,63142,75426,56381,75610,75426
10005,DE,10008,14062,6704,9859,6601,4284,7455,11906,7304.850375,8854,9702,52059,6917,-13727,5517,6917,58973,58976,38332,57576,58976
12001,FL,10428,15750,6704,9859,7312,4284,5641,17622,7641.257958,6718,9292,55985,6387,-14257,5515,6387,59978,62372,41728,61500,62372
12003,FL,8772,15750,6704,9859,7312,4284,5450,16570,6656.064322,6718,9837,52837,5934,-14710,4798,5934,58131,58771,38127,57635,58771
12005,FL,10344,15750,6704,9859,7312,4284,5632,17205,7304.850375,6718,9542,55398,6387,-14257,5515,6387,59885,61785,41141,60913,61785
12007,FL,7644,15750,6704,9859,7312,4284,5320,15750,6295.627626,6718,9859,50551,5481,-15163,4081,5481,56873,56032,35388,54632,56032
12009,FL,10344,15750,6704,9859,7312,4284,5632,16372,6944.413679,6718,9342,54005,5934,-14710,4798,5934,59885,59939,39295,58803,59939
12011,FL,15120,15750,6704,9859,7312,4284,6182,20767,7497.08328,6718,9913,64299,8199,-10846,8383,8199,65211,72498,53453,72682,72498
12013,FL,7644,15750,6704,9859,7312,4284,5320,15750,7160.675697,6718,9859,51416,5481,-15163,4081,5481,56873,56897,36253,55497,56897
12015,FL,10308,15750,6704,9859,7312,4284,5627,16020,7208.733923,6718,8675,53214,5934,-14710,4798,5934,59844,59148,38504,58012,59148
12017,FL,8964,15750,6704,9859,7312,4284,5473,14829,7304.850375,6718,8234,50335,5254,-15390,3722,5254,58346,55589,34945,54057,55589
12019,FL,11220,15750,6704,9859,7312,4284,5732,16272,7232.763036,6718,9837,55564,6387,-14257,5515,6387,60861,61951,41307,61079,61951
12021,FL,12072,15750,6704,9859,7312,4284,5831,21323,7449.025054,6718,9655,61501,7746,-11723,7666,7746,61812,69247,49778,69167,69247
12023,FL,9372,15750,6704,9859,7312,4284,5520,16036,6776.209888,6718,8847,52033,5481,-15163,4081,5481,58801,57514,36870,56114,57514
12027,FL,7848,15750,6704,9859,7312,4284,5344,16646,6632.035209,6718,8926,51053,5481,-15163,4081,5481,57101,56534,35890,55134,56534
12029,FL,7644,15750,6704,9859,7312,4284,5320,15750,6704.122548,6718,9859,50959,5481,-15163,4081,5481,56873,56440,35796,55040,56440
12031,FL,11220,15750,6704,9859,7312,4284,5732,16810,7112.617471,6718,9836,55981,6387,-14257,5515,6387,60861,62368,41724,61496,62368
12033,FL,9960,15750,6704,9859,7312,4284,5587,15366,6920.384566,6718,9546,52794,5934,-14710,4798,5934,59456,58728,38084,57592,58728
12035,FL,11988,15750,6704,9859,7312,4284,5821,15368,7521.112393,6718,9197,55076,6387,-14257,5515,6387,61718,61463,40819,60591,61463
12037,FL,8436,15750,6704,9859,7312,4284,5412,15750,6632.035209,6718,9859,51679,5481,-15163,4081,5481,57757,57160,36516,55760,57160
12039,FL,10920,15750,6704,9859,7312,4284,5698,15065,6583.976983,6718,9502,53073,5934,-14710,4798,5934,60527,59007,38363,57871,59007
12041,FL,10428,15750,6704,9859,7312,4284,5641,17001,7328.879488,6718,9333,55092,6387,-14257,5515,6387,59978,61479,40835,60607,61479
12043,FL,8952,15750,6704,9859,7312,4284,5471,15750,7424.995941,6718,9859,52988,5934,-14710,4798,5934,58332,58922,38278,57786,58922
12045,FL,8484,15750,6704,9859,7312,4284,5417,15939,7256.792149,6718,9552,52235,5481,-15163,4081,5481,57810,57716,37072,56316,57716
12047,FL,7644,15750,6704,9859,7312,4284,5320,15750,6608.006096,6718,9859,50863,5481,-15163,4081,5481,56873,56344,35700,54944,56344
12049,FL,8136,15750,6704,9859,7312,4284,5377,15619,6343.685852,6718,9516,50617,5481,-15163,4081,5481,57422,56098,35454,54698,56098
12051,FL,9336,15750,6704,9859,7312,4284,5515,15844,6608.006096,6718,9297,52087,5934,-14710,4798,5934,58760,58021,37377,56885,58021
12053,FL,11412,15750,6704,9859,7312,4284,5755,14568,6944.413679,6718,9437,53363,5934,-14710,4798,5934,61076,59297,38653,58161,59297
12055,FL,8364,15750,6704,9859,7312,4284,5403,15500,6944.413679,6718,8266,50076,5254,-15390,3722,5254,57676,55330,34686,53798,55330
12057,FL,11412,15750,6704,9859,7312,4284,5755,17772,7136.646584,6718,9379,56701,6840,-13476,6232,6840,61076,63541,43225,62933,63541
12059,FL,7644,15750,6704,9859,7312,4284,5320,15750,7545.141506,6718,9859,51800,5481,-15163,4081,5481,56873,57281,36637,55881,57281
12061,FL,10368,15750,6704,9859,7312,4284,5634,17089,7617.228845,6718,8968,55044,6387,-14257,5515,6387,59911,61431,40787,60559,61431
12063,FL,7644,15750,6704,9859,7312,4284,5320,15750,7040.530132,6718,9859,51296,5481,-15163,4081,5481,56873,56777,36133,55377,56777
12065,FL,10920,15750,6704,9859,7312,4284,5698,15563,6944.413679,6718,9509,53938,5934,-14710,4798,5934,60527,59872,39228,58736,59872
12067,FL,7644,15750,6704,9859,7312,4284,5320,15750,6680.093435,6718,9859,50935,5481,-15163,4081,5481,56873,56416,35772,55016,56416
12069,FL,11796,15750,6704,9859,7312,4284,5799,16168,6968.442792,6718,9964,55899,6387,-14257,5515,6387,61504,62286,41642,61414,62286
12071,FL,10716,15750,6704,9859,7312,4284,5674,17969,7184.70481,6718,9361,56233,6387,-14257,5515,6387,60299,62620,41976,61748,62620
12073,FL,10920,15750,6704,9859,7312,4284,5698,17612,7208.733923,6718,9474,56217,6387,-14257,5515,6387,60527,62604,41960,61732,62604
12075,FL,7644,15750,6704,9859,7312,4284,5320,15750,6704.122548,6718,9859,50959,5481,-15163,4081,5481,56873,56440,35796,55040,56440
12077,FL,7644,15750,6704,9859,7312,4284,5320,15750,7112.617471,6718,9859,51368,5481,-15163,4081,5481,56873,56849,36205,55449,56849
12079,FL,7884,15750,6704,9859,7312,4284,5348,15750,6920.384566,6718,9859,51415,5481,-15163,4081,5481,57141,56896,36252,55496,56896
12081,FL,12132,15750,6704,9859,7312,4284,5837,18363,7521.112393,6718,9080,58098,6840,-13476,6232,6840,61878,64938,44622,64330,64938
12083,FL,9444,15750,6704,9859,7312,4284,5528,15153,6728.151662,6718,8574,50901,5481,-15163,4081,5481,58881,56382,35738,54982,56382
12085,FL,11112,15750,6704,9859,7312,4284,5720,19409,8266.014898,6718,9240,59029,6840,-13476,6232,6840,60741,65869,45553,65261,65869
12086,FL,13992,15750,6704,9859,7312,4284,6052,20434,7617.228845,6718,9916,62961,8199,-10846,8383,8199,63953,71160,52115,71344,71160
12087,FL,16392,15750,6704,9859,7312,4284,6328,21330,8722.568047,6718,9935,67382,8652,-9970,9100,8652,66629,76034,57412,76482,76034
12089,FL,11220,15750,6704,9859,7312,4284,5732,17505,7713.345298,6718,9838,57278,6840,-13476,6232,6840,60861,64118,43802,63510,64118
12091,FL,10668,15750,6704,9859,7312,4284,5669,16738,7352.908602,6718,9702,55463,6387,-14257,5515,6387,60246,61850,41206,60978,61850
12093,FL,9108,15750,6704,9859,7312,4284,5489,16190,6680.093435,6718,8845,51825,5481,-15163,4081,5481,58506,57306,36662,55906,57306
12095,FL,11796,15750,6704,9859,7312,4284,5799,17999,6992.471905,6718,9979,57769,6840,-13476,6232,6840,61504,64609,44293,64001,64609
12097,FL,11796,15750,6704,9859,7312,4284,5799,17092,6632.035209,6718,9971,56493,6840,-13476,6232,6840,61504,63333,43017,62725,63333
12099,FL,14424,15750,6704,9859,7312,4284,6102,20372,7665.287072,6718,9908,63372,8199,-10846,8383,8199,64435,71571,52526,71755,71571
12101,FL,11412,15750,6704,9859,7312,4284,5755,16487,7160.675697,6718,9412,55473,6387,-14257,5515,6387,61076,61860,41216,60988,61860
12103,FL,11412,15750,6704,9859,7312,4284,5755,18472,7256.792149,6718,9351,57494,6840,-13476,6232,6840,61076,64334,44018,63726,64334
12105,FL,9684,15750,6704,9859,7312,4284,5555,16114,6728.151662,6718,9457,52985,5934,-14710,4798,5934,59148,58919,38275,57783,58919
12107,FL,7812,15750,6704,9859,7312,4284,5340,15953,6728.151662,6718,8440,49935,5254,-15390,3722,5254,57061,55189,34545,53657,55189
12109,FL,11220,15750,6704,9859,7312,4284,5732,18531,8169.898446,6718,9837,58760,6840,-13476,6232,6840,60861,65600,45284,64992,65600
12111,FL,11112,15750,6704,9859,7312,4284,5720,15896,7136.646584,6718,9266,54413,5934,-14710,4798,5934,60741,60347,39703,59211,60347
12113,FL,9960,15750,6704,9859,7312,4284,5587,15658,7641.257958,6718,9555,53817,5934,-14710,4798,5934,59456,59751,39107,58615,59751
12115,FL,12132,15750,6704,9859,7312,4284,5837,17772,7689.316185,6718,9089,57685,6840,-13476,6232,6840,61878,64525,44209,63917,64525
12117,FL,11796,15750,6704,9859,7312,4284,5799,17658,7016.501018,6718,9974,57447,6840,-13476,6232,6840,61504,64287,43971,63679,64287
12119,FL,8556,15750,6704,9859,7312,4284,5426,13941,7256.792149,6718,7994,48750,5028,-15616,3364,5028,57891,53778,33134,52114,53778
12121,FL,7728,15750,6704,9859,7312,4284,5330,15750,6632.035209,6718,9859,50971,5481,-15163,4081,5481,56967,56452,35808,55052,56452
12123,FL,7644,15750,6704,9859,7312,4284,5320,15750,6776.209888,6718,9859,51031,5481,-15163,4081,5481,56873,56512,35868,55112,56512
12125,FL,7644,15750,6704,9859,7312,4284,5320,15750,7328.879488,6718,9859,51584,5481,-15163,4081,5481,56873,57065,36421,55665,57065
12127,FL,10536,15750,6704,9859,7312,4284,5654,16139,7304.850375,6718,9189,54171,5934,-14710,4798,5934,60099,60105,39461,58969,60105
12129,FL,9108,15750,6704,9859,7312,4284,5489,16241,6848.297227,6718,9502,52702,5934,-14710,4798,5934,58506,58636,37992,57500,58636
12131,FL,10620,15750,6704,9859,7312,4284,5663,16914,8097.811107,6718,9712,56346,6387,-14257,5515,6387,60192,62733,42089,61861,62733
12133,FL,7644,15750,6704,9859,7312,4284,5320,15750,6608.006096,6718,9859,50863,5481,-15163,4081,5481,56873,56344,35700,54944,56344
13001,GA,7632,21631,6704,9859,6066,4284,5846,21631,6343.685852,6538,9859,56288,9183,-11122,8586,9194,62022,65471,45166,64874,65482
13003,GA,7632,21631,6704,9859,6066,4284,5846,21631,6199.511174,6538,9859,56144,9183,-11122,8586,9194,62022,65327,45022,64730,65338
13005,GA,7632,21631,6704,9859,6066,4284,5846,21631,6247.5694,6538,9859,56192,9183,-11122,8586,9194,62022,65375,45070,64778,65386
13007,GA,8400,21631,6704,9859,6066,4284,5950,23419,6728.151662,6538,8887,58257,9756,-10125,9423,9767,62894,68013,48132,67680,68024
13009,GA,8520,21631,6704,9859,6066,4284,5966,22684,6848.297227,6538,8446,57321,9183,-11122,8586,9194,63030,66504,46199,65907,66515
13011,GA,8424,21631,6704,9859,6066,4284,5953,21631,6800.239001,6538,9859,57536,9183,-11122,8586,9194,62921,66719,46414,66122,66730
13013,GA,10752,21631,6704,9859,6066,4284,6268,21015,6391.744078,6538,10081,59062,9756,-10125,9423,9767,65564,68818,48937,68485,68829
13015,GA,10752,21631,6704,9859,6066,4284,6268,22008,6704.122548,6538,10088,60374,10329,-9129,10260,10340,65564,70703,51245,70634,70714
13017,GA,7956,21631,6704,9859,6066,4284,5890,20768,6487.860531,6538,8451,54485,8610,-12023,7749,8621,62390,63095,42462,62234,63106
13019,GA,7632,21631,6704,9859,6066,4284,5846,21631,6583.976983,6538,9859,56528,9183,-11122,8586,9194,62022,65711,45406,65114,65722
13021,GA,8760,21631,6704,9859,6066,4284,5998,21702,6439.802305,6538,9366,57089,9183,-11122,8586,9194,63302,66272,45967,65675,66283
13023,GA,7632,21631,6704,9859,6066,4284,5846,21631,6632.035209,6538,9859,56576,9183,-11122,8586,9194,62022,65759,45454,65162,65770
13025,GA,8040,21631,6704,9859,6066,4284,5901,22813,6896.355453,6538,9439,58011,9183,-11122,8586,9194,62485,67194,46889,66597,67205
13027,GA,8628,21631,6704,9859,6066,4284,5981,21307,6680.093435,6538,9062,56499,9183,-11122,8586,9194,63153,65682,45377,65085,65693
13029,GA,10320,21631,6704,9859,6066,4284,6209,23676,7545.141506,6538,9774,62137,10329,-9129,10260,10340,65073,72466,53008,72397,72477
13031,GA,8700,21631,6704,9859,6066,4284,5990,23265,6944.413679,6538,8899,58631,9756,-10125,9423,9767,63234,68387,48506,68054,68398
13033,GA,8760,21631,6704,9859,6066,4284,5998,21601,6295.627626,6538,9611,57090,9183,-11122,8586,9194,63302,66273,45968,65676,66284
13035,GA,9228,21631,6704,9859,6066,4284,6062,20934,8386.160464,6538,10078,59448,9183,-11122,8586,9194,63834,68631,48326,68034,68642
13037,GA,7632,21631,6704,9859,6066,4284,5846,21631,6728.151662,6538,9859,56672,9183,-11122,8586,9194,62022,65855,45550,65258,65866
13039,GA,9756,21631,6704,9859,6066,4284,6133,23464,6968.442792,6538,9954,60964,10329,-9129,10260,10340,64433,71293,51835,71224,71304
13043,GA,7632,21631,6704,9859,6066,4284,5846,21631,6632.035209,6538,9859,56576,9183,-11122,8586,9194,62022,65759,45454,65162,65770
13045,GA,10752,21631,6704,9859,6066,4284,6268,21603,6920.384566,6538,10088,60185,9756,-10125,9423,9767,65564,69941,50060,69608,69952
13047,GA,8148,21631,6704,9859,6066,4284,5916,21495,6367.714965,6538,9508,56340,9183,-11122,8586,9194,62608,65523,45218,64926,65534
13049,GA,7704,21631,6704,9859,6066,4284,5856,21631,7280.821262,6538,9859,57297,9183,-11122,8586,9194,62104,66480,46175,65883,66491
13051,GA,10320,21631,6704,9859,6066,4284,6209,24261,7088.588358,6538,9767,62258,10329,-9129,10260,10340,65073,72587,53129,72518,72598
13053,GA,8460,21631,6704,9859,6066,4284,5958,25177,7184.70481,6538,9413,61057,10329,-9129,10260,10340,62962,71386,51928,71317,71397
13055,GA,7632,21631,6704,9859,6066,4284,5846,20422,6439.802305,6538,8546,53861,8610,-12023,7749,8621,62022,62471,41838,61610,62482
13057,GA,10752,21631,6704,9859,6066,4284,6268,23581,7040.530132,6538,10077,62272,10329,-9129,10260,10340,65564,72601,53143,72532,72612
13059,GA,8652,21631,6704,9859,6066,4284,5984,23997,6776.209888,6538,9566,59813,9756,-10125,9423,9767,63180,69569,49688,69236,69580
13061,GA,7932,21631,6704,9859,6066,4284,5887,21631,6968.442792,6538,9859,57212,9183,-11122,8586,9194,62363,66395,46090,65798,66406
13063,GA,10752,21631,6704,9859,6066,4284,6268,22728,5742.958025,6538,10099,60144,10329,-9129,10260,10340,65564,70473,51015,70404,70484
13065,GA,7632,21631,6704,9859,6066,4284,5846,21631,6583.976983,6538,9859,56528,9183,-11122,8586,9194,62022,65711,45406,65114,65722
13067,GA,10752,21631,6704,9859,6066,4284,6268,25185,7040.530132,6538,10099,63899,10902,-8132,11097,10913,65564,74801,55767,74996,74812
13069,GA,7632,21631,6704,9859,6066,4284,5846,21704,6319.656739,6538,8863,55340,8610,-12023,7749,8621,62022,63950,43317,63089,63961
13071,GA,7632,21631,6704,9859,6066,4284,5846,21852,6367.714965,6538,8986,55659,8610,-12023,7749,8621,62022,64269,43636,63408,64280
13073,GA,8760,21631,6704,9859,6066,4284,5998,22977,6992.471905,6538,9620,59172,9756,-10125,9423,9767,63302,68928,49047,68595,68939
13075,GA,7860,21631,6704,9859,6066,4284,5877,21631,6632.035209,6538,9859,56804,9183,-11122,8586,9194,62281,65987,45682,65390,65998
13077,GA,10752,21631,6704,9859,6066,4284,6268,21929,7112.617471,6538,10074,60689,10329,-9129,10260,10340,65564,71018,51560,70949,71029
13079,GA,8760,21631,6704,9859,6066,4284,5998,23051,6511.889644,6538,9392,58537,9756,-10125,9423,9767,63302,68293,48412,67960,68304
13081,GA,7704,21631,6704,9859,6066,4284,5856,21022,6608.006096,6538,8745,54901,8610,-12023,7749,8621,62104,63511,42878,62650,63522
13083,GA,8148,21631,6704,9859,6066,4284,5916,21013,6656.064322,6538,9510,56149,9183,-11122,8586,9194,62608,65332,45027,64735,65343
13085,GA,10752,21631,6704,9859,6066,4284,6268,23349,6824.268114,6538,10077,61824,10329,-9129,10260,10340,65564,72153,52695,72084,72164
13087,GA,7848,21631,6704,9859,6066,4284,5875,21290,6968.442792,6538,8541,55470,8610,-12023,7749,8621,62267,64080,43447,63219,64091
13089,GA,10752,21631,6704,9859,6066,4284,6268,25755,6944.413679,6538,10125,64398,11475,-7136,11934,11486,65564,75873,57262,76332,75884
13091,GA,7632,21631,6704,9859,6066,4284,5846,21631,6487.860531,6538,9859,56432,9183,-11122,8586,9194,62022,65615,45310,65018,65626
13093,GA,7632,21631,6704,9859,6066,4284,5846,21631,6656.064322,6538,9859,56600,9183,-11122,8586,9194,62022,65783,45478,65186,65794
13095,GA,8400,21631,6704,9859,6066,4284,5950,21806,6608.006096,6538,8752,56389,9183,-11122,8586,9194,62894,65572,45267,64975,65583
13097,GA,10752,21631,6704,9859,6066,4284,6268,22774,6463.831418,6538,10081,60893,10329,-9129,10260,10340,65564,71222,51764,71153,71233
13099,GA,7632,21631,6704,9859,6066,4284,5846,21631,6944.413679,6538,9859,56888,9183,-11122,8586,9194,62022,66071,45766,65474,66082
13101,GA,8628,21631,6704,9859,6066,4284,5981,23677,6728.151662,6538,9068,58924,9756,-10125,9423,9767,63153,68680,48799,68347,68691
13103,GA,10320,21631,6704,9859,6066,4284,6209,23677,6704.122548,6538,9771,61294,10329,-9129,10260,10340,65073,71623,52165,71554,71634
13105,GA,7632,21631,6704,9859,6066,4284,5846,21631,6704.122548,6538,9859,56648,9183,-11122,8586,9194,62022,65831,45526,65234,65842
13107,GA,7632,21631,6704,9859,6066,4284,5846,21631,6151.452948,6538,9859,56095,9183,-11122,8586,9194,62022,65278,44973,64681,65289
13109,GA,7632,21631,6704,9859,6066,4284,5846,21631,6824.268114,6538,9859,56768,9183,-11122,8586,9194,62022,65951,45646,65354,65962
13111,GA,7632,21631,6704,9859,6066,4284,5846,21631,7184.70481,6538,9859,57129,9183,-11122,8586,9194,62022,66312,46007,65715,66323
13113,GA,10752,21631,6704,9859,6066,4284,6268,24903,7304.850375,6538,10086,63868,10902,-8132,11097,10913,65564,74770,55736,74965,74781
13115,GA,8088,21631,6704,9859,6066,4284,5908,21229,6511.889644,6538,9385,56035,9183,-11122,8586,9194,62540,65218,44913,64621,65229
13117,GA,10752,21631,6704,9859,6066,4284,6268,25378,8097.811107,6538,10079,65128,10902,-8132,11097,10913,65564,76030,56996,76225,76041
13119,GA,7632,21631,6704,9859,6066,4284,5846,21631,6992.471905,6538,9859,56936,9183,-11122,8586,9194,62022,66119,45814,65522,66130
13121,GA,10752,21631,6704,9859,6066,4284,6268,27959,7424.995941,6538,10129,67088,12048,-6139,12771,12059,65564,79136,60949,79859,79147
13123,GA,8340,21631,6704,9859,6066,4284,5942,21631,6704.122548,6538,9859,57356,9183,-11122,8586,9194,62826,66539,46234,65942,66550
13125,GA,7632,21631,6704,9859,6066,4284,5846,21631,6487.860531,6538,9859,56432,9183,-11122,8586,9194,62022,65615,45310,65018,65626
13127,GA,8040,21631,6704,9859,6066,4284,5901,23805,7473.054167,6538,9400,59540,9756,-10125,9423,9767,62485,69296,49415,68963,69307
13129,GA,8460,21631,6704,9859,6066,4284,5958,21256,6608.006096,6538,9690,56836,9183,-11122,8586,9194,62962,66019,45714,65422,66030
13131,GA,7632,21631,6704,9859,6066,4284,5846,21631,6439.802305,6538,9859,56384,9183,-11122,8586,9194,62022,65567,45262,64970,65578
13133,GA,7836,21631,6704,9859,6066,4284,5874,21631,6896.355453,6538,9859,57044,9183,-11122,8586,9194,62254,66227,45922,65630,66238
13135,GA,10752,21631,6704,9859,6066,4284,6268,24314,6632.035209,6538,10092,62612,10902,-8132,11097,10913,65564,73514,54480,73709,73525
13137,GA,7632,21631,6704,9859,6066,4284,5846,21428,6824.268114,6538,9064,55770,8610,-12023,7749,8621,62022,64380,43747,63519,64391
13139,GA,9780,21631,6704,9859,6066,4284,6136,22911,6728.151662,6538,10096,60338,10329,-9129,10260,10340,64460,70667,51209,70598,70678
13141,GA,7632,21631,6704,9859,6066,4284,5846,22404,6920.384566,6538,8548,56327,9183,-11122,8586,9194,62022,65510,45205,64913,65521
13143,GA,7632,21631,6704,9859,6066,4284,5846,21308,6632.035209,6538,10080,56474,9183,-11122,8586,9194,62022,65657,45352,65060,65668
13145,GA,8460,21631,6704,9859,6066,4284,5958,22407,7376.937715,6538,9454,58520,9183,-11122,8586,9194,62962,67703,47398,67106,67714
13147,GA,7632,21631,6704,9859,6066,4284,5846,21631,6632.035209,6538,9859,56576,9183,-11122,8586,9194,62022,65759,45454,65162,65770
13149,GA,10752,21631,6704,9859,6066,4284,6268,22291,6920.384566,6538,10075,60861,10329,-9129,10260,10340,65564,71190,51732,71121,71201
13151,GA,10752,21631,6704,9859,6066,4284,6268,22427,6487.860531,6538,10083,60572,10329,-9129,10260,10340,65564,70901,51443,70832,70912
13153,GA,9120,21631,6704,9859,6066,4284,6047,21610,6632.035209,6538,9876,58059,9756,-10125,9423,9767,63711,67815,47934,67482,67826
13155,GA,7632,21631,6704,9859,6066,4284,5846,21631,6463.831418,6538,9859,56408,9183,-11122,8586,9194,62022,65591,45286,64994,65602
13157,GA,9324,21631,6704,9859,6066,4284,6075,22592,7497.08328,6538,9941,60175,9756,-10125,9423,9767,63943,69931,50050,69598,69942
13159,GA,10752,21631,6704,9859,6066,4284,6268,21059,6487.860531,6538,10069,59190,9756,-10125,9423,9767,65564,68946,49065,68613,68957
13161,GA,7632,21631,6704,9859,6066,4284,5846,21631,6367.714965,6538,9859,56312,9183,-11122,8586,9194,62022,65495,45190,64898,65506
13163,GA,7632,21631,6704,9859,6066,4284,5846,21631,6608.006096,6538,9859,56552,9183,-11122,8586,9194,62022,65735,45430,65138,65746
13165,GA,7632,21631,6704,9859,6066,4284,5846,21631,6656.064322,6538,9859,56600,9183,-11122,8586,9194,62022,65783,45478,65186,65794
13167,GA,7632,21631,6704,9859,6066,4284,5846,20002,6415.773192,6538,8820,53692,8037,-12596,6912,8048,62022,61729,41096,60604,61740
13169,GA,8760,21631,6704,9859,6066,4284,5998,22425,5694.899799,6538,9412,57114,9756,-10125,9423,9767,63302,66870,46989,66537,66881
13171,GA,7632,21631,6704,9859,6066,4284,5846,21780,6632.035209,6538,10081,56947,9183,-11122,8586,9194,62022,66130,45825,65533,66141
13173,GA,8628,21631,6704,9859,6066,4284,5981,22180,6632.035209,6538,9048,57310,9183,-11122,8586,9194,63153,66493,46188,65896,66504
13175,GA,7632,21631,6704,9859,6066,4284,5846,21597,6632.035209,6538,8770,55453,8610,-12023,7749,8621,62022,64063,43430,63202,64074
13177,GA,8400,21631,6704,9859,6066,4284,5950,22379,7184.70481,6538,8845,57630,9183,-11122,8586,9194,62894,66813,46508,66216,66824
13179,GA,8964,21631,6704,9859,6066,4284,6026,23708,6583.976983,6538,9740,59818,9756,-10125,9423,9767,63534,69574,49693,69241,69585
13181,GA,7632,21631,6704,9859,6066,4284,5846,22847,6920.384566,6538,9613,57835,9183,-11122,8586,9194,62022,67018,46713,66421,67029
13183,GA,7632,21631,6704,9859,6066,4284,5846,23974,6463.831418,6538,9750,58641,9756,-10125,9423,9767,62022,68397,48516,68064,68408
13185,GA,8628,21631,6704,9859,6066,4284,5981,21868,6776.209888,6538,9004,57098,9183,-11122,8586,9194,63153,66281,45976,65684,66292
13187,GA,8952,21631,6704,9859,6066,4284,6024,21631,7208.733923,6538,9859,58473,9183,-11122,8586,9194,63520,67656,47351,67059,67667
13189,GA,8760,21631,6704,9859,6066,4284,5998,21491,6535.918757,6538,9606,57215,9183,-11122,8586,9194,63302,66398,46093,65801,66409
13191,GA,8040,21631,6704,9859,6066,4284,5901,24049,6968.442792,6538,9435,59314,9756,-10125,9423,9767,62485,69070,49189,68737,69081
13193,GA,7632,21631,6704,9859,6066,4284,5846,21631,6656.064322,6538,9859,56600,9183,-11122,8586,9194,62022,65783,45478,65186,65794
13195,GA,8652,21631,6704,9859,6066,4284,5984,21740,7040.530132,6538,9586,57841,9183,-11122,8586,9194,63180,67024,46719,66427,67035
13197,GA,8460,21631,6704,9859,6066,4284,5958,22411,6439.802305,6538,9425,57558,9183,-11122,8586,9194,62962,66741,46436,66144,66752
13199,GA,7632,21631,6704,9859,6066,4284,5846,20881,7328.879488,6538,10075,56739,9183,-11122,8586,9194,62022,65922,45617,65325,65933
13201,GA,7632,21631,6704,9859,6066,4284,5846,21631,6824.268114,6538,9859,56768,9183,-11122,8586,9194,62022,65951,45646,65354,65962
13205,GA,8268,21631,6704,9859,6066,4284,5932,21631,6632.035209,6538,9859,57212,9183,-11122,8586,9194,62744,66395,46090,65798,66406
13207,GA,7812,21631,6704,9859,6066,4284,5870,22723,6704.122548,6538,9384,57445,9183,-11122,8586,9194,62226,66628,46323,66031,66639
13209,GA,7632,21631,6704,9859,6066,4284,5846,21809,6319.656739,6538,8698,55281,8610,-12023,7749,8621,62022,63891,43258,63030,63902
13211,GA,8388,21631,6704,9859,6066,4284,5948,21982,6728.151662,6538,10072,57992,9183,-11122,8586,9194,62880,67175,46870,66578,67186
13213,GA,8004,21631,6704,9859,6066,4284,5896,22080,6920.384566,6538,9367,57194,9183,-11122,8586,9194,62444,66377,46072,65780,66388
13215,GA,8460,21631,6704,9859,6066,4284,5958,22152,7424.995941,6538,9393,58252,9183,-11122,8586,9194,62962,67435,47130,66838,67446
13217,GA,10752,21631,6704,9859,6066,4284,6268,21152,6391.744078,6538,10081,59198,9756,-10125,9423,9767,65564,68954,49073,68621,68965
13219,GA,8652,21631,6704,9859,6066,4284,5984,23563,7352.908602,6538,9610,60000,9756,-10125,9423,9767,63180,69756,49875,69423,69767
13221,GA,8652,21631,6704,9859,6066,4284,5984,22016,7040.530132,6538,9600,58130,9183,-11122,8586,9194,63180,67313,47008,66716,67324
13223,GA,10752,21631,6704,9859,6066,4284,6268,21144,6511.889644,6538,10076,59306,9756,-10125,9423,9767,65564,69062,49181,68729,69073
13225,GA,7692,21631,6704,9859,6066,4284,5854,21512,6271.598513,6538,9875,56173,9183,-11122,8586,9194,62090,65356,45051,64759,65367
13227,GA,10752,21631,6704,9859,6066,4284,6268,22501,7040.530132,6538,10080,61195,10329,-9129,10260,10340,65564,71524,52066,71455,71535
13229,GA,7632,21631,6704,9859,6066,4284,5846,21475,6247.5694,6538,8712,54889,8610,-12023,7749,8621,62022,63499,42866,62638,63510
13231,GA,10752,21631,6704,9859,6066,4284,6268,22219,6632.035209,6538,10072,60498,10329,-9129,10260,10340,65564,70827,51369,70758,70838
13233,GA,8052,21631,6704,9859,6066,4284,5903,20962,6559.94787,6538,9106,55502,8610,-12023,7749,8621,62499,64112,43479,63251,64123
13235,GA,7632,21631,6704,9859,6066,4284,5846,20774,6583.976983,6538,9875,55687,8610,-12023,7749,8621,62022,64297,43664,63436,64308
13237,GA,9684,21631,6704,9859,6066,4284,6123,21631,6656.064322,6538,9859,58652,9756,-10125,9423,9767,64351,68408,48527,68075,68419
13239,GA,7632,21631,6704,9859,6066,4284,5846,21631,7112.617471,6538,9859,57057,9183,-11122,8586,9194,62022,66240,45935,65643,66251
13241,GA,9204,21631,6704,9859,6066,4284,6059,21631,6728.151662,6538,9859,58244,9756,-10125,9423,9767,63807,68000,48119,67667,68011
13243,GA,7632,21631,6704,9859,6066,4284,5846,21631,7088.588358,6538,9859,57033,9183,-11122,8586,9194,62022,66216,45911,65619,66227
13245,GA,8760,21631,6704,9859,6066,4284,5998,22190,6511.889644,6538,9609,57892,9756,-10125,9423,9767,63302,67648,47767,67315,67659
13247,GA,10752,21631,6704,9859,6066,4284,6268,22467,6367.714965,6538,10081,60490,10329,-9129,10260,10340,65564,70819,51361,70750,70830
13249,GA,7632,21631,6704,9859,6066,4284,5846,22094,6680.093435,6538,8871,56099,9183,-11122,8586,9194,62022,65282,44977,64685,65293
13251,GA,7632,21631,6704,9859,6066,4284,5846,21631,6656.064322,6538,9859,56600,9183,-11122,8586,9194,62022,65783,45478,65186,65794
13253,GA,7632,21631,6704,9859,6066,4284,5846,21631,6968.442792,6538,9859,56912,9183,-11122,8586,9194,62022,66095,45790,65498,66106
13255,GA,10752,21631,6704,9859,6066,4284,6268,21334,6680.093435,6538,10089,59677,9756,-10125,9423,9767,65564,69433,49552,69100,69444
13257,GA,8232,21631,6704,9859,6066,4284,5927,21613,6752.180775,6538,8996,56415,9183,-11122,8586,9194,62703,65598,45293,65001,65609
13259,GA,7632,21631,6704,9859,6066,4284,5846,21631,7112.617471,6538,9859,57057,9183,-11122,8586,9194,62022,66240,45935,65643,66251
13261,GA,7632,21631,6704,9859,6066,4284,5846,21351,6776.209888,6538,8819,55400,8610,-12023,7749,8621,62022,64010,43377,63149,64021
13263,GA,8568,21631,6704,9859,6066,4284,5973,21631,7136.646584,6538,9859,58017,9183,-11122,8586,9194,63085,67200,46895,66603,67211
13265,GA,9840,21631,6704,9859,6066,4284,6144,21631,7232.763036,6538,9859,59385,9756,-10125,9423,9767,64528,69141,49260,68808,69152
13267,GA,7632,21631,6704,9859,6066,4284,5846,21631,6247.5694,6538,9859,56192,9183,-11122,8586,9194,62022,65375,45070,64778,65386
13269,GA,7632,21631,6704,9859,6066,4284,5846,21631,6656.064322,6538,9859,56600,9183,-11122,8586,9194,62022,65783,45478,65186,65794
13271,GA,7632,21631,6704,9859,6066,4284,5846,21631,6391.744078,6538,9859,56336,9183,-11122,8586,9194,62022,65519,45214,64922,65530
13273,GA,8400,21631,6704,9859,6066,4284,5950,19390,6728.151662,6538,8854,54194,8610,-12023,7749,8621,62894,62804,42171,61943,62815
13275,GA,8376,21631,6704,9859,6066,4284,5947,21517,7016.501018,6538,8576,56308,8610,-12023,7749,8621,62867,64918,44285,64057,64929
13277,GA,7848,21631,6704,9859,6066,4284,5875,22195,6776.209888,6538,8981,56622,9183,-11122,8586,9194,62267,65805,45500,65208,65816
13279,GA,7632,21631,6704,9859,6066,4284,5846,21243,6463.831418,6538,8651,54812,8610,-12023,7749,8621,62022,63422,42789,62561,63433
13281,GA,8184,21631,6704,9859,6066,4284,5921,21631,7016.501018,6538,9859,57513,9183,-11122,8586,9194,62649,66696,46391,66099,66707
13283,GA,7632,21631,6704,9859,6066,4284,5846,21631,6439.802305,6538,9859,56384,9183,-11122,8586,9194,62022,65567,45262,64970,65578
13285,GA,8400,21631,6704,9859,6066,4284,5950,21058,7088.588358,6538,9463,56832,9183,-11122,8586,9194,62894,66015,45710,65418,66026
13287,GA,7632,21631,6704,9859,6066,4284,5846,21631,6559.94787,6538,9859,56504,9183,-11122,8586,9194,62022,65687,45382,65090,65698
13289,GA,8760,21631,6704,9859,6066,4284,5998,22562,6511.889644,6538,9403,58060,9756,-10125,9423,9767,63302,67816,47935,67483,67827
13291,GA,8664,21631,6704,9859,6066,4284,5986,21631,7232.763036,6538,9859,58209,9183,-11122,8586,9194,63194,67392,47087,66795,67403
13293,GA,7632,21631,6704,9859,6066,4284,5846,20195,6463.831418,6538,8726,53840,8610,-12023,7749,8621,62022,62450,41817,61589,62461
13295,GA,8148,21631,6704,9859,6066,4284,5916,20269,6824.268114,6538,9499,55563,8610,-12023,7749,8621,62608,64173,43540,63312,64184
13297,GA,10752,21631,6704,9859,6066,4284,6268,21725,6968.442792,6538,10082,60350,10329,-9129,10260,10340,65564,70679,51221,70610,70690
13299,GA,7680,21631,6704,9859,6066,4284,5852,20918,6223.540287,6538,8660,54304,8610,-12023,7749,8621,62076,62914,42281,62053,62925
13301,GA,7632,21631,6704,9859,6066,4284,5846,21631,6583.976983,6538,9859,56528,9183,-11122,8586,9194,62022,65711,45406,65114,65722
13303,GA,7632,21631,6704,9859,6066,4284,5846,21631,6439.802305,6538,9859,56384,9183,-11122,8586,9194,62022,65567,45262,64970,65578
13305,GA,7632,21631,6704,9859,6066,4284,5846,22248,6391.744078,6538,8860,55954,9183,-11122,8586,9194,62022,65137,44832,64540,65148
13307,GA,7632,21631,6704,9859,6066,4284,5846,21631,6704.122548,6538,9859,56648,9183,-11122,8586,9194,62022,65831,45526,65234,65842
13309,GA,7632,21631,6704,9859,6066,4284,5846,21631,6463.831418,6538,9859,56408,9183,-11122,8586,9194,62022,65591,45286,64994,65602
13311,GA,7788,21631,6704,9859,6066,4284,5867,21631,6824.268114,6538,9859,56924,9183,-11122,8586,9194,62199,66107,45802,65510,66118
13313,GA,8364,21631,6704,9859,6066,4284,5945,21949,6175.482061,6538,9349,56660,9183,-11122,8586,9194,62853,65843,45538,65246,65854
13315,GA,7632,21631,6704,9859,6066,4284,5846,21631,6583.976983,6538,9859,56528,9183,-11122,8586,9194,62022,65711,45406,65114,65722
13317,GA,7632,21631,6704,9859,6066,4284,5846,21631,7112.617471,6538,9859,57057,9183,-11122,8586,9194,62022,66240,45935,65643,66251
13319,GA,7632,21631,6704,9859,6066,4284,5846,21631,6535.918757,6538,9859,56480,9183,-11122,8586,9194,62022,65663,45358,65066,65674
13321,GA,8400,21631,6704,9859,6066,4284,5950,22869,6343.685852,6538,8843,57278,9183,-11122,8586,9194,62894,66461,46156,65864,66472
15001,HI,11400,6494,8002,8509,4732,4344,7680,6539,8690.502945,6701,8518,46192,4894,-13500,5084,7144,51161,51086,32692,51276,53336
15003,HI,21840,6494,8002,8509,4732,4344,9217,9205,8862.592112,6701,9841,60793,8881,-8761,10787,11131,63138,69674,52032,71580,71924
15005,HI,7644,6494,8002,8509,4732,4344,7127,5657,8891.27364,6701,9298,42535,2965,-15209,3336,5215,46852,45500,27326,45871,47750
15007,HI,19164,6494,8002,8509,4732,4344,8823,7465,8202.916971,6701,9325,55201,7645,-10749,9023,9895,60068,62846,44452,64224,65096
15009,HI,15144,6494,8002,8509,4732,4344,8231,8271,9436.222669,6701,9396,53292,6422,-11972,7272,8672,55456,59714,41320,60564,61964
16001,ID,8628,15187,8002,8509,5210,4344,6660,13175,8375.006138,6965,8469,49956,7091,-13291,5821,7353,56540,57047,36665,55777,57309
16003,ID,7644,15187,8002,8509,5210,4344,6512,15187,9235.451974,6965,8509,51884,7392,-12990,6254,7654,55408,59276,38894,58138,59538
16005,ID,7644,15187,8002,8509,5210,4344,6512,18055,7801.375581,6965,8348,53157,7993,-12389,7119,8255,55408,61150,40768,60276,61412
16007,ID,7644,15187,8002,8509,5210,4344,6512,15187,8116.872387,6965,8509,50766,7392,-12990,6254,7654,55408,58158,37776,57020,58420
16009,ID,7644,15187,8002,8509,5210,4344,6512,15187,8489.73225,6965,8509,51139,7392,-12990,6254,7654,55408,58531,38149,57393,58793
16011,ID,7644,15187,8002,8509,5210,4344,6512,13189,7830.057109,6965,8680,48652,6791,-13591,5389,7053,55408,55443,35061,54041,55705
16013,ID,11112,15187,8002,8509,5210,4344,7036,20194,11788.10795,6965,8502,62906,9796,-9834,9714,10058,59400,72702,53072,72620,72964
16015,ID,8628,15187,8002,8509,5210,4344,6660,13651,8088.190859,6965,8476,50152,7392,-12990,6254,7654,56540,57544,37162,56406,57806
16017,ID,8268,15187,8002,8509,5210,4344,6606,12686,9063.362807,6965,7772,49098,6791,-13591,5389,7053,56126,55889,35507,54487,56151
16019,ID,7920,15187,8002,8509,5210,4344,6553,12718,7600.604886,6965,8748,48295,6791,-13591,5389,7053,55725,55086,34704,53684,55348
16021,ID,7644,15187,8002,8509,5210,4344,6512,15187,9063.362807,6965,8509,51712,7392,-12990,6254,7654,55408,59104,38722,57966,59366
16023,ID,7644,15187,8002,8509,5210,4344,6512,17158,7744.012525,6965,8695,52550,7993,-12389,7119,8255,55408,60543,40161,59669,60805
16025,ID,7644,15187,8002,8509,5210,4344,6512,12581,7830.057109,6965,8504,47867,6791,-13591,5389,7053,55408,54658,34276,53256,54920
16027,ID,8628,15187,8002,8509,5210,4344,6660,12697,7514.560302,6965,8471,48620,7091,-13291,5821,7353,56540,55711,35329,54441,55973
16029,ID,7644,15187,8002,8509,5210,4344,6512,15187,7772.694053,6965,8509,50422,7392,-12990,6254,7654,55408,57814,37432,56676,58076
16031,ID,7644,15187,8002,8509,5210,4344,6512,12993,8489.73225,6965,8434,48869,6791,-13591,5389,7053,55408,55660,35278,54258,55922
16033,ID,7644,15187,8002,8509,5210,4344,6512,15187,8002.146276,6965,8509,50651,7392,-12990,6254,7654,55408,58043,37661,56905,58305
16035,ID,7644,15187,8002,8509,5210,4344,6512,15187,8518.413777,6965,8509,51167,7392,-12990,6254,7654,55408,58559,38177,57421,58821
16037,ID,7644,15187,8002,8509,5210,4344,6512,15187,9092.044335,6965,8509,51741,7392,-12990,6254,7654,55408,59133,38751,57995,59395
16039,ID,7644,15187,8002,8509,5210,4344,6512,16507,8059.509332,6965,8354,51874,7392,-12990,6254,7654,55408,59266,38884,58128,59528
16041,ID,7644,15187,8002,8509,5210,4344,6512,14867,7944.78322,6965,8878,50643,7392,-12990,6254,7654,55408,58035,37653,56897,58297
16043,ID,7716,15187,8002,8509,5210,4344,6523,14007,8288.961554,6965,8266,49587,7091,-13291,5821,7353,55491,56678,36296,55408,56940
16045,ID,7668,15187,8002,8509,5210,4344,6515,18477,8059.509332,6965,8465,53978,7993,-12389,7119,8255,55435,61971,41589,61097,62233
16047,ID,7644,15187,8002,8509,5210,4344,6512,15187,7744.012525,6965,8509,50393,7392,-12990,6254,7654,55408,57785,37403,56647,58047
16049,ID,7644,15187,8002,8509,5210,4344,6512,15187,8747.866,6965,8509,51397,7392,-12990,6254,7654,55408,58789,38407,57651,59051
16051,ID,7920,15187,8002,8509,5210,4344,6553,15675,9092.044335,6965,8718,52714,7392,-12990,6254,7654,55725,60106,39724,58968,60368
16053,ID,7692,15187,8002,8509,5210,4344,6519,18424,7772.694053,6965,8351,53549,7993,-12389,7119,8255,55463,61542,41160,60668,61804
16055,ID,9036,15187,8002,8509,5210,4344,6722,13146,8375.006138,6965,8216,50082,7091,-13291,5821,7353,57010,57173,36791,55903,57435
16057,ID,7860,15187,8002,8509,5210,4344,6544,19829,8403.687666,6965,7992,55394,8594,-11788,7984,8856,55656,63988,43606,63378,64250
16059,ID,7644,15187,8002,8509,5210,4344,6512,15187,9493.585725,6965,8509,52143,7392,-12990,6254,7654,55408,59535,39153,58397,59797
16061,ID,7644,15187,8002,8509,5210,4344,6512,15187,8403.687666,6965,8509,51053,7392,-12990,6254,7654,55408,58445,38063,57307,58707
16063,ID,7644,15187,8002,8509,5210,4344,6512,14172,7801.375581,6965,8503,49429,7091,-13291,5821,7353,55408,56520,36138,55250,56782
16065,ID,7824,15187,8002,8509,5210,4344,6539,14093,8719.184473,6965,8263,50208,7091,-13291,5821,7353,55615,57299,36917,56029,57561
16067,ID,7644,15187,8002,8509,5210,4344,6512,13993,7657.967941,6965,8434,49038,7091,-13291,5821,7353,55408,56129,35747,54859,56391
16069,ID,7908,15187,8002,8509,5210,4344,6552,13254,10239.30545,6965,8050,50760,6791,-13591,5389,7053,55712,57551,37169,56149,57813
16071,ID,7644,15187,8002,8509,5210,4344,6512,15187,7801.375581,6965,8509,50450,7392,-12990,6254,7654,55408,57842,37460,56704,58104
16073,ID,8628,15187,8002,8509,5210,4344,6660,15034,8145.553915,6965,8471,51587,7392,-12990,6254,7654,56540,58979,38597,57841,59241
16075,ID,7848,15187,8002,8509,5210,4344,6543,17609,9292.81503,6965,7697,53756,7993,-12389,7119,8255,55643,61749,41367,60875,62011
16077,ID,7644,15187,8002,8509,5210,4344,6512,15187,7801.375581,6965,8509,50450,7392,-12990,6254,7654,55408,57842,37460,56704,58104
16079,ID,7644,15187,8002,8509,5210,4344,6512,15187,8489.73225,6965,8509,51139,7392,-12990,6254,7654,55408,58531,38149,57393,58793
16081,ID,8280,15187,8002,8509,5210,4344,6608,16793,8088.190859,6965,9422,53893,7993,-12389,7119,8255,56140,61886,41504,61012,62148
16083,ID,7944,15187,8002,8509,5210,4344,6557,13587,7686.649469,6965,8343,48869,7091,-13291,5821,7353,55753,55960,35578,54690,56222
16085,ID,8256,15187,8002,8509,5210,4344,6604,15187,8145.553915,6965,8509,51407,7392,-12990,6254,7654,56112,58799,38417,57661,59061
16087,ID,7644,15187,8002,8509,5210,4344,6512,15187,7657.967941,6965,8509,50307,7392,-12990,6254,7654,55408,57699,37317,56561,57961
17001,IL,7644,6648,6849,9589,6110,4046,7641,6351,6063.562452,5450,9230,38785,-1159,-18163,-260,1460,48527,37626,20622,38525,40245
17003,IL,8148,6648,6849,9589,6110,4046,7725,7038,6284.501975,5450,9242,40208,938,-16468,1757,3556,49115,41146,23740,41965,43764
17005,IL,8244,6648,6849,9589,6110,4046,7740,7161,6259.953139,5450,9537,40698,1413,-16392,2153,4032,49226,42111,24306,42851,44730
17007,IL,9048,6648,6849,9589,6110,4046,7873,5869,5744.427586,5450,9438,39595,938,-16468,1757,3556,50163,40533,23127,41352,43151
17009,IL,9336,6648,6849,9589,6110,4046,7921,6648,6014.464781,5450,9589,41083,1413,-16392,2153,4032,50499,42496,24691,43236,45115
17011,IL,7980,6648,6849,9589,6110,4046,7697,7089,6971.869378,5450,9426,40963,938,-16468,1757,3556,48919,41901,24495,42720,44519
17013,IL,9768,6648,6849,9589,6110,4046,7992,6632,6603.636841,5450,9541,42040,1889,-16137,2549,4507,51002,43929,25903,44589,46547
17015,IL,7644,6648,6849,9589,6110,4046,7641,6648,6088.111288,5450,9589,39465,938,-16468,1757,3556,48527,40403,22997,41222,43021
17017,IL,7812,6648,6849,9589,6110,4046,7669,6648,6456.343826,5450,9589,40001,938,-16468,1757,3556,48723,40939,23533,41758,43557
17019,IL,10344,6648,6849,9589,6110,4046,8087,5836,6750.929856,5450,9225,41652,1413,-16392,2153,4032,51673,43065,25260,43805,45684
17021,IL,8064,6648,6849,9589,6110,4046,7711,7358,5744.427586,5450,9039,39701,938,-16468,1757,3556,49017,40639,23233,41458,43257
17023,IL,8364,6648,6849,9589,6110,4046,7760,6648,6112.660124,5450,9589,40210,938,-16468,1757,3556,49366,41148,23742,41967,43766
17025,IL,7644,6648,6849,9589,6110,4046,7641,6648,5989.915945,5450,9589,39367,938,-16468,1757,3556,48527,40305,22899,41124,42923
17027,IL,9768,6648,6849,9589,6110,4046,7992,6918,5695.329915,5450,9537,41414,1889,-16137,2549,4507,51002,43303,25277,43963,45921
17029,IL,8004,6648,6849,9589,6110,4046,7701,6858,6088.111288,5450,8569,39016,-1159,-18163,-260,1460,48947,37857,20853,38756,40476
17031,IL,11748,6648,6849,9589,6110,4046,8319,7406,6505.441497,5450,10353,45508,3178,-14847,3737,5797,53309,48686,30661,49245,51305
17033,IL,7644,6648,6849,9589,6110,4046,7641,6648,6333.599646,5450,9589,39711,938,-16468,1757,3556,48527,40649,23243,41468,43267
17035,IL,7644,6648,6849,9589,6110,4046,7641,6186,6063.562452,5450,8651,38040,-1635,-18239,-656,983,48527,36405,19801,37384,39023
17037,IL,10512,6648,6849,9589,6110,4046,8115,6554,6922.771707,5450,10232,43716,2365,-15660,2945,4984,51869,46081,28056,46661,48700
17039,IL,7644,6648,6849,9589,6110,4046,7641,7311,6529.990333,5450,10175,41156,1413,-16392,2153,4032,48527,42569,24764,43309,45188
17041,IL,8328,6648,6849,9589,6110,4046,7754,6648,6431.79499,5450,9589,40493,938,-16468,1757,3556,49324,41431,24025,42250,44049
17043,IL,11748,6648,6849,9589,6110,4046,8319,7798,6775.478692,5450,10274,46091,3443,-14583,4133,6061,53309,49534,31508,50224,52152
17045,IL,7644,6648,6849,9589,6110,4046,7641,6648,6382.697318,5450,9589,39760,938,-16468,1757,3556,48527,40698,23292,41517,43316
17047,IL,7644,6648,6849,9589,6110,4046,7641,6648,6652.734512,5450,9589,40030,938,-16468,1757,3556,48527,40968,23562,41787,43586
17049,IL,7644,6648,6849,9589,6110,4046,7641,7596,5818.074094,5450,9614,40168,1413,-16392,2153,4032,48527,41581,23776,42321,44200
17051,IL,7644,6648,6849,9589,6110,4046,7641,6648,5449.841556,5450,9589,38827,938,-16468,1757,3556,48527,39765,22359,40584,42383
17053,IL,10344,6648,6849,9589,6110,4046,8087,6396,6579.088005,5450,9271,42086,1889,-16137,2549,4507,51673,43975,25949,44635,46593
17055,IL,7644,6648,6849,9589,6110,4046,7641,6648,6701.832184,5450,9589,40079,938,-16468,1757,3556,48527,41017,23611,41836,43635
17057,IL,7704,6648,6849,9589,6110,4046,7651,5622,5768.976422,5450,8986,37577,-1635,-18239,-656,983,48597,35942,19338,36921,38560
17059,IL,7644,6648,6849,9589,6110,4046,7641,6648,6014.464781,5450,9589,39391,938,-16468,1757,3556,48527,40329,22923,41148,42947
17061,IL,7644,6648,6849,9589,6110,4046,7641,6648,6161.757796,5450,9589,39539,938,-16468,1757,3556,48527,40477,23071,41296,43095
17063,IL,10956,6648,6849,9589,6110,4046,8189,6873,6677.283348,5450,10236,44238,2841,-15185,3341,5459,52387,47079,29053,47579,49697
17065,IL,7644,6648,6849,9589,6110,4046,7641,6648,6088.111288,5450,9589,39465,938,-16468,1757,3556,48527,40403,22997,41222,43021
17067,IL,7644,6648,6849,9589,6110,4046,7641,6593,5940.818273,5450,9098,38772,-1159,-18163,-260,1460,48527,37613,20609,38512,40232
17069,IL,7644,6648,6849,9589,6110,4046,7641,6648,5940.818273,5450,9589,39318,938,-16468,1757,3556,48527,40256,22850,41075,42874
17071,IL,7644,6648,6849,9589,6110,4046,7641,6256,5916.269437,5450,9051,38363,-1159,-18163,-260,1460,48527,37204,20200,38103,39823
17073,IL,8196,6648,6849,9589,6110,4046,7733,6451,5842.62293,5450,9393,39378,938,-16468,1757,3556,49171,40316,22910,41135,42934
17075,IL,7788,6648,6849,9589,6110,4046,7665,6648,6726.38102,5450,9589,40247,938,-16468,1757,3556,48695,41185,23779,42004,43803
17077,IL,8184,6648,6849,9589,6110,4046,7731,8864,6456.343826,5450,8546,41546,1413,-16392,2153,4032,49157,42959,25154,43699,45578
17079,IL,7644,6648,6849,9589,6110,4046,7641,6648,6210.855467,5450,9589,39588,938,-16468,1757,3556,48527,40526,23120,41345,43144
17081,IL,7644,6648,6849,9589,6110,4046,7641,7062,5989.915945,5450,8983,39176,938,-16468,1757,3556,48527,40114,22708,40933,42732
17083,IL,9768,6648,6849,9589,6110,4046,7992,7789,6726.38102,5450,9538,43317,2365,-15660,2945,4984,51002,45682,27657,46262,48301
17085,IL,7644,6648,6849,9589,6110,4046,7641,6648,7315.55308,5450,9589,40693,938,-16468,1757,3556,48527,41631,24225,42450,44249
17087,IL,7644,6648,6849,9589,6110,4046,7641,6648,6186.306631,5450,9589,39563,938,-16468,1757,3556,48527,40501,23095,41320,43119
17089,IL,11748,6648,6849,9589,6110,4046,8319,6738,6358.148482,5450,10245,44585,3178,-14847,3737,5797,53309,47763,29738,48322,50382
17091,IL,9096,6648,6849,9589,6110,4046,7881,6208,6579.088005,5450,9451,40831,1413,-16392,2153,4032,50219,42244,24439,42984,44863
17093,IL,11988,6648,6849,9589,6110,4046,8359,6855,6063.562452,5450,10213,44616,3178,-14847,3737,5797,53589,47794,29769,48353,50413
17095,IL,7644,6648,6849,9589,6110,4046,7641,6959,6210.855467,5450,8668,38979,-1159,-18163,-260,1460,48527,37820,20816,38719,40439
17097,IL,11748,6648,6849,9589,6110,4046,8319,5545,6971.869378,5450,10245,44006,2365,-15660,2945,4984,53309,46371,28346,46951,48990
17099,IL,9204,6648,6849,9589,6110,4046,7899,7647,6112.660124,5450,9417,41877,1889,-16137,2549,4507,50345,43766,25740,44426,46384
17101,IL,7644,6648,6849,9589,6110,4046,7641,6648,6603.636841,5450,9589,39981,938,-16468,1757,3556,48527,40919,23513,41738,43537
17103,IL,7680,6648,6849,9589,6110,4046,7647,6255,5842.62293,5450,9287,38561,-1159,-18163,-260,1460,48569,37402,20398,38301,40021
17105,IL,8160,6648,6849,9589,6110,4046,7727,6114,5768.976422,5450,9209,38748,-1159,-18163,-260,1460,49129,37589,20585,38488,40208
17107,IL,7668,6648,6849,9589,6110,4046,7645,6098,5793.525258,5450,8585,37640,-1635,-18239,-656,983,48555,36005,19401,36984,38623
17109,IL,8496,6648,6849,9589,6110,4046,7782,7296,6039.013616,5450,8297,39624,938,-16468,1757,3556,49520,40562,23156,41381,43180
17111,IL,11748,6648,6849,9589,6110,4046,8319,6286,6677.283348,5450,10219,44426,2841,-15185,3341,5459,53309,47267,29241,47767,49885
17113,IL,10380,6648,6849,9589,6110,4046,8093,6207,6652.734512,5450,10195,42931,2365,-15660,2945,4984,51715,45296,27271,45876,47915
17115,IL,8208,6648,6849,9589,6110,4046,7735,6158,6112.660124,5450,9088,39062,-1159,-18163,-260,1460,49185,37903,20899,38802,40522
17117,IL,7644,6648,6849,9589,6110,4046,7641,6784,6898.222871,5450,9538,40360,938,-16468,1757,3556,48527,41298,23892,42117,43916
17119,IL,9768,6648,6849,9589,6110,4046,7992,6410,6382.697318,5450,9530,41587,1889,-16137,2549,4507,51002,43476,25450,44136,46094
17121,IL,7644,6648,6849,9589,6110,4046,7641,6682,6554.539169,5450,8954,39331,-1159,-18163,-260,1460,48527,38172,21168,39071,40791
17123,IL,8700,6648,6849,9589,6110,4046,7816,6977,6309.050811,5450,9442,40924,1413,-16392,2153,4032,49758,42337,24532,43077,44956
17125,IL,7644,6648,6849,9589,6110,4046,7641,6648,6333.599646,5450,9589,39711,938,-16468,1757,3556,48527,40649,23243,41468,43267
17127,IL,8052,6648,6849,9589,6110,4046,7709,6574,6112.660124,5450,9027,39262,-1159,-18163,-260,1460,49003,38103,21099,39002,40722
17129,IL,8916,6648,6849,9589,6110,4046,7852,7095,6456.343826,5450,9476,41439,1413,-16392,2153,4032,50010,42852,25047,43592,45471
17131,IL,8196,6648,6849,9589,6110,4046,7733,6287,6358.148482,5450,9398,39735,938,-16468,1757,3556,49171,40673,23267,41492,43291
17133,IL,9768,6648,6849,9589,6110,4046,7992,7008,7168.260065,5450,9536,42976,1889,-16137,2549,4507,51002,44865,26839,45525,47483
17135,IL,8172,6648,6849,9589,6110,4046,7729,6648,5621.683407,5450,9589,39527,938,-16468,1757,3556,49143,40465,23059,41284,43083
17137,IL,7812,6648,6849,9589,6110,4046,7669,6268,5793.525258,5450,9128,38498,-1159,-18163,-260,1460,48723,37339,20335,38238,39958
17139,IL,7644,6648,6849,9589,6110,4046,7641,6648,6161.757796,5450,9589,39539,938,-16468,1757,3556,48527,40477,23071,41296,43095
17141,IL,8268,6648,6849,9589,6110,4046,7744,7909,5744.427586,5450,9596,41013,1889,-16137,2549,4507,49254,42902,24876,43562,45520
17143,IL,8700,6648,6849,9589,6110,4046,7816,6646,6407.246154,5450,9418,40667,1413,-16392,2153,4032,49758,42080,24275,42820,44699
17145,IL,7644,6648,6849,9589,6110,4046,7641,6648,6554.539169,5450,9589,39932,938,-16468,1757,3556,48527,40870,23464,41689,43488
17147,IL,10344,6648,6849,9589,6110,4046,8087,6811,6529.990333,5450,9274,42455,1889,-16137,2549,4507,51673,44344,26318,45004,46962
17149,IL,7644,6648,6849,9589,6110,4046,7641,6648,5940.818273,5450,9589,39318,938,-16468,1757,3556,48527,40256,22850,41075,42874
17151,IL,7644,6648,6849,9589,6110,4046,7641,6648,6063.562452,5450,9589,39441,938,-16468,1757,3556,48527,40379,22973,41198,42997
17153,IL,7644,6648,6849,9589,6110,4046,7641,6648,6186.306631,5450,9589,39563,938,-16468,1757,3556,48527,40501,23095,41320,43119
17155,IL,7836,6648,6849,9589,6110,4046,7673,6899,6161.757796,5450,9430,39824,938,-16468,1757,3556,48751,40762,23356,41581,43380
17157,IL,7824,6648,6849,9589,6110,4046,7671,6648,5523.488064,5450,9589,39080,938,-16468,1757,3556,48737,40018,22612,40837,42636
17159,IL,7644,6648,6849,9589,6110,4046,7641,6648,6603.636841,5450,9589,39981,938,-16468,1757,3556,48527,40919,23513,41738,43537
17161,IL,8196,6648,6849,9589,6110,4046,7733,6169,6333.599646,5450,9370,39564,938,-16468,1757,3556,49171,40502,23096,41321,43120
17163,IL,9768,6648,6849,9589,6110,4046,7992,6663,6407.246154,5450,9528,41862,1889,-16137,2549,4507,51002,43751,25725,44411,46369
17165,IL,7644,6648,6849,9589,6110,4046,7641,6648,5793.525258,5450,9589,39171,938,-16468,1757,3556,48527,40109,22703,40928,42727
17167,IL,8916,6648,6849,9589,6110,4046,7852,6172,6652.734512,5450,9457,40694,938,-16468,1757,3556,50010,41632,24226,42451,44250
17169,IL,7644,6648,6849,9589,6110,4046,7641,6648,6014.464781,5450,9589,39391,938,-16468,1757,3556,48527,40329,22923,41148,42947
17171,IL,7644,6648,6849,9589,6110,4046,7641,6738,5940.818273,5450,9177,38996,-1159,-18163,-260,1460,48527,37837,20833,38736,40456
17173,IL,7644,6648,6849,9589,6110,4046,7641,6648,6284.501975,5450,9589,39662,938,-16468,1757,3556,48527,40600,23194,41419,43218
17175,IL,8700,6648,6849,9589,6110,4046,7816,6451,6284.501975,5450,9448,40380,938,-16468,1757,3556,49758,41318,23912,42137,43936
17177,IL,7836,6648,6849,9589,6110,4046,7673,7153,6161.757796,5450,9041,39687,938,-16468,1757,3556,48751,40625,23219,41444,43243
17179,IL,8700,6648,6849,9589,6110,4046,7816,7109,6407.246154,5450,9428,41141,1413,-16392,2153,4032,49758,42554,24749,43294,45173
17181,IL,7644,6648,6849,9589,6110,4046,7641,6648,6284.501975,5450,9589,39662,938,-16468,1757,3556,48527,40600,23194,41419,43218
17183,IL,8532,6648,6849,9589,6110,4046,7788,7518,5768.976422,5450,9024,40339,1413,-16392,2153,4032,49562,41752,23947,42492,44371
17185,IL,7824,6648,6849,9589,6110,4046,7671,6648,6652.734512,5450,9589,40210,938,-16468,1757,3556,48737,41148,23742,41967,43766
17187,IL,8304,6648,6849,9589,6110,4046,7750,6648,6088.111288,5450,9589,40125,938,-16468,1757,3556,49296,41063,23657,41882,43681
17189,IL,7944,6648,6849,9589,6110,4046,7691,6648,6186.306631,5450,9589,39863,938,-16468,1757,3556,48877,40801,23395,41620,43419
17191,IL,7644,6648,6849,9589,6110,4046,7641,6648,6333.599646,5450,9589,39711,938,-16468,1757,3556,48527,40649,23243,41468,43267
17193,IL,7644,6648,6849,9589,6110,4046,7641,6648,6358.148482,5450,9589,39735,938,-16468,1757,3556,48527,40673,23267,41492,43291
17195,IL,8208,6648,6849,9589,6110,4046,7735,6374,6063.562452,5450,9280,39421,938,-16468,1757,3556,49185,40359,22953,41178,42977
17197,IL,11748,6648,6849,9589,6110,4046,8319,6968,6603.636841,5450,10231,45047,3178,-14847,3737,5797,53309,48225,30200,48784,50844
17199,IL,7800,6648,6849,9589,6110,4046,7667,7620,6063.562452,5450,8567,39547,938,-16468,1757,3556,48709,40485,23079,41304,43103
17201,IL,9048,6648,6849,9589,6110,4046,7873,6816,6161.757796,5450,9436,40958,1413,-16392,2153,4032,50163,42371,24566,43111,44990
17203,IL,8700,6648,6849,9589,6110,4046,7816,6494,6996.418214,5450,9441,41127,938,-16468,1757,3556,49758,42065,24659,42884,44683
18001,IN,7512,15136,6849,9589,5928,4046,6427,14251,6358.148482,7706,9515,49389,5176,-13904,5208,6740,55487,54565,35485,54597,56129
18003,IN,7968,15136,6849,9589,5928,4046,6495,16763,6309.050811,7706,9449,52241,5955,-13125,6383,7519,56011,58196,39116,58624,59760
18005,IN,9924,15136,6849,9589,5928,4046,6787,14770,6186.306631,7706,9654,52286,5955,-13125,6383,7519,58259,58241,39161,58669,59805
18007,IN,9360,15136,6849,9589,5928,4046,6703,14165,6210.855467,7706,9255,50743,5436,-13644,5600,7000,57611,56179,37099,56343,57743
18009,IN,7512,15136,6849,9589,5928,4046,6427,15136,5989.915945,7706,9589,49979,5436,-13644,5600,7000,55487,55415,36335,55579,56979
18011,IN,9324,15136,6849,9589,5928,4046,6698,17466,6284.501975,7706,9575,54401,6474,-12606,7166,8038,57570,60875,41795,61567,62439
18013,IN,9324,15136,6849,9589,5928,4046,6698,14531,6333.599646,7706,9575,51516,5955,-13125,6383,7519,57570,57471,38391,57899,59035
18015,IN,7512,15136,6849,9589,5928,4046,6427,15517,6701.832184,7706,9249,50733,5436,-13644,5600,7000,55487,56169,37089,56333,57733
18017,IN,7512,15136,6849,9589,5928,4046,6427,13137,5548.0369,7706,9203,47153,4917,-14163,4817,6481,55487,52070,32990,51970,53634
18019,IN,8460,15136,6849,9589,5928,4046,6569,14713,6112.660124,7706,9411,50448,5436,-13644,5600,7000,56577,55884,36804,56048,57448
18021,IN,8760,15136,6849,9589,5928,4046,6613,15372,5351.646213,7706,9101,50337,5436,-13644,5600,7000,56921,55773,36693,55937,57337
18023,IN,8016,15136,6849,9589,5928,4046,6502,14539,5425.29272,7706,9648,49380,5436,-13644,5600,7000,56066,54816,35736,54980,56380
18025,IN,7512,15136,6849,9589,5928,4046,6427,15136,6407.246154,7706,9589,50396,5436,-13644,5600,7000,55487,55832,36752,55996,57396
18027,IN,7512,15136,6849,9589,5928,4046,6427,13775,6677.283348,7706,9602,49319,5176,-13904,5208,6740,55487,54495,35415,54527,56059
18029,IN,8820,15136,6849,9589,5928,4046,6622,17604,5842.62293,7706,9610,53629,6474,-12606,7166,8038,56990,60103,41023,60795,61667
18031,IN,8196,15136,6849,9589,5928,4046,6529,14949,5548.0369,7706,9433,49878,5436,-13644,5600,7000,56273,55314,36234,55478,56878
18033,IN,7512,15136,6849,9589,5928,4046,6427,15672,6505.441497,7706,9392,50833,5436,-13644,5600,7000,55487,56269,37189,56433,57833
18035,IN,8016,15136,6849,9589,5928,4046,6502,14633,6039.013616,7706,8506,48945,5176,-13904,5208,6740,56066,54121,35041,54153,55685
18037,IN,7512,15136,6849,9589,5928,4046,6427,15349,6750.929856,7706,9649,51013,5436,-13644,5600,7000,55487,56449,37369,56613,58013
18039,IN,8904,15136,6849,9589,5928,4046,6635,15322,5867.171766,7706,9597,51442,5955,-13125,6383,7519,57087,57397,38317,57825,58961
18041,IN,7728,15136,6849,9589,5928,4046,6459,15263,6210.855467,7706,8439,49393,5436,-13644,5600,7000,55735,54829,35749,54993,56393
18043,IN,8460,15136,6849,9589,5928,4046,6569,13706,6333.599646,7706,9412,49664,5436,-13644,5600,7000,56577,55100,36020,55264,56664
18045,IN,7512,15136,6849,9589,5928,4046,6427,15136,6284.501975,7706,9589,50274,5436,-13644,5600,7000,55487,55710,36630,55874,57274
18047,IN,8820,15136,6849,9589,5928,4046,6622,15136,6677.283348,7706,9589,51974,5955,-13125,6383,7519,56990,57929,38849,58357,59493
18049,IN,7836,15136,6849,9589,5928,4046,6476,15136,6456.343826,7706,9589,50769,5436,-13644,5600,7000,55860,56205,37125,56369,57769
18051,IN,7512,15136,6849,9589,5928,4046,6427,15136,6726.38102,7706,9589,50715,5436,-13644,5600,7000,55487,56151,37071,56315,57715
18053,IN,7512,15136,6849,9589,5928,4046,6427,16669,5891.720601,7706,8471,50296,5436,-13644,5600,7000,55487,55732,36652,55896,57296
18055,IN,7512,15136,6849,9589,5928,4046,6427,15136,6480.892661,7706,9589,50470,5436,-13644,5600,7000,55487,55906,36826,56070,57470
18057,IN,9324,15136,6849,9589,5928,4046,6698,14565,7536.492603,7706,9575,52753,5955,-13125,6383,7519,57570,58708,39628,59136,60272
18059,IN,9324,15136,6849,9589,5928,4046,6698,15287,6137.20896,7706,9575,52075,5955,-13125,6383,7519,57570,58030,38950,58458,59594
18061,IN,8460,15136,6849,9589,5928,4046,6569,12829,6284.501975,7706,9423,48749,5176,-13904,5208,6740,56577,53925,34845,53957,55489
18063,IN,9324,15136,6849,9589,5928,4046,6698,14498,6480.892661,7706,9575,51629,5436,-13644,5600,7000,57570,57065,37985,57229,58629
18065,IN,7512,15136,6849,9589,5928,4046,6427,13365,5670.781079,7706,8902,47201,4917,-14163,4817,6481,55487,52118,33038,52018,53682
18067,IN,7956,15136,6849,9589,5928,4046,6493,16381,6039.013616,7706,8893,51022,5436,-13644,5600,7000,55997,56458,37378,56622,58022
18069,IN,7740,15136,6849,9589,5928,4046,6461,14591,5646.232243,7706,9368,49097,5436,-13644,5600,7000,55749,54533,35453,54697,56097
18071,IN,8184,15136,6849,9589,5928,4046,6527,13893,5523.488064,7706,9346,48698,5436,-13644,5600,7000,56259,54134,35054,54298,55698
18073,IN,8292,15136,6849,9589,5928,4046,6544,13857,6677.283348,7706,10207,50785,5436,-13644,5600,7000,56384,56221,37141,56385,57785
18075,IN,7512,15136,6849,9589,5928,4046,6427,15136,6161.757796,7706,9589,50151,5436,-13644,5600,7000,55487,55587,36507,55751,57151
18077,IN,7512,15136,6849,9589,5928,4046,6427,14903,5646.232243,7706,9031,48844,5436,-13644,5600,7000,55487,54280,35200,54444,55844
18079,IN,8112,15136,6849,9589,5928,4046,6517,15000,6309.050811,7706,9256,50428,5436,-13644,5600,7000,56177,55864,36784,56028,57428
18081,IN,9324,15136,6849,9589,5928,4046,6698,15686,6407.246154,7706,9575,52744,5955,-13125,6383,7519,57570,58699,39619,59127,60263
18083,IN,7512,15136,6849,9589,5928,4046,6427,15837,6677.283348,7706,9060,50839,5436,-13644,5600,7000,55487,56275,37195,56439,57839
18085,IN,8088,15136,6849,9589,5928,4046,6513,15199,5940.818273,7706,9544,50524,5436,-13644,5600,7000,56149,55960,36880,56124,57524
18087,IN,7932,15136,6849,9589,5928,4046,6490,15136,6677.283348,7706,9589,51086,5436,-13644,5600,7000,55970,56522,37442,56686,58086
18089,IN,9636,15136,6849,9589,5928,4046,6744,13786,6112.660124,7706,10239,51526,5955,-13125,6383,7519,57928,57481,38401,57909,59045
18091,IN,8628,15136,6849,9589,5928,4046,6594,14545,5965.367109,7706,9101,49991,5436,-13644,5600,7000,56770,55427,36347,55591,56991
18093,IN,7704,15136,6849,9589,5928,4046,6456,13813,5572.585735,7706,9023,47864,5176,-13904,5208,6740,55708,53040,33960,53072,54604
18095,IN,8124,15136,6849,9589,5928,4046,6518,14647,6161.757796,7706,9573,50258,5436,-13644,5600,7000,56190,55694,36614,55858,57258
18097,IN,9324,15136,6849,9589,5928,4046,6698,19630,6284.501975,7706,9574,56564,6993,-11759,7949,8557,57570,63557,44805,64513,65121
18099,IN,8076,15136,6849,9589,5928,4046,6511,14112,5646.232243,7706,9401,48987,5436,-13644,5600,7000,56135,54423,35343,54587,55987
18101,IN,7512,15136,6849,9589,5928,4046,6427,15136,6186.306631,7706,9589,50175,5436,-13644,5600,7000,55487,55611,36531,55775,57175
18103,IN,7512,15136,6849,9589,5928,4046,6427,14358,5474.390392,7706,9137,48234,5176,-13904,5208,6740,55487,53410,34330,53442,54974
18105,IN,9348,15136,6849,9589,5928,4046,6701,16013,6873.674035,7706,8958,52944,5955,-13125,6383,7519,57597,58899,39819,59327,60463
18107,IN,8316,15136,6849,9589,5928,4046,6547,16297,6505.441497,7706,9327,52198,5955,-13125,6383,7519,56411,58153,39073,58581,59717
18109,IN,9324,15136,6849,9589,5928,4046,6698,14118,6579.088005,7706,9574,51347,5436,-13644,5600,7000,57570,56783,37703,56947,58347
18111,IN,9636,15136,6849,9589,5928,4046,6744,14201,6186.306631,7706,10194,51969,5955,-13125,6383,7519,57928,57924,38844,58352,59488
18113,IN,7644,15136,6849,9589,5928,4046,6447,14716,6382.697318,7706,9433,49927,5436,-13644,5600,7000,55639,55363,36283,55527,56927
18115,IN,8820,15136,6849,9589,5928,4046,6622,15220,6579.088005,7706,9611,51983,5955,-13125,6383,7519,56990,57938,38858,58366,59502
18117,IN,7512,15136,6849,9589,5928,4046,6427,15136,6112.660124,7706,9589,50102,5436,-13644,5600,7000,55487,55538,36458,55702,57102
18119,IN,7512,15136,6849,9589,5928,4046,6427,14277,6947.320542,7706,9002,49490,5176,-13904,5208,6740,55487,54666,35586,54698,56230
18121,IN,7512,15136,6849,9589,5928,4046,6427,15136,5989.915945,7706,9589,49979,5436,-13644,5600,7000,55487,55415,36335,55579,56979
18123,IN,7512,15136,6849,9589,5928,4046,6427,15136,6407.246154,7706,9589,50396,5436,-13644,5600,7000,55487,55832,36752,55996,57396
18125,IN,7512,15136,6849,9589,5928,4046,6427,19628,6505.441497,7706,9648,55045,6474,-12606,7166,8038,55487,61519,42439,62211,63083
18127,IN,9636,15136,6849,9589,5928,4046,6744,15193,6554.539169,7706,10213,53348,5955,-13125,6383,7519,57928,59303,40223,59731,60867
18129,IN,8868,15136,6849,9589,5928,4046,6629,13590,6971.869378,7706,9336,50519,5436,-13644,5600,7000,57045,55955,36875,56119,57519
18131,IN,7512,15136,6849,9589,5928,4046,6427,15136,5842.62293,7706,9589,49832,5436,-13644,5600,7000,55487,55268,36188,55432,56832
18133,IN,7512,15136,6849,9589,5928,4046,6427,17285,5621.683407,7706,9574,51745,5955,-13125,6383,7519,55487,57700,38620,58128,59264
18135,IN,7512,15136,6849,9589,5928,4046,6427,15136,5253.45087,7706,9589,49242,5436,-13644,5600,7000,55487,54678,35598,54842,56242
18137,IN,7560,15136,6849,9589,5928,4046,6434,15136,6898.222871,7706,9589,50935,5436,-13644,5600,7000,55542,56371,37291,56535,57935
18139,IN,7512,15136,6849,9589,5928,4046,6427,15136,6088.111288,7706,9589,50077,5436,-13644,5600,7000,55487,55513,36433,55677,57077
18141,IN,8568,15136,6849,9589,5928,4046,6585,16442,6210.855467,7706,9225,52198,5955,-13125,6383,7519,56701,58153,39073,58581,59717
18143,IN,7752,15136,6849,9589,5928,4046,6463,13960,6529.990333,7706,9413,49407,5176,-13904,5208,6740,55763,54583,35503,54615,56147
18145,IN,9324,15136,6849,9589,5928,4046,6698,15131,5744.427586,7706,9574,51526,5955,-13125,6383,7519,57570,57481,38401,57909,59045
18147,IN,7512,15136,6849,9589,5928,4046,6427,15136,6775.478692,7706,9589,50764,5436,-13644,5600,7000,55487,56200,37120,56364,57764
18149,IN,7644,15136,6849,9589,5928,4046,6447,15136,6898.222871,7706,9589,51019,5436,-13644,5600,7000,55639,56455,37375,56619,58019
18151,IN,8112,15136,6849,9589,5928,4046,6517,16900,5793.525258,7706,9343,51900,5955,-13125,6383,7519,56177,57855,38775,58283,59419
18153,IN,7512,15136,6849,9589,5928,4046,6427,15815,6800.027527,7706,9111,50990,5436,-13644,5600,7000,55487,56426,37346,56590,57990
18155,IN,7512,15136,6849,9589,5928,4046,6427,15136,6284.501975,7706,9589,50274,5436,-13644,5600,7000,55487,55710,36630,55874,57274
18157,IN,9360,15136,6849,9589,5928,4046,6703,14152,6358.148482,7706,9224,50845,5436,-13644,5600,7000,57611,56281,37201,56445,57845
18159,IN,7956,15136,6849,9589,5928,4046,6493,15136,6726.38102,7706,9589,51159,5436,-13644,5600,7000,55997,56595,37515,56759,58159
18161,IN,7512,15136,6849,9589,5928,4046,6427,17837,6505.441497,7706,9611,53218,5955,-13125,6383,7519,55487,59173,40093,59601,60737
18163,IN,8868,15136,6849,9589,5928,4046,6629,15931,6358.148482,7706,9313,52223,5955,-13125,6383,7519,57045,58178,39098,58606,59742
18165,IN,8760,15136,6849,9589,5928,4046,6613,16968,5940.818273,7706,9112,52533,5955,-13125,6383,7519,56921,58488,39408,58916,60052
18167,IN,8760,15136,6849,9589,5928,4046,6613,17916,6112.660124,7706,9061,53602,6474,-12606,7166,8038,56921,60076,40996,60768,61640
18169,IN,7512,15136,6849,9589,5928,4046,6427,13735,6382.697318,7706,9104,48486,4917,-14163,4817,6481,55487,53403,34323,53303,54967
18171,IN,7512,15136,6849,9589,5928,4046,6427,15136,6284.501975,7706,9589,50274,5436,-13644,5600,7000,55487,55710,36630,55874,57274
18173,IN,8868,15136,6849,9589,5928,4046,6629,17145,7045.515886,7706,9336,54146,5955,-13125,6383,7519,57045,60101,41021,60529,61665
18175,IN,7512,15136,6849,9589,5928,4046,6427,15857,7266.455408,7706,9420,51807,5436,-13644,5600,7000,55487,57243,38163,57407,58807
18177,IN,7656,15136,6849,9589,5928,4046,6449,13684,5891.720601,7706,8453,47437,4917,-14163,4817,6481,55653,52354,33274,52254,53918
18179,IN,7968,15136,6849,9589,5928,4046,6495,14646,6284.501975,7706,9450,50101,5436,-13644,5600,7000,56011,55537,36457,55701,57101
18181,IN,7512,15136,6849,9589,5928,4046,6427,15136,6309.050811,7706,9589,50298,5436,-13644,5600,7000,55487,55734,36654,55898,57298
18183,IN,7968,15136,6849,9589,5928,4046,6495,13122,5646.232243,7706,9454,47942,5176,-13904,5208,6740,56011,53118,34038,53150,54682
19001,IA,7428,11966,6849,9589,5669,4046,8325,11966,6652.734512,7394,9589,47076,1814,-13381,5467,7263,53872,48890,33695,52543,54339
19003,IA,7488,11966,6849,9589,5669,4046,8337,11966,6259.953139,7394,9589,46743,1814,-13381,5467,7263,53944,48557,33362,52210,54006
19005,IA,6948,11966,6849,9589,5669,4046,8236,11966,6161.757796,7394,9589,46105,1520,-13675,5041,6969,53303,47625,32430,51146,53074
19007,IA,6948,11966,6849,9589,5669,4046,8236,11966,5670.781079,7394,9589,45614,1520,-13675,5041,6969,53303,47134,31939,50655,52583
19009,IA,6948,11966,6849,9589,5669,4046,8236,11966,6456.343826,7394,9589,46399,1520,-13675,5041,6969,53303,47919,32724,51440,53368
19011,IA,6948,11966,6849,9589,5669,4046,8236,12866,6480.892661,7394,9667,47402,1814,-13381,5467,7263,53303,49216,34021,52869,54665
19013,IA,8640,11966,6849,9589,5669,4046,8552,12140,6309.050811,7394,9401,47931,2109,-13086,5894,7558,55311,50040,34845,53825,55489
19015,IA,7536,11966,6849,9589,5669,4046,8346,11676,6382.697318,7394,9457,46492,1520,-13675,5041,6969,54001,48012,32817,51533,53461
19017,IA,7800,11966,6849,9589,5669,4046,8395,15269,6603.636841,7394,9409,50522,2718,-12478,6766,8166,54314,53240,38044,57288,58688
19019,IA,6948,11966,6849,9589,5669,4046,8236,11966,6603.636841,7394,9589,46547,1520,-13675,5041,6969,53303,48067,32872,51588,53516
19021,IA,7320,11966,6849,9589,5669,4046,8305,12115,6259.953139,7394,9494,46630,1814,-13381,5467,7263,53744,48444,33249,52097,53893
19023,IA,6948,11966,6849,9589,5669,4046,8236,11966,6333.599646,7394,9589,46277,1520,-13675,5041,6969,53303,47797,32602,51318,53246
19025,IA,6948,11966,6849,9589,5669,4046,8236,11966,6161.757796,7394,9589,46105,1520,-13675,5041,6969,53303,47625,32430,51146,53074
19027,IA,6948,11966,6849,9589,5669,4046,8236,11966,6677.283348,7394,9589,46620,1520,-13675,5041,6969,53303,48140,32945,51661,53589
19029,IA,6948,11966,6849,9589,5669,4046,8236,11966,6210.855467,7394,9589,46154,1520,-13675,5041,6969,53303,47674,32479,51195,53123
19031,IA,7620,11966,6849,9589,5669,4046,8361,11966,6505.441497,7394,9589,47120,1814,-13381,5467,7263,54100,48934,33739,52587,54383
19033,IA,7992,11966,6849,9589,5669,4046,8431,13106,6309.050811,7394,9055,47902,2109,-13086,5894,7558,54542,50011,34816,53796,55460
19035,IA,6948,11966,6849,9589,5669,4046,8236,11966,6407.246154,7394,9589,46350,1520,-13675,5041,6969,53303,47870,32675,51391,53319
19037,IA,6948,11966,6849,9589,5669,4046,8236,11966,6382.697318,7394,9589,46326,1520,-13675,5041,6969,53303,47846,32651,51367,53295
19039,IA,7692,11966,6849,9589,5669,4046,8375,11966,6554.539169,7394,9589,47242,1814,-13381,5467,7263,54186,49056,33861,52709,54505
19041,IA,6948,11966,6849,9589,5669,4046,8236,12365,6505.441497,7394,9273,46531,1520,-13675,5041,6969,53303,48051,32856,51572,53500
19043,IA,6948,11966,6849,9589,5669,4046,8236,11966,6333.599646,7394,9589,46277,1520,-13675,5041,6969,53303,47797,32602,51318,53246
19045,IA,7488,11966,6849,9589,5669,4046,8337,11549,6063.562452,7394,9343,45883,1520,-13675,5041,6969,53944,47403,32208,50924,52852
19047,IA,6948,11966,6849,9589,5669,4046,8236,11966,6358.148482,7394,9589,46301,1520,-13675,5041,6969,53303,47821,32626,51342,53270
19049,IA,9396,11966,6849,9589,5669,4046,8694,11102,6800.027527,7394,10160,48898,2109,-13086,5894,7558,56209,51007,35812,54792,56456
19051,IA,7464,11966,6849,9589,5669,4046,8332,11718,5867.171766,7394,9119,45608,1520,-13675,5041,6969,53915,47128,31933,50649,52577
19053,IA,6948,11966,6849,9589,5669,4046,8236,11966,6088.111288,7394,9589,46031,1520,-13675,5041,6969,53303,47551,32356,51072,53000
19055,IA,6948,11966,6849,9589,5669,4046,8236,11966,6407.246154,7394,9589,46350,1520,-13675,5041,6969,53303,47870,32675,51391,53319
19057,IA,8184,11966,6849,9589,5669,4046,8467,11005,6137.20896,7394,8970,45736,1520,-13675,5041,6969,54770,47256,32061,50777,52705
19059,IA,7224,11966,6849,9589,5669,4046,8287,12415,6529.990333,7394,9187,46796,1814,-13381,5467,7263,53630,48610,33415,52263,54059
19061,IA,8700,11966,6849,9589,5669,4046,8564,11338,6603.636841,7394,9545,47627,1814,-13381,5467,7263,55383,49441,34246,53094,54890
19063,IA,7404,11966,6849,9589,5669,4046,8321,11966,6824.576363,7394,9589,47224,1814,-13381,5467,7263,53844,49038,33843,52691,54487
19065,IA,6948,11966,6849,9589,5669,4046,8236,11966,6456.343826,7394,9589,46399,1520,-13675,5041,6969,53303,47919,32724,51440,53368
19067,IA,6948,11966,6849,9589,5669,4046,8236,11966,6358.148482,7394,9589,46301,1520,-13675,5041,6969,53303,47821,32626,51342,53270
19069,IA,6948,11966,6849,9589,5669,4046,8236,11966,6333.599646,7394,9589,46277,1520,-13675,5041,6969,53303,47797,32602,51318,53246
19071,IA,6948,11966,6849,9589,5669,4046,8236,11966,6480.892661,7394,9589,46424,1520,-13675,5041,6969,53303,47944,32749,51465,53393
19073,IA,7080,11966,6849,9589,5669,4046,8260,11966,6529.990333,7394,9589,46605,1520,-13675,5041,6969,53459,48125,32930,51646,53574
19075,IA,8640,11966,6849,9589,5669,4046,8552,11926,6259.953139,7394,9417,47683,2109,-13086,5894,7558,55311,49792,34597,53577,55241
19077,IA,9396,11966,6849,9589,5669,4046,8694,11642,6554.539169,7394,10137,49170,2412,-12784,6328,7860,56209,51582,36386,55498,57030
19079,IA,7824,11966,6849,9589,5669,4046,8400,11966,6358.148482,7394,9589,47177,1814,-13381,5467,7263,54343,48991,33796,52644,54440
19081,IA,6948,11966,6849,9589,5669,4046,8236,11966,6382.697318,7394,9589,46326,1520,-13675,5041,6969,53303,47846,32651,51367,53295
19083,IA,6948,11966,6849,9589,5669,4046,8236,11966,6333.599646,7394,9589,46277,1520,-13675,5041,6969,53303,47797,32602,51318,53246
19085,IA,9480,11966,6849,9589,5669,4046,8710,11870,6603.636841,7394,9809,49202,2412,-12784,6328,7860,56309,51614,36418,55530,57062
19087,IA,7176,11966,6849,9589,5669,4046,8278,11966,5548.0369,7394,9589,45719,1814,-13381,5467,7263,53573,47533,32338,51186,52982
19089,IA,6948,11966,6849,9589,5669,4046,8236,11966,6259.953139,7394,9589,46203,1520,-13675,5041,6969,53303,47723,32528,51244,53172
19091,IA,6948,11966,6849,9589,5669,4046,8236,11966,6161.757796,7394,9589,46105,1520,-13675,5041,6969,53303,47625,32430,51146,53074
19093,IA,6948,11966,6849,9589,5669,4046,8236,11966,6431.79499,7394,9589,46375,1520,-13675,5041,6969,53303,47895,32700,51416,53344
19095,IA,6948,11966,6849,9589,5669,4046,8236,11966,6677.283348,7394,9589,46620,1520,-13675,5041,6969,53303,48140,32945,51661,53589
19097,IA,6948,11966,6849,9589,5669,4046,8236,11966,6431.79499,7394,9589,46375,1520,-13675,5041,6969,53303,47895,32700,51416,53344
19099,IA,7860,11966,6849,9589,5669,4046,8406,11576,6750.929856,7394,9228,46855,1520,-13675,5041,6969,54385,48375,33180,51896,53824
19101,IA,7668,11966,6849,9589,5669,4046,8370,12859,5891.720601,7394,9007,46866,1814,-13381,5467,7263,54157,48680,33485,52333,54129
19103,IA,10212,11966,6849,9589,5669,4046,8847,13356,6898.222871,7394,9602,51508,2718,-12478,6766,8166,57178,54226,39030,58274,59674
19105,IA,6948,11966,6849,9589,5669,4046,8236,11921,6579.088005,7394,9670,46558,1520,-13675,5041,6969,53303,48078,32883,51599,53527
19107,IA,6948,11966,6849,9589,5669,4046,8236,11966,6554.539169,7394,9589,46498,1520,-13675,5041,6969,53303,48018,32823,51539,53467
19109,IA,6948,11966,6849,9589,5669,4046,8236,11966,6726.38102,7394,9589,46669,1520,-13675,5041,6969,53303,48189,32994,51710,53638
19111,IA,7068,11966,6849,9589,5669,4046,8258,13473,5474.390392,7394,9062,46517,1814,-13381,5467,7263,53445,48331,33136,51984,53780
19113,IA,7860,11966,6849,9589,5669,4046,8406,10775,6579.088005,7394,9670,46325,1520,-13675,5041,6969,54385,47845,32650,51366,53294
19115,IA,7416,11966,6849,9589,5669,4046,8323,11966,6505.441497,7394,9589,46916,1814,-13381,5467,7263,53858,48730,33535,52383,54179
19117,IA,6948,11966,6849,9589,5669,4046,8236,11966,6137.20896,7394,9589,46080,1520,-13675,5041,6969,53303,47600,32405,51121,53049
19119,IA,6948,11966,6849,9589,5669,4046,8236,11966,6579.088005,7394,9589,46522,1520,-13675,5041,6969,53303,48042,32847,51563,53491
19121,IA,9396,11966,6849,9589,5669,4046,8694,12390,6554.539169,7394,10144,49925,2718,-12478,6766,8166,56209,52643,37447,56691,58091
19123,IA,7020,11966,6849,9589,5669,4046,8249,11480,6431.79499,7394,9294,45666,1520,-13675,5041,6969,53388,47186,31991,50707,52635
19125,IA,8412,11966,6849,9589,5669,4046,8510,11966,6652.734512,7394,9589,48060,2109,-13086,5894,7558,55041,50169,34974,53954,55618
19127,IA,7500,11966,6849,9589,5669,4046,8339,11962,5940.818273,7394,9549,46392,1814,-13381,5467,7263,53958,48206,33011,51859,53655
19129,IA,9480,11966,6849,9589,5669,4046,8710,13677,6603.636841,7394,9809,51010,2718,-12478,6766,8166,56309,53728,38532,57776,59176
19131,IA,6948,11966,6849,9589,5669,4046,8236,11966,6333.599646,7394,9589,46277,1520,-13675,5041,6969,53303,47797,32602,51318,53246
19133,IA,6948,11966,6849,9589,5669,4046,8236,11966,6431.79499,7394,9589,46375,1520,-13675,5041,6969,53303,47895,32700,51416,53344
19135,IA,7104,11966,6849,9589,5669,4046,8265,11966,5965.367109,7394,9589,46064,1520,-13675,5041,6969,53488,47584,32389,51105,53033
19137,IA,6948,11966,6849,9589,5669,4046,8236,11966,6235.404303,7394,9589,46178,1520,-13675,5041,6969,53303,47698,32503,51219,53147
19139,IA,8556,11966,6849,9589,5669,4046,8537,11743,5940.818273,7394,9618,47297,2109,-13086,5894,7558,55212,49406,34211,53191,54855
19141,IA,6948,11966,6849,9589,5669,4046,8236,11966,6407.246154,7394,9589,46350,1520,-13675,5041,6969,53303,47870,32675,51391,53319
19143,IA,7368,11966,6849,9589,5669,4046,8314,11966,6456.343826,7394,9589,46819,1814,-13381,5467,7263,53801,48633,33438,52286,54082
19145,IA,6948,11966,6849,9589,5669,4046,8236,11966,6480.892661,7394,9589,46424,1520,-13675,5041,6969,53303,47944,32749,51465,53393
19147,IA,6948,11966,6849,9589,5669,4046,8236,11966,6628.185677,7394,9589,46571,1520,-13675,5041,6969,53303,48091,32896,51612,53540
19149,IA,7500,11966,6849,9589,5669,4046,8339,11413,6407.246154,7394,9637,46396,1520,-13675,5041,6969,53958,47916,32721,51437,53365
19151,IA,6948,11966,6849,9589,5669,4046,8236,11966,6210.855467,7394,9589,46154,1520,-13675,5041,6969,53303,47674,32479,51195,53123
19153,IA,9396,11966,6849,9589,5669,4046,8694,11165,6505.441497,7394,10183,48690,2412,-12784,6328,7860,56209,51102,35906,55018,56550
19155,IA,9480,11966,6849,9589,5669,4046,8710,11681,6186.306631,7394,9820,48608,2412,-12784,6328,7860,56309,51020,35824,54936,56468
19157,IA,7740,11966,6849,9589,5669,4046,8384,11966,6186.306631,7394,9589,46921,1814,-13381,5467,7263,54243,48735,33540,52388,54184
19159,IA,6948,11966,6849,9589,5669,4046,8236,11966,6088.111288,7394,9589,46031,1520,-13675,5041,6969,53303,47551,32356,51072,53000
19161,IA,6948,11966,6849,9589,5669,4046,8236,11966,6358.148482,7394,9589,46301,1520,-13675,5041,6969,53303,47821,32626,51342,53270
19163,IA,8196,11966,6849,9589,5669,4046,8469,13808,6554.539169,7394,9369,49367,2412,-12784,6328,7860,54784,51779,36583,55695,57227
19165,IA,6948,11966,6849,9589,5669,4046,8236,11966,6259.953139,7394,9589,46203,1520,-13675,5041,6969,53303,47723,32528,51244,53172
19167,IA,6948,11966,6849,9589,5669,4046,8236,11966,6235.404303,7394,9589,46178,1520,-13675,5041,6969,53303,47698,32503,51219,53147
19169,IA,8604,11966,6849,9589,5669,4046,8546,11149,6628.185677,7394,9488,47309,1814,-13381,5467,7263,55269,49123,33928,52776,54572
19171,IA,7152,11966,6849,9589,5669,4046,8274,11966,6284.501975,7394,9589,46432,1520,-13675,5041,6969,53545,47952,32757,51473,53401
19173,IA,6948,11966,6849,9589,5669,4046,8236,11966,6309.050811,7394,9589,46252,1520,-13675,5041,6969,53303,47772,32577,51293,53221
19175,IA,6948,11966,6849,9589,5669,4046,8236,11966,6210.855467,7394,9589,46154,1520,-13675,5041,6969,53303,47674,32479,51195,53123
19177,IA,6948,11966,6849,9589,5669,4046,8236,11966,5744.427586,7394,9589,45687,1520,-13675,5041,6969,53303,47207,32012,50728,52656
19179,IA,7800,11966,6849,9589,5669,4046,8395,11218,5793.525258,7394,9056,45307,1520,-13675,5041,6969,54314,46827,31632,50348,52276
19181,IA,9396,11966,6849,9589,5669,4046,8694,13548,6701.832184,7394,10147,51232,2718,-12478,6766,8166,56209,53950,38754,57998,59398
19183,IA,7740,11966,6849,9589,5669,4046,8384,10687,6333.599646,7394,9604,45805,1520,-13675,5041,6969,54243,47325,32130,50846,52774
19185,IA,6948,11966,6849,9589,5669,4046,8236,11966,5670.781079,7394,9589,45614,1520,-13675,5041,6969,53303,47134,31939,50655,52583
19187,IA,6948,11966,6849,9589,5669,4046,8236,12257,5940.818273,7394,8879,45465,1520,-13675,5041,6969,53303,46985,31790,50506,52434
19189,IA,6948,11966,6849,9589,5669,4046,8236,11966,6529.990333,7394,9589,46473,1520,-13675,5041,6969,53303,47993,32798,51514,53442
19191,IA,6948,11966,6849,9589,5669,4046,8236,11966,6800.027527,7394,9589,46743,1520,-13675,5041,6969,53303,48263,33068,51784,53712
19193,IA,8352,11966,6849,9589,5669,4046,8498,11631,6505.441497,7394,9649,47577,1814,-13381,5467,7263,54969,49391,34196,53044,54840
19195,IA,6948,11966,6849,9589,5669,4046,8236,16732,6333.599646,7394,9120,50573,2718,-12478,6766,8166,53303,53291,38095,57339,58739
19197,IA,6948,11966,6849,9589,5669,4046,8236,11966,6235.404303,7394,9589,46178,1520,-13675,5041,6969,53303,47698,32503,51219,53147
20001,KS,7464,9358,6849,9589,5789,4046,7158,9358,6971.869378,5930,9589,43359,3123,-15800,2805,4844,50253,46482,27559,46164,48203
20003,KS,7464,9358,6849,9589,5789,4046,7158,9358,7241.906572,5930,9589,43629,3123,-15800,2805,4844,50253,46752,27829,46434,48473
20005,KS,7464,9358,6849,9589,5789,4046,7158,8633,6947.320542,5930,9182,42202,2638,-16285,2401,4359,50253,44840,25917,44603,46561
20007,KS,7464,9358,6849,9589,5789,4046,7158,9358,7241.906572,5930,9589,43629,3123,-15800,2805,4844,50253,46752,27829,46434,48473
20009,KS,7464,9358,6849,9589,5789,4046,7158,8034,6824.576363,5930,9247,41545,2154,-16549,1996,3875,50253,43699,24996,43541,45420
20011,KS,7596,9358,6849,9589,5789,4046,7180,9358,6579.088005,5930,9589,43098,3123,-15800,2805,4844,50407,46221,27298,45903,47942
20013,KS,7464,9358,6849,9589,5789,4046,7158,9358,6407.246154,5930,9589,42794,3123,-15800,2805,4844,50253,45917,26994,45599,47638
20015,KS,8880,9358,6849,9589,5789,4046,7389,9616,7315.55308,5930,9548,45335,3607,-15316,3210,5328,51900,48942,30019,48545,50663
20017,KS,7464,9358,6849,9589,5789,4046,7158,9358,6652.734512,5930,9589,43040,3123,-15800,2805,4844,50253,46163,27240,45845,47884
20019,KS,7464,9358,6849,9589,5789,4046,7158,9358,6873.674035,5930,9589,43261,3123,-15800,2805,4844,50253,46384,27461,46066,48105
20021,KS,7464,9358,6849,9589,5789,4046,7158,9358,7143.711229,5930,9589,43531,3123,-15800,2805,4844,50253,46654,27731,46336,48375
20023,KS,7464,9358,6849,9589,5789,4046,7158,9358,7389.199588,5930,9589,43776,3123,-15800,2805,4844,50253,46899,27976,46581,48620
20025,KS,7464,9358,6849,9589,5789,4046,7158,9358,6701.832184,5930,9589,43089,3123,-15800,2805,4844,50253,46212,27289,45894,47933
20027,KS,8628,9358,6849,9589,5789,4046,7348,9358,6701.832184,5930,9589,44253,3607,-15316,3210,5328,51607,47860,28937,47463,49581
20029,KS,7464,9358,6849,9589,5789,4046,7158,9358,6849.125199,5930,9589,43236,3123,-15800,2805,4844,50253,46359,27436,46041,48080
20031,KS,7464,9358,6849,9589,5789,4046,7158,9358,6407.246154,5930,9589,42794,3123,-15800,2805,4844,50253,45917,26994,45599,47638
20033,KS,7464,9358,6849,9589,5789,4046,7158,9358,7192.808901,5930,9589,43580,3123,-15800,2805,4844,50253,46703,27780,46385,48424
20035,KS,7680,9358,6849,9589,5789,4046,7194,8466,6873.674035,5930,9085,42081,2638,-16285,2401,4359,50505,44719,25796,44482,46440
20037,KS,8028,9358,6849,9589,5789,4046,7250,8470,6088.111288,5930,8692,41254,2638,-16285,2401,4359,50909,43892,24969,43655,45613
20039,KS,7464,9358,6849,9589,5789,4046,7158,9358,7119.162393,5930,9589,43506,3123,-15800,2805,4844,50253,46629,27706,46311,48350
20041,KS,7464,9358,6849,9589,5789,4046,7158,9358,6849.125199,5930,9589,43236,3123,-15800,2805,4844,50253,46359,27436,46041,48080
20043,KS,8940,9358,6849,9589,5789,4046,7399,8793,6456.343826,5930,9369,43535,3123,-15800,2805,4844,51970,46658,27735,46340,48379
20045,KS,9348,9358,6849,9589,5789,4046,7466,11268,7561.041438,5930,9504,47657,4226,-14697,4019,5947,52445,51883,32960,51676,53604
20047,KS,7464,9358,6849,9589,5789,4046,7158,9358,6824.576363,5930,9589,43212,3123,-15800,2805,4844,50253,46335,27412,46017,48056
20049,KS,7464,9358,6849,9589,5789,4046,7158,9358,7168.260065,5930,9589,43555,3123,-15800,2805,4844,50253,46678,27755,46360,48399
20051,KS,7536,9358,6849,9589,5789,4046,7170,9557,7143.711229,5930,9372,43585,3123,-15800,2805,4844,50337,46708,27785,46390,48429
20053,KS,7464,9358,6849,9589,5789,4046,7158,9358,6456.343826,5930,9589,42843,3123,-15800,2805,4844,50253,45966,27043,45648,47687
20055,KS,7908,9358,6849,9589,5789,4046,7231,9653,6407.246154,5930,10018,43962,3607,-15316,3210,5328,50770,47569,28646,47172,49290
20057,KS,7860,9358,6849,9589,5789,4046,7223,9342,6800.027527,5930,10162,44140,3607,-15316,3210,5328,50714,47747,28824,47350,49468
20059,KS,9408,9358,6849,9589,5789,4046,7476,9462,7020.96705,5930,9490,45358,3953,-14970,3614,5674,52515,49311,30388,48972,51032
20061,KS,9432,9358,6849,9589,5789,4046,7479,11075,6726.38102,5930,9741,46951,4498,-14425,4423,6219,52542,51449,32526,51374,53170
20063,KS,7464,9358,6849,9589,5789,4046,7158,9358,7241.906572,5930,9589,43629,3123,-15800,2805,4844,50253,46752,27829,46434,48473
20065,KS,7464,9358,6849,9589,5789,4046,7158,9358,7143.711229,5930,9589,43531,3123,-15800,2805,4844,50253,46654,27731,46336,48375
20067,KS,7464,9358,6849,9589,5789,4046,7158,9358,6480.892661,5930,9589,42868,3123,-15800,2805,4844,50253,45991,27068,45673,47712
20069,KS,7464,9358,6849,9589,5789,4046,7158,9358,6529.990333,5930,9589,42917,3123,-15800,2805,4844,50253,46040,27117,45722,47761
20071,KS,7464,9358,6849,9589,5789,4046,7158,9358,7266.455408,5930,9589,43653,3123,-15800,2805,4844,50253,46776,27853,46458,48497
20073,KS,7464,9358,6849,9589,5789,4046,7158,9358,6726.38102,5930,9589,43113,3123,-15800,2805,4844,50253,46236,27313,45918,47957
20075,KS,8148,9358,6849,9589,5789,4046,7270,9358,6554.539169,5930,9589,43626,3123,-15800,2805,4844,51049,46749,27826,46431,48470
20077,KS,7464,9358,6849,9589,5789,4046,7158,9358,6750.929856,5930,9589,43138,3123,-15800,2805,4844,50253,46261,27338,45943,47982
20079,KS,8880,9358,6849,9589,5789,4046,7389,8860,7119.162393,5930,9544,44379,3607,-15316,3210,5328,51900,47986,29063,47589,49707
20081,KS,7836,9358,6849,9589,5789,4046,7219,9358,6505.441497,5930,9589,43264,3123,-15800,2805,4844,50686,46387,27464,46069,48108
20083,KS,7464,9358,6849,9589,5789,4046,7158,9358,6529.990333,5930,9589,42917,3123,-15800,2805,4844,50253,46040,27117,45722,47761
20085,KS,8556,9358,6849,9589,5789,4046,7337,9048,6800.027527,5930,9381,43761,3123,-15800,2805,4844,51524,46884,27961,46566,48605
20087,KS,8556,9358,6849,9589,5789,4046,7337,9503,7045.515886,5930,9383,44464,3607,-15316,3210,5328,51524,48071,29148,47674,49792
20089,KS,7464,9358,6849,9589,5789,4046,7158,9358,6800.027527,5930,9589,43187,3123,-15800,2805,4844,50253,46310,27387,45992,48031
20091,KS,10224,9358,6849,9589,5789,4046,7609,12018,7143.711229,5930,9684,49045,4771,-14152,4828,6492,53464,53816,34893,53873,55537
20093,KS,7464,9358,6849,9589,5789,4046,7158,9116,6358.148482,5930,9966,42879,3123,-15800,2805,4844,50253,46002,27079,45684,47723
20095,KS,7464,9358,6849,9589,5789,4046,7158,8607,6750.929856,5930,9549,42346,2638,-16285,2401,4359,50253,44984,26061,44747,46705
20097,KS,7464,9358,6849,9589,5789,4046,7158,9358,6824.576363,5930,9589,43212,3123,-15800,2805,4844,50253,46335,27412,46017,48056
20099,KS,7464,9358,6849,9589,5789,4046,7158,7969,7168.260065,5930,9036,41613,2154,-16549,1996,3875,50253,43767,25064,43609,45488
20101,KS,8052,9358,6849,9589,5789,4046,7254,9358,6407.246154,5930,9589,43382,3123,-15800,2805,4844,50937,46505,27582,46187,48226
20103,KS,10224,9358,6849,9589,5789,4046,7609,10550,6677.283348,5930,9687,47115,4498,-14425,4423,6219,53464,51613,32690,51538,53334
20105,KS,7464,9358,6849,9589,5789,4046,7158,9358,6309.050811,5930,9589,42696,3123,-15800,2805,4844,50253,45819,26896,45501,47540
20107,KS,10224,9358,6849,9589,5789,4046,7609,9122,6873.674035,5930,9678,45873,3953,-14970,3614,5674,53464,49826,30903,49487,51547
20109,KS,7464,9358,6849,9589,5789,4046,7158,9358,7094.613557,5930,9589,43482,3123,-15800,2805,4844,50253,46605,27682,46287,48326
20111,KS,7596,9358,6849,9589,5789,4046,7180,9010,6088.111288,5930,8892,41562,2638,-16285,2401,4359,50407,44200,25277,43963,45921
20113,KS,7896,9358,6849,9589,5789,4046,7229,8930,7217.357737,5930,9590,43609,3123,-15800,2805,4844,50756,46732,27809,46414,48453
20115,KS,7464,9358,6849,9589,5789,4046,7158,9358,6726.38102,5930,9589,43113,3123,-15800,2805,4844,50253,46236,27313,45918,47957
20117,KS,7464,9358,6849,9589,5789,4046,7158,9358,7020.96705,5930,9589,43408,3123,-15800,2805,4844,50253,46531,27608,46213,48252
20119,KS,7464,9358,6849,9589,5789,4046,7158,9358,6579.088005,5930,9589,42966,3123,-15800,2805,4844,50253,46089,27166,45771,47810
20121,KS,10224,9358,6849,9589,5789,4046,7609,10416,7610.13911,5930,9682,47908,4498,-14425,4423,6219,53464,52406,33483,52331,54127
20123,KS,7464,9358,6849,9589,5789,4046,7158,9358,6775.478692,5930,9589,43162,3123,-15800,2805,4844,50253,46285,27362,45967,48006
20125,KS,7464,9358,6849,9589,5789,4046,7158,8191,7168.260065,5930,8672,41471,2154,-16549,1996,3875,50253,43625,24922,43467,45346
20127,KS,7464,9358,6849,9589,5789,4046,7158,9358,6750.929856,5930,9589,43138,3123,-15800,2805,4844,50253,46261,27338,45943,47982
20129,KS,7464,9358,6849,9589,5789,4046,7158,9358,6800.027527,5930,9589,43187,3123,-15800,2805,4844,50253,46310,27387,45992,48031
20131,KS,7464,9358,6849,9589,5789,4046,7158,9358,6431.79499,5930,9589,42819,3123,-15800,2805,4844,50253,45942,27019,45624,47663
20133,KS,7464,9358,6849,9589,5789,4046,7158,9358,6677.283348,5930,9589,43064,3123,-15800,2805,4844,50253,46187,27264,45869,47908
20135,KS,7464,9358,6849,9589,5789,4046,7158,9358,6652.734512,5930,9589,43040,3123,-15800,2805,4844,50253,46163,27240,45845,47884
20137,KS,7464,9358,6849,9589,5789,4046,7158,9358,7094.613557,5930,9589,43482,3123,-15800,2805,4844,50253,46605,27682,46287,48326
20139,KS,8556,9358,6849,9589,5789,4046,7337,9000,6775.478692,5930,9376,43683,3123,-15800,2805,4844,51524,46806,27883,46488,48527
20141,KS,7464,9358,6849,9589,5789,4046,7158,9358,7143.711229,5930,9589,43531,3123,-15800,2805,4844,50253,46654,27731,46336,48375
20143,KS,7464,9358,6849,9589,5789,4046,7158,8629,6358.148482,5930,9472,41899,2638,-16285,2401,4359,50253,44537,25614,44300,46258
20145,KS,7740,9358,6849,9589,5789,4046,7203,9358,6971.869378,5930,9589,43635,3123,-15800,2805,4844,50574,46758,27835,46440,48479
20147,KS,7464,9358,6849,9589,5789,4046,7158,9358,7241.906572,5930,9589,43629,3123,-15800,2805,4844,50253,46752,27829,46434,48473
20149,KS,9432,9358,6849,9589,5789,4046,7479,9354,6063.562452,5930,9489,44314,3953,-14970,3614,5674,52542,48267,29344,47928,49988
20151,KS,7752,9358,6849,9589,5789,4046,7205,9358,6529.990333,5930,9589,43205,3123,-15800,2805,4844,50588,46328,27405,46010,48049
20153,KS,7464,9358,6849,9589,5789,4046,7158,9358,7119.162393,5930,9589,43506,3123,-15800,2805,4844,50253,46629,27706,46311,48350
20155,KS,8016,9358,6849,9589,5789,4046,7248,8645,6382.697318,5930,9072,42092,2638,-16285,2401,4359,50895,44730,25807,44493,46451
20157,KS,7464,9358,6849,9589,5789,4046,7158,9358,6922.771707,5930,9589,43310,3123,-15800,2805,4844,50253,46433,27510,46115,48154
20159,KS,7464,9358,6849,9589,5789,4046,7158,9358,6554.539169,5930,9589,42942,3123,-15800,2805,4844,50253,46065,27142,45747,47786
20161,KS,9432,9358,6849,9589,5789,4046,7479,11188,7831.078633,5930,9469,47896,4226,-14697,4019,5947,52542,52122,33199,51915,53843
20163,KS,7464,9358,6849,9589,5789,4046,7158,9358,7045.515886,5930,9589,43433,3123,-15800,2805,4844,50253,46556,27633,46238,48277
20165,KS,7464,9358,6849,9589,5789,4046,7158,9358,6922.771707,5930,9589,43310,3123,-15800,2805,4844,50253,46433,27510,46115,48154
20167,KS,8244,9358,6849,9589,5789,4046,7286,9358,7045.515886,5930,9589,44213,3607,-15316,3210,5328,51161,47820,28897,47423,49541
20169,KS,8100,9358,6849,9589,5789,4046,7262,9261,6309.050811,5930,9466,43112,3123,-15800,2805,4844,50993,46235,27312,45917,47956
20171,KS,7464,9358,6849,9589,5789,4046,7158,9358,6480.892661,5930,9589,42868,3123,-15800,2805,4844,50253,45991,27068,45673,47712
20173,KS,8880,9358,6849,9589,5789,4046,7389,9663,6775.478692,5930,9548,44842,3607,-15316,3210,5328,51900,48449,29526,48052,50170
20175,KS,8700,9358,6849,9589,5789,4046,7360,9552,6849.125199,5930,10035,45112,3953,-14970,3614,5674,51691,49065,30142,48726,50786
20177,KS,8556,9358,6849,9589,5789,4046,7337,9584,6579.088005,5930,9335,44030,3607,-15316,3210,5328,51524,47637,28714,47240,49358
20179,KS,7464,9358,6849,9589,5789,4046,7158,9358,7168.260065,5930,9589,43555,3123,-15800,2805,4844,50253,46678,27755,46360,48399
20181,KS,7464,9358,6849,9589,5789,4046,7158,9358,7413.748423,5930,9589,43801,3123,-15800,2805,4844,50253,46924,28001,46606,48645
20183,KS,7464,9358,6849,9589,5789,4046,7158,9358,6971.869378,5930,9589,43359,3123,-15800,2805,4844,50253,46482,27559,46164,48203
20185,KS,7464,9358,6849,9589,5789,4046,7158,9358,6579.088005,5930,9589,42966,3123,-15800,2805,4844,50253,46089,27166,45771,47810
20187,KS,7464,9358,6849,9589,5789,4046,7158,9358,6579.088005,5930,9589,42966,3123,-15800,2805,4844,50253,46089,27166,45771,47810
20189,KS,9552,9358,6849,9589,5789,4046,7499,9358,6800.027527,5930,9589,45275,3953,-14970,3614,5674,52682,49228,30305,48889,50949
20191,KS,8040,9358,6849,9589,5789,4046,7252,8655,6971.869378,5930,9546,43189,3123,-15800,2805,4844,50923,46312,27389,45994,48033
20193,KS,7464,9358,6849,9589,5789,4046,7158,9358,7070.064722,5930,9589,43457,3123,-15800,2805,4844,50253,46580,27657,46262,48301
20195,KS,7848,9358,6849,9589,5789,4046,7221,9358,7168.260065,5930,9589,43939,3123,-15800,2805,4844,50700,47062,28139,46744,48783
20197,KS,8556,9358,6849,9589,5789,4046,7337,8603,6677.283348,5930,9387,43200,3123,-15800,2805,4844,51524,46323,27400,46005,48044
20199,KS,7464,9358,6849,9589,5789,4046,7158,9358,7241.906572,5930,9589,43629,3123,-15800,2805,4844,50253,46752,27829,46434,48473
20201,KS,7464,9358,6849,9589,5789,4046,7158,9358,7438.297259,5930,9589,43825,3123,-15800,2805,4844,50253,46948,28025,46630,48669
20203,KS,8256,9358,6849,9589,5789,4046,7288,9358,6480.892661,5930,9589,43660,3607,-15316,3210,5328,51175,47267,28344,46870,48988
20205,KS,7464,9358,6849,9589,5789,4046,7158,9358,7020.96705,5930,9589,43408,3123,-15800,2805,4844,50253,46531,27608,46213,48252
20207,KS,7464,9358,6849,9589,5789,4046,7158,9358,6333.599646,5930,9589,42721,3123,-15800,2805,4844,50253,45844,26921,45526,47565
20209,KS,10224,9358,6849,9589,5789,4046,7609,9531,6529.990333,5930,9683,45945,4226,-14697,4019,5947,53464,50171,31248,49964,51892
21001,KY,6780,7364,6704,9859,5517,4284,6075,7364,6127.423835,5938,9859,40352,3813,-15737,2488,4287,46583,44165,24615,42840,44639
21003,KY,6780,7364,6704,9859,5517,4284,6075,7005,6632.035209,5938,9435,40073,3813,-15737,2488,4287,46583,43886,24336,42561,44360
21005,KY,8052,7364,6704,9859,5517,4284,6260,7162,6247.5694,5938,9446,41130,4309,-15641,2904,4783,48040,45439,25489,44034,45913
21007,KY,6780,7364,6704,9859,5517,4284,6075,6850,5935.19093,5938,9328,39116,1024,-18126,-223,1497,46583,40140,20990,38893,40613
21009,KY,6780,7364,6704,9859,5517,4284,6075,7076,6319.656739,5938,8891,39289,1024,-18126,-223,1497,46583,40313,21163,39066,40786
21011,KY,6780,7364,6704,9859,5517,4284,6075,7608,6343.685852,5938,8728,39682,3813,-15737,2488,4287,46583,43495,23945,42170,43969
21013,KY,6780,7364,6704,9859,5517,4284,6075,7186,6247.5694,5938,8022,38457,527,-18222,-639,1000,46583,38984,20235,37818,39457
21015,KY,8820,7364,6704,9859,5517,4284,6371,8477,6487.860531,5938,9879,43885,5798,-14372,4154,6272,48919,49683,29513,48039,50157
21017,KY,8604,7364,6704,9859,5517,4284,6340,7064,6415.773192,5938,9670,41976,4805,-15365,3321,5279,48672,46781,26611,45297,47255
21019,KY,7716,7364,6704,9859,5517,4284,6211,6946,5935.19093,5938,9197,40016,3813,-15737,2488,4287,47655,43829,24279,42504,44303
21021,KY,7680,7364,6704,9859,5517,4284,6206,7073,5718.928912,5938,8670,39364,3813,-15737,2488,4287,47614,43177,23627,41852,43651
21023,KY,8820,7364,6704,9859,5517,4284,6371,7445,6367.714965,5938,9882,42736,5302,-14868,3737,5776,48919,48038,27868,46473,48512
21025,KY,6780,7364,6704,9859,5517,4284,6075,7364,6391.744078,5938,9859,40617,3813,-15737,2488,4287,46583,44430,24880,43105,44904
21027,KY,6780,7364,6704,9859,5517,4284,6075,7364,6559.94787,5938,9859,40785,3813,-15737,2488,4287,46583,44598,25048,43273,45072
21029,KY,8460,7364,6704,9859,5517,4284,6319,7409,6608.006096,5938,9689,42388,4805,-15365,3321,5279,48507,47193,27023,45709,47667
21031,KY,6780,7364,6704,9859,5517,4284,6075,7074,6151.452948,5938,9441,39669,3813,-15737,2488,4287,46583,43482,23932,42157,43956
21033,KY,6780,7364,6704,9859,5517,4284,6075,7364,6223.540287,5938,9859,40449,3813,-15737,2488,4287,46583,44262,24712,42937,44736
21035,KY,7632,7364,6704,9859,5517,4284,6199,7600,6559.94787,5938,8847,40861,4309,-15641,2904,4783,47559,45170,25220,43765,45644
21037,KY,8820,7364,6704,9859,5517,4284,6371,8168,6944.413679,5938,9879,44034,5302,-14868,3737,5776,48919,49336,29166,47771,49810
21039,KY,7284,7364,6704,9859,5517,4284,6148,7364,6007.278269,5938,9859,40736,4309,-15641,2904,4783,47160,45045,25095,43640,45519
21041,KY,7752,7364,6704,9859,5517,4284,6216,7364,5694.899799,5938,9859,40892,4309,-15641,2904,4783,47696,45201,25251,43796,45675
21043,KY,6780,7364,6704,9859,5517,4284,6075,7364,7256.792149,5938,9859,41482,3813,-15737,2488,4287,46583,45295,25745,43970,45769
21045,KY,6780,7364,6704,9859,5517,4284,6075,7364,5887.132704,5938,9859,40112,3813,-15737,2488,4287,46583,43925,24375,42600,44399
21047,KY,9204,7364,6704,9859,5517,4284,6427,7488,6031.307382,5938,9691,42637,5302,-14868,3737,5776,49359,47939,27769,46374,48413
21049,KY,8604,7364,6704,9859,5517,4284,6340,7685,6415.773192,5938,9660,42586,4805,-15365,3321,5279,48672,47391,27221,45907,47865
21051,KY,6780,7364,6704,9859,5517,4284,6075,7364,6391.744078,5938,9859,40617,3813,-15737,2488,4287,46583,44430,24880,43105,44904
21053,KY,6780,7364,6704,9859,5517,4284,6075,7364,6127.423835,5938,9859,40352,3813,-15737,2488,4287,46583,44165,24615,42840,44639
21055,KY,6780,7364,6704,9859,5517,4284,6075,7364,6463.831418,5938,9859,40689,3813,-15737,2488,4287,46583,44502,24952,43177,44976
21057,KY,6780,7364,6704,9859,5517,4284,6075,7364,6247.5694,5938,9859,40473,3813,-15737,2488,4287,46583,44286,24736,42961,44760
21059,KY,7512,7364,6704,9859,5517,4284,6181,7005,6247.5694,5938,9528,40515,3813,-15737,2488,4287,47421,44328,24778,43003,44802
21061,KY,7932,7364,6704,9859,5517,4284,6242,7418,6151.452948,5938,9438,41161,4309,-15641,2904,4783,47902,45470,25520,44065,45944
21063,KY,6780,7364,6704,9859,5517,4284,6075,7364,6319.656739,5938,9859,40545,3813,-15737,2488,4287,46583,44358,24808,43033,44832
21065,KY,6780,7364,6704,9859,5517,4284,6075,7364,6367.714965,5938,9859,40593,3813,-15737,2488,4287,46583,44406,24856,43081,44880
21067,KY,8604,7364,6704,9859,5517,4284,6340,8279,6391.744078,5938,9647,43145,5302,-14868,3737,5776,48672,48447,28277,46882,48921
21069,KY,6780,7364,6704,9859,5517,4284,6075,7364,6247.5694,5938,9859,40473,3813,-15737,2488,4287,46583,44286,24736,42961,44760
21071,KY,6780,7364,6704,9859,5517,4284,6075,7364,6776.209888,5938,9859,41001,3813,-15737,2488,4287,46583,44814,25264,43489,45288
21073,KY,7980,7364,6704,9859,5517,4284,6249,7682,6583.976983,5938,9411,41879,4309,-15641,2904,4783,47957,46188,26238,44783,46662
21075,KY,6780,7364,6704,9859,5517,4284,6075,6577,6055.336495,5938,8766,38400,1024,-18126,-223,1497,46583,39424,20274,38177,39897
21077,KY,8820,7364,6704,9859,5517,4284,6371,8422,6439.802305,5938,9881,43785,5798,-14372,4154,6272,48919,49583,29413,47939,50057
21079,KY,6864,7364,6704,9859,5517,4284,6087,7364,6175.482061,5938,9859,40484,4309,-15641,2904,4783,46679,44793,24843,43388,45267
21081,KY,8232,7364,6704,9859,5517,4284,6286,8120,6199.511174,5938,9881,42654,5302,-14868,3737,5776,48246,47956,27786,46391,48430
21083,KY,6912,7364,6704,9859,5517,4284,6094,6790,6247.5694,5938,8903,39075,1024,-18126,-223,1497,46734,40099,20949,38852,40572
21085,KY,6780,7364,6704,9859,5517,4284,6075,7364,5935.19093,5938,9859,40160,3813,-15737,2488,4287,46583,43973,24423,42648,44447
21087,KY,6780,7364,6704,9859,5517,4284,6075,7364,6103.394722,5938,9859,40328,3813,-15737,2488,4287,46583,44141,24591,42816,44615
21089,KY,7716,7364,6704,9859,5517,4284,6211,6999,6896.355453,5938,9179,41012,3813,-15737,2488,4287,47655,44825,25275,43500,45299
21091,KY,7512,7364,6704,9859,5517,4284,6181,7363,6343.685852,5938,9534,40975,4309,-15641,2904,4783,47421,45284,25334,43879,45758
21093,KY,7020,7364,6704,9859,5517,4284,6110,7696,5983.249156,5938,9694,40615,4309,-15641,2904,4783,46858,44924,24974,43519,45398
21095,KY,6780,7364,6704,9859,5517,4284,6075,7364,6367.714965,5938,9859,40593,3813,-15737,2488,4287,46583,44406,24856,43081,44880
21097,KY,7188,7364,6704,9859,5517,4284,6134,7364,6415.773192,5938,9859,41049,4309,-15641,2904,4783,47050,45358,25408,43953,45832
21099,KY,6780,7364,6704,9859,5517,4284,6075,7364,6007.278269,5938,9859,40232,3813,-15737,2488,4287,46583,44045,24495,42720,44519
21101,KY,8868,7364,6704,9859,5517,4284,6378,7273,6511.889644,5938,9601,42476,4805,-15365,3321,5279,48974,47281,27111,45797,47755
21103,KY,8460,7364,6704,9859,5517,4284,6319,7166,6247.5694,5938,9690,41786,4805,-15365,3321,5279,48507,46591,26421,45107,47065
21105,KY,6780,7364,6704,9859,5517,4284,6075,7364,6391.744078,5938,9859,40617,3813,-15737,2488,4287,46583,44430,24880,43105,44904
21107,KY,6780,7364,6704,9859,5517,4284,6075,6959,6535.918757,5938,9291,39787,1024,-18126,-223,1497,46583,40811,21661,39564,41284
21109,KY,7584,7364,6704,9859,5517,4284,6192,7364,6103.394722,5938,9859,41132,4309,-15641,2904,4783,47504,45441,25491,44036,45915
21111,KY,8460,7364,6704,9859,5517,4284,6319,8031,6463.831418,5938,9659,42837,5302,-14868,3737,5776,48507,48139,27969,46574,48613
21113,KY,8604,7364,6704,9859,5517,4284,6340,8098,6391.744078,5938,9664,42979,5302,-14868,3737,5776,48672,48281,28111,46716,48755
21115,KY,6780,7364,6704,9859,5517,4284,6075,7364,6391.744078,5938,9859,40617,3813,-15737,2488,4287,46583,44430,24880,43105,44904
21117,KY,8820,7364,6704,9859,5517,4284,6371,8016,6391.744078,5938,9880,43331,5302,-14868,3737,5776,48919,48633,28463,47068,49107
21119,KY,6780,7364,6704,9859,5517,4284,6075,7364,6439.802305,5938,9859,40665,3813,-15737,2488,4287,46583,44478,24928,43153,44952
21121,KY,6780,7364,6704,9859,5517,4284,6075,7726,6175.482061,5938,8458,39361,1024,-18126,-223,1497,46583,40385,21235,39138,40858
21123,KY,7020,7364,6704,9859,5517,4284,6110,6959,6031.307382,5938,9707,39940,3813,-15737,2488,4287,46858,43753,24203,42428,44227
21125,KY,7008,7364,6704,9859,5517,4284,6108,7585,5815.045365,5938,8462,39092,1024,-18126,-223,1497,46844,40116,20966,38869,40589
21127,KY,6780,7364,6704,9859,5517,4284,6075,7364,6175.482061,5938,9859,40400,3813,-15737,2488,4287,46583,44213,24663,42888,44687
21129,KY,6780,7364,6704,9859,5517,4284,6075,7364,6031.307382,5938,9859,40256,3813,-15737,2488,4287,46583,44069,24519,42744,44543
21131,KY,6912,7364,6704,9859,5517,4284,6094,7364,6295.627626,5938,9859,40653,4309,-15641,2904,4783,46734,44962,25012,43557,45436
21133,KY,6780,7364,6704,9859,5517,4284,6075,7364,6343.685852,5938,9859,40569,3813,-15737,2488,4287,46583,44382,24832,43057,44856
21135,KY,6780,7364,6704,9859,5517,4284,6075,7364,6079.365608,5938,9859,40304,3813,-15737,2488,4287,46583,44117,24567,42792,44591
21137,KY,6780,7364,6704,9859,5517,4284,6075,7088,6007.278269,5938,8722,38820,1024,-18126,-223,1497,46583,39844,20694,38597,40317
21139,KY,6780,7364,6704,9859,5517,4284,6075,6836,6031.307382,5938,9322,39192,1024,-18126,-223,1497,46583,40216,21066,38969,40689
21141,KY,7332,7364,6704,9859,5517,4284,6155,7364,6055.336495,5938,9859,40832,4309,-15641,2904,4783,47215,45141,25191,43736,45615
21143,KY,6780,7364,6704,9859,5517,4284,6075,7364,6511.889644,5938,9859,40737,3813,-15737,2488,4287,46583,44550,25000,43225,45024
21145,KY,7380,7364,6704,9859,5517,4284,6162,7299,5911.161817,5938,9254,40066,3813,-15737,2488,4287,47270,43879,24329,42554,44353
21147,KY,6780,7364,6704,9859,5517,4284,6075,7364,5983.249156,5938,9859,40208,3813,-15737,2488,4287,46583,44021,24471,42696,44495
21149,KY,7512,7364,6704,9859,5517,4284,6181,6836,6295.627626,5938,9540,40405,3813,-15737,2488,4287,47421,44218,24668,42893,44692
21151,KY,7248,7364,6704,9859,5517,4284,6143,7850,6391.744078,5938,9337,41049,4309,-15641,2904,4783,47119,45358,25408,43953,45832
21153,KY,6780,7364,6704,9859,5517,4284,6075,7364,6415.773192,5938,9859,40641,3813,-15737,2488,4287,46583,44454,24904,43129,44928
21155,KY,7092,7364,6704,9859,5517,4284,6120,7364,5983.249156,5938,9859,40520,4309,-15641,2904,4783,46940,44829,24879,43424,45303
21157,KY,7476,7364,6704,9859,5517,4284,6176,7364,6511.889644,5938,9859,41433,4309,-15641,2904,4783,47380,45742,25792,44337,46216
21159,KY,6780,7364,6704,9859,5517,4284,6075,7364,6367.714965,5938,9859,40593,3813,-15737,2488,4287,46583,44406,24856,43081,44880
21161,KY,6912,7364,6704,9859,5517,4284,6094,7148,6175.482061,5938,9431,39888,3813,-15737,2488,4287,46734,43701,24151,42376,44175
21163,KY,7632,7364,6704,9859,5517,4284,6199,7855,6247.5694,5938,9703,41659,4805,-15365,3321,5279,47559,46464,26294,44980,46938
21165,KY,6780,7364,6704,9859,5517,4284,6075,6864,6295.627626,5938,8751,38912,1024,-18126,-223,1497,46583,39936,20786,38689,40409
21167,KY,7152,7364,6704,9859,5517,4284,6129,7364,6199.511174,5938,9859,40797,4309,-15641,2904,4783,47009,45106,25156,43701,45580
21169,KY,7248,7364,6704,9859,5517,4284,6143,6676,6199.511174,5938,8932,39277,1024,-18126,-223,1497,47119,40301,21151,39054,40774
21171,KY,6780,7364,6704,9859,5517,4284,6075,7364,6343.685852,5938,9859,40569,3813,-15737,2488,4287,46583,44382,24832,43057,44856
21173,KY,6948,7364,6704,9859,5517,4284,6099,7465,6271.598513,5938,8681,39587,3813,-15737,2488,4287,46775,43400,23850,42075,43874
21175,KY,6780,7364,6704,9859,5517,4284,6075,7364,6271.598513,5938,9859,40497,3813,-15737,2488,4287,46583,44310,24760,42985,44784
21177,KY,6780,7364,6704,9859,5517,4284,6075,7364,6223.540287,5938,9859,40449,3813,-15737,2488,4287,46583,44262,24712,42937,44736
21179,KY,7344,7364,6704,9859,5517,4284,6157,7078,6463.831418,5938,9560,40667,3813,-15737,2488,4287,47229,44480,24930,43155,44954
21181,KY,6780,7364,6704,9859,5517,4284,6075,7364,6295.627626,5938,9859,40521,3813,-15737,2488,4287,46583,44334,24784,43009,44808
21183,KY,6780,7364,6704,9859,5517,4284,6075,7364,6079.365608,5938,9859,40304,3813,-15737,2488,4287,46583,44117,24567,42792,44591
21185,KY,8460,7364,6704,9859,5517,4284,6319,8476,6656.064322,5938,9695,43509,5302,-14868,3737,5776,48507,48811,28641,47246,49285
21187,KY,7296,7364,6704,9859,5517,4284,6150,7364,6511.889644,5938,9859,41253,4309,-15641,2904,4783,47174,45562,25612,44157,46036
21189,KY,6780,7364,6704,9859,5517,4284,6075,7364,6367.714965,5938,9859,40593,3813,-15737,2488,4287,46583,44406,24856,43081,44880
21191,KY,8820,7364,6704,9859,5517,4284,6371,7481,6511.889644,5938,9881,42915,5302,-14868,3737,5776,48919,48217,28047,46652,48691
21193,KY,6780,7364,6704,9859,5517,4284,6075,7364,6487.860531,5938,9859,40713,3813,-15737,2488,4287,46583,44526,24976,43201,45000
21195,KY,8520,7364,6704,9859,5517,4284,6328,7364,6415.773192,5938,9859,42381,4805,-15365,3321,5279,48576,47186,27016,45702,47660
21197,KY,6780,7364,6704,9859,5517,4284,6075,7364,6319.656739,5938,9859,40545,3813,-15737,2488,4287,46583,44358,24808,43033,44832
21199,KY,6912,7364,6704,9859,5517,4284,6094,7231,5766.987138,5938,8606,38738,1024,-18126,-223,1497,46734,39762,20612,38515,40235
21201,KY,8940,7364,6704,9859,5517,4284,6389,7364,6175.482061,5938,9859,42560,5302,-14868,3737,5776,49057,47862,27692,46297,48336
21203,KY,6780,7364,6704,9859,5517,4284,6075,7091,5935.19093,5938,9383,39411,3813,-15737,2488,4287,46583,43224,23674,41899,43698
21205,KY,6888,7364,6704,9859,5517,4284,6091,7364,6367.714965,5938,9859,40701,4309,-15641,2904,4783,46707,45010,25060,43605,45484
21207,KY,6780,7364,6704,9859,5517,4284,6075,7364,5911.161817,5938,9859,40136,3813,-15737,2488,4287,46583,43949,24399,42624,44423
21209,KY,8604,7364,6704,9859,5517,4284,6340,7700,6680.093435,5938,9663,42869,4805,-15365,3321,5279,48672,47674,27504,46190,48148
21211,KY,8280,7364,6704,9859,5517,4284,6293,7775,6463.831418,5938,9682,42423,4805,-15365,3321,5279,48301,47228,27058,45744,47702
21213,KY,7500,7364,6704,9859,5517,4284,6179,7364,6343.685852,5938,9859,41289,4309,-15641,2904,4783,47407,45598,25648,44193,46072
21215,KY,8460,7364,6704,9859,5517,4284,6319,7424,6463.831418,5938,9692,42262,4805,-15365,3321,5279,48507,47067,26897,45583,47541
21217,KY,7272,7364,6704,9859,5517,4284,6146,6676,6031.307382,5938,8711,38912,1024,-18126,-223,1497,47146,39936,20786,38689,40409
21219,KY,7008,7364,6704,9859,5517,4284,6108,7364,6175.482061,5938,9859,40628,4309,-15641,2904,4783,46844,44937,24987,43532,45411
21221,KY,9204,7364,6704,9859,5517,4284,6427,7116,6295.627626,5938,9700,42537,4805,-15365,3321,5279,49359,47342,27172,45858,47816
21223,KY,8460,7364,6704,9859,5517,4284,6319,7430,6007.278269,5938,9688,41808,4805,-15365,3321,5279,48507,46613,26443,45129,47087
21225,KY,6780,7364,6704,9859,5517,4284,6075,7364,6199.511174,5938,9859,40425,3813,-15737,2488,4287,46583,44238,24688,42913,44712
21227,KY,7932,7364,6704,9859,5517,4284,6242,7572,6151.452948,5938,9386,41264,4309,-15641,2904,4783,47902,45573,25623,44168,46047
21229,KY,6780,7364,6704,9859,5517,4284,6075,7364,6031.307382,5938,9859,40256,3813,-15737,2488,4287,46583,44069,24519,42744,44543
21231,KY,6780,7364,6704,9859,5517,4284,6075,7364,6055.336495,5938,9859,40280,3813,-15737,2488,4287,46583,44093,24543,42768,44567
21233,KY,8868,7364,6704,9859,5517,4284,6378,7364,6487.860531,5938,9859,42801,5302,-14868,3737,5776,48974,48103,27933,46538,48577
21235,KY,7164,7364,6704,9859,5517,4284,6131,7353,6367.714965,5938,8476,39583,1024,-18126,-223,1497,47023,40607,21457,39360,41080
21237,KY,7596,7364,6704,9859,5517,4284,6193,7364,6079.365608,5938,9859,41120,4309,-15641,2904,4783,47517,45429,25479,44024,45903
21239,KY,8604,7364,6704,9859,5517,4284,6340,7351,7040.530132,5938,9672,42890,4805,-15365,3321,5279,48672,47695,27525,46211,48169
22001,LA,7644,12835,6704,9859,6239,4284,6303,11547,6800.239001,8302,9742,48320,6249,-14341,4639,6303,53868,54569,33979,52959,54623
22003,LA,7644,12835,6704,9859,6239,4284,6303,12835,6439.802305,8302,9859,49364,6515,-14075,5037,6569,53868,55879,35289,54401,55933
22005,LA,9588,12835,6704,9859,6239,4284,6605,14228,7160.675697,8302,9923,53486,7315,-13275,6233,7369,56114,60801,40211,59719,60855
22007,LA,7872,12835,6704,9859,6239,4284,6338,12835,6968.442792,8302,9859,50120,6515,-14075,5037,6569,54131,56635,36045,55157,56689
22009,LA,7980,12835,6704,9859,6239,4284,6355,12835,6367.714965,8302,9859,49628,6515,-14075,5037,6569,54256,56143,35553,54665,56197
22011,LA,8064,12835,6704,9859,6239,4284,6368,12841,6439.802305,8302,9598,49528,6515,-14075,5037,6569,54353,56043,35453,54565,56097
22013,LA,7644,12835,6704,9859,6239,4284,6303,12835,6704.122548,8302,9859,49628,6515,-14075,5037,6569,53868,56143,35553,54665,56197
22015,LA,9084,12835,6704,9859,6239,4284,6526,14255,6848.297227,8302,9532,52305,7315,-13275,6233,7369,55531,59620,39030,58538,59674
22017,LA,9084,12835,6704,9859,6239,4284,6526,13217,6728.151662,8302,9524,51138,6782,-13808,5436,6836,55531,57920,37330,56574,57974
22019,LA,8748,12835,6704,9859,6239,4284,6474,12933,6439.802305,8302,9554,50261,6782,-13808,5436,6836,55143,57043,36453,55697,57097
22021,LA,7644,12835,6704,9859,6239,4284,6303,12835,6415.773192,8302,9859,49340,6515,-14075,5037,6569,53868,55855,35265,54377,55909
22023,LA,8748,12835,6704,9859,6239,4284,6474,12691,6175.482061,8302,9574,49775,6782,-13808,5436,6836,55143,56557,35967,55211,56611
22025,LA,7644,12835,6704,9859,6239,4284,6303,12835,6391.744078,8302,9859,49316,6515,-14075,5037,6569,53868,55831,35241,54353,55885
22027,LA,7644,12835,6704,9859,6239,4284,6303,12835,6656.064322,8302,9859,49580,6515,-14075,5037,6569,53868,56095,35505,54617,56149
22029,LA,7644,12835,6704,9859,6239,4284,6303,11474,6680.093435,8302,8250,46634,5716,-14874,3842,5770,53868,52350,31760,50476,52404
22031,LA,9084,12835,6704,9859,6239,4284,6526,13373,6535.918757,8302,9537,51116,6782,-13808,5436,6836,55531,57898,37308,56552,57952
22033,LA,9588,12835,6704,9859,6239,4284,6605,14369,6992.471905,8302,9931,53467,7315,-13275,6233,7369,56114,60782,40192,59700,60836
22035,LA,7644,12835,6704,9859,6239,4284,6303,12835,6487.860531,8302,9859,49412,6515,-14075,5037,6569,53868,55927,35337,54449,55981
22037,LA,9588,12835,6704,9859,6239,4284,6605,12853,7136.646584,8302,9917,52081,6782,-13808,5436,6836,56114,58863,38273,57517,58917
22039,LA,7644,12835,6704,9859,6239,4284,6303,12835,6463.831418,8302,9859,49388,6515,-14075,5037,6569,53868,55903,35313,54425,55957
22041,LA,7644,12835,6704,9859,6239,4284,6303,12835,6175.482061,8302,9859,49099,6515,-14075,5037,6569,53868,55614,35024,54136,55668
22043,LA,7872,12835,6704,9859,6239,4284,6338,12755,6824.268114,8302,9409,49447,6515,-14075,5037,6569,54131,55962,35372,54484,56016
22045,LA,8484,12835,6704,9859,6239,4284,6433,12863,6487.860531,8302,9735,50156,6782,-13808,5436,6836,54838,56938,36348,55592,56992
22047,LA,7644,12835,6704,9859,6239,4284,6303,12201,6992.471905,8302,9920,49344,6515,-14075,5037,6569,53868,55859,35269,54381,55913
22049,LA,7644,12835,6704,9859,6239,4284,6303,12835,6511.889644,8302,9859,49436,6515,-14075,5037,6569,53868,55951,35361,54473,56005
22051,LA,11376,12835,6704,9859,6239,4284,6882,15045,7064.559245,8302,9644,55715,7848,-12742,7030,7902,58179,63563,42973,62745,63617
22053,LA,7644,12835,6704,9859,6239,4284,6303,12835,6608.006096,8302,9859,49532,6515,-14075,5037,6569,53868,56047,35457,54569,56101
22055,LA,9492,12835,6704,9859,6239,4284,6590,14233,7160.675697,8302,9752,53224,7315,-13275,6233,7369,56003,60539,39949,59457,60593
22057,LA,9276,12835,6704,9859,6239,4284,6556,13135,6968.442792,8302,9922,51887,6782,-13808,5436,6836,55753,58669,38079,57323,58723
22059,LA,7644,12835,6704,9859,6239,4284,6303,12835,6223.540287,8302,9859,49148,6515,-14075,5037,6569,53868,55663,35073,54185,55717
22061,LA,9108,12835,6704,9859,6239,4284,6530,13496,6800.239001,8302,8916,50906,6782,-13808,5436,6836,55559,57688,37098,56342,57742
22063,LA,9588,12835,6704,9859,6239,4284,6605,14180,6559.94787,8302,9922,52835,7315,-13275,6233,7369,56114,60150,39560,59068,60204
22065,LA,7908,12835,6704,9859,6239,4284,6344,12835,6439.802305,8302,9859,49628,6515,-14075,5037,6569,54173,56143,35553,54665,56197
22067,LA,8292,12835,6704,9859,6239,4284,6404,11266,6199.511174,8302,8421,46765,5982,-14608,4240,6036,54617,52747,32157,51005,52801
22069,LA,8724,12835,6704,9859,6239,4284,6471,13240,6824.268114,8302,8781,50155,6782,-13808,5436,6836,55116,56937,36347,55591,56991
22071,LA,11376,12835,6704,9859,6239,4284,6882,17150,7737.374411,8302,9616,58466,8381,-11881,7827,8435,58179,66847,46585,66293,66901
22073,LA,8316,12835,6704,9859,6239,4284,6407,12822,6487.860531,8302,8966,49178,6515,-14075,5037,6569,54644,55693,35103,54215,55747
22075,LA,11376,12835,6704,9859,6239,4284,6882,17215,6175.482061,8302,9661,57014,8381,-11881,7827,8435,58179,65395,45133,64841,65449
22077,LA,9588,12835,6704,9859,6239,4284,6605,13006,7040.530132,8302,9918,52139,6782,-13808,5436,6836,56114,58921,38331,57575,58975
22079,LA,7872,12835,6704,9859,6239,4284,6338,12926,6151.452948,8302,9369,48905,6515,-14075,5037,6569,54131,55420,34830,53942,55474
22081,LA,7644,12835,6704,9859,6239,4284,6303,12835,6728.151662,8302,9859,49652,6515,-14075,5037,6569,53868,56167,35577,54689,56221
22083,LA,7644,12835,6704,9859,6239,4284,6303,12835,6391.744078,8302,9859,49316,6515,-14075,5037,6569,53868,55831,35241,54353,55885
22085,LA,7644,12835,6704,9859,6239,4284,6303,12835,6656.064322,8302,9859,49580,6515,-14075,5037,6569,53868,56095,35505,54617,56149
22087,LA,11376,12835,6704,9859,6239,4284,6882,12807,6776.209888,8302,9662,53207,7315,-13275,6233,7369,58179,60522,39932,59440,60576
22089,LA,11376,12835,6704,9859,6239,4284,6882,14614,7400.966828,8302,9656,55633,7848,-12742,7030,7902,58179,63481,42891,62663,63535
22091,LA,9588,12835,6704,9859,6239,4284,6605,13025,6896.355453,8302,9917,52013,6782,-13808,5436,6836,56114,58795,38205,57449,58849
22093,LA,7644,12835,6704,9859,6239,4284,6303,12921,7376.937715,8302,9657,50185,6515,-14075,5037,6569,53868,56700,36110,55222,56754
22095,LA,11376,12835,6704,9859,6239,4284,6882,13194,6968.442792,8302,9646,53771,7315,-13275,6233,7369,58179,61086,40496,60004,61140
22097,LA,7644,12835,6704,9859,6239,4284,6303,11824,6415.773192,8302,8823,47293,5982,-14608,4240,6036,53868,53275,32685,51533,53329
22099,LA,9492,12835,6704,9859,6239,4284,6590,12633,6944.413679,8302,9748,51403,6782,-13808,5436,6836,56003,58185,37595,56839,58239
22101,LA,8352,12835,6704,9859,6239,4284,6413,12749,6848.297227,8302,9392,49928,6515,-14075,5037,6569,54686,56443,35853,54965,56497
22103,LA,11376,12835,6704,9859,6239,4284,6882,15028,7304.850375,8302,9649,55945,7848,-12742,7030,7902,58179,63793,43203,62975,63847
22105,LA,9864,12835,6704,9859,6239,4284,6647,13986,6992.471905,8302,9506,52934,7315,-13275,6233,7369,56432,60249,39659,59167,60303
22107,LA,7644,12835,6704,9859,6239,4284,6303,12835,6463.831418,8302,9859,49388,6515,-14075,5037,6569,53868,55903,35313,54425,55957
22109,LA,9276,12835,6704,9859,6239,4284,6556,13457,6463.831418,8302,9927,51710,6782,-13808,5436,6836,55753,58492,37902,57146,58546
22111,LA,8316,12835,6704,9859,6239,4284,6407,12613,6559.94787,8302,9040,49115,6515,-14075,5037,6569,54644,55630,35040,54152,55684
22113,LA,7884,12835,6704,9859,6239,4284,6340,12298,6559.94787,8302,9743,49071,6515,-14075,5037,6569,54145,55586,34996,54108,55640
22115,LA,10980,12835,6704,9859,6239,4284,6821,14318,6295.627626,8302,9841,54021,7848,-12742,7030,7902,57722,61869,41279,61051,61923
22117,LA,7884,12835,6704,9859,6239,4284,6340,11910,6872.32634,8302,8449,47701,5982,-14608,4240,6036,54145,53683,33093,51941,53737
22119,LA,7644,12835,6704,9859,6239,4284,6303,12197,6608.006096,8302,9517,48552,6249,-14341,4639,6303,53868,54801,34211,53191,54855
22121,LA,9588,12835,6704,9859,6239,4284,6605,13596,7112.617471,8302,9924,52807,7315,-13275,6233,7369,56114,60122,39532,59040,60176
22123,LA,7644,12835,6704,9859,6239,4284,6303,12835,6319.656739,8302,9859,49244,6515,-14075,5037,6569,53868,55759,35169,54281,55813
22125,LA,9588,12835,6704,9859,6239,4284,6605,14582,6848.297227,8302,9917,53521,7315,-13275,6233,7369,56114,60836,40246,59754,60890
22127,LA,7644,12835,6704,9859,6239,4284,6303,12835,6343.685852,8302,9859,49268,6515,-14075,5037,6569,53868,55783,35193,54305,55837
23001,ME,9024,13960,7786,7901,6405,3987,8865,11857,8762.898533,7258,7543,48432,5036,-15603,3245,5041,57928,53468,32829,51677,53473
23003,ME,7644,13960,7786,7901,6405,3987,8597,13960,8232.65945,7258,7901,48983,5292,-15347,3633,5297,56280,54275,33636,52616,54280
23005,ME,11871,13960,7786,7901,6405,3987,9420,16941,9321.044937,7258,7875,57254,6891,-13748,6024,6896,61330,64145,43506,63278,64150
23007,ME,7956,13960,7786,7901,6405,3987,8658,13960,8902.435134,7258,7901,49964,5292,-15347,3633,5297,56653,55256,34617,53597,55261
23009,ME,9876,13960,7786,7901,6405,3987,9031,13960,9488.488858,7258,7901,52470,5825,-14814,4430,5830,58946,58295,37656,56900,58300
23011,ME,9264,13960,7786,7901,6405,3987,8912,16916,8651.269253,7258,7498,53575,6358,-14281,5227,6363,58215,59933,39294,58802,59938
23013,ME,10608,13960,7786,7901,6405,3987,9174,13960,9962.913301,7258,7901,53677,5825,-14814,4430,5830,59821,59502,38863,58107,59507
23015,ME,11016,13960,7786,7901,6405,3987,9253,13960,10353.61578,7258,7901,54476,5825,-14814,4430,5830,60308,60301,39662,58906,60306
23017,ME,8364,13960,7786,7901,6405,3987,8737,13960,8567.547292,7258,7901,50038,5558,-15081,4031,5563,57140,55596,34957,54069,55601
23019,ME,9486,13960,7786,7901,6405,3987,8955,14907,8511.732652,7258,7512,51661,5825,-14814,4430,5830,58480,57486,36847,56091,57491
23021,ME,7800,13960,7786,7901,6405,3987,8627,13960,8986.157095,7258,7901,49892,5292,-15347,3633,5297,56466,55184,34545,53525,55189
23023,ME,10344,13960,7786,7901,6405,3987,9122,15785,10241.9865,7258,7883,55499,6358,-14281,5227,6363,59505,61857,41218,60726,61862
23025,ME,8472,13960,7786,7901,6405,3987,8758,13960,8148.93749,7258,7901,49727,5558,-15081,4031,5563,57269,55285,34646,53758,55290
23027,ME,8832,13960,7786,7901,6405,3987,8828,13960,9739.654739,7258,7901,51678,5558,-15081,4031,5563,57699,57236,36597,55709,57241
23029,ME,7968,13960,7786,7901,6405,3987,8660,13960,8734.991213,7258,7901,49809,5292,-15347,3633,5297,56667,55101,34462,53442,55106
23031,ME,11168,13960,7786,7901,6405,3987,9283,12944,9293.137616,7258,7882,52533,5825,-14814,4430,5830,60490,58358,37719,56963,58363
24001,MD,7644,3426,6704,9859,6145,4284,6730,3099,7040.530132,6430,8652,37149,-10790,-19557,-2616,-1136,44792,26359,17592,34533,36013
24003,MD,15024,3426,6704,9859,6145,4284,7801,3821,7136.646584,6430,10642,47338,-547,-14487,4229,6157,53243,46791,32851,51567,53495
24005,MD,15024,3426,6704,9859,6145,4284,7801,3796,6968.442792,6430,10692,47195,-547,-14487,4229,6157,53243,46648,32708,51424,53352
24009,MD,17628,3426,6704,9859,6145,4284,8179,4375,8169.898446,6430,11156,52043,549,-13391,5853,7253,56225,52592,38652,57896,59296
24011,MD,10692,3426,6704,9859,6145,4284,7172,3426,6800.239001,6430,9859,41491,-2626,-16346,2199,4078,48282,38865,25145,43690,45569
24013,MD,15024,3426,6704,9859,6145,4284,7801,4416,7761.403524,6430,10631,48546,-273,-14213,4635,6431,53243,48273,34333,53181,54977
24015,MD,13620,3426,6704,9859,6145,4284,7597,3958,6656.064322,6430,10382,45330,-821,-14761,3823,5883,51635,44509,30569,49153,51213
24017,MD,17628,3426,6704,9859,6145,4284,8179,3655,7088.588358,6430,11208,50294,275,-13665,5447,6979,56225,50569,36629,55741,57273
24019,MD,10164,3426,6704,9859,6145,4284,7096,3616,6559.94787,6430,9390,40444,-3112,-16432,1793,3592,47678,37332,24012,42237,44036
24021,MD,17628,3426,6704,9859,6145,4284,8179,3021,7064.559245,6430,11261,49688,275,-13665,5447,6979,56225,49963,36023,55135,56667
24023,MD,8292,3426,6704,9859,6145,4284,6824,3426,6583.976983,6430,9859,38875,-9219,-19387,-1804,-165,45534,29656,19488,37071,38710
24025,MD,15024,3426,6704,9859,6145,4284,7801,3420,7208.733923,6430,10626,46992,-547,-14487,4229,6157,53243,46445,32505,51221,53149
24027,MD,15024,3426,6704,9859,6145,4284,7801,3333,8001.694655,6430,10653,47727,-547,-14487,4229,6157,53243,47180,33240,51956,53884
24028,MD,18672,3426,6704,9859,6145,4284,8331,3426,6704,6430,9859,49375,275,-13665,5447,6979,57421,49650,35710,54822,56354
24029,MD,11328,3426,6704,9859,6145,4284,7265,3426,7593.199732,6430,9859,42920,-2141,-16081,2605,4563,49011,40779,26839,45525,47483
24031,MD,17628,3426,6704,9859,6145,4284,8179,3166,8121.84022,6430,11487,51117,275,-13665,5447,6979,56225,51392,37452,56564,58096
24033,MD,17628,3426,6704,9859,6145,4284,8179,3414,6872.32634,6430,11452,50080,275,-13665,5447,6979,56225,50355,36415,55527,57059
24035,MD,15024,3426,6704,9859,6145,4284,7801,3752,8770.626273,6430,10579,48840,-547,-14487,4229,6157,53243,48293,34353,53069,54997
24037,MD,14592,3426,6704,9859,6145,4284,7738,3480,7112.617471,6430,11148,47047,-547,-14487,4229,6157,52748,46500,32560,51276,53204
24039,MD,8352,3426,6704,9859,6145,4284,6832,3215,6463.831418,6430,9697,38442,-9219,-19387,-1804,-165,45602,29223,19055,36638,38277
24041,MD,12720,3426,6704,9859,6145,4284,7467,3560,7977.665542,6430,9979,44951,-1654,-15594,3011,5050,50605,43297,29357,47962,50001
24043,MD,11616,3426,6704,9859,6145,4284,7306,3778,6656.064322,6430,9796,42560,-2141,-16081,2605,4563,49340,40419,26479,45165,47123
24045,MD,10500,3426,6704,9859,6145,4284,7144,3935,6632.035209,6430,9686,41467,-2626,-16346,2199,4078,48062,38841,25121,43666,45545
24047,MD,10656,3426,6704,9859,6145,4284,7167,3257,7497.08328,6430,9695,41820,-2626,-16346,2199,4078,48241,39194,25474,44019,45898
24510,MD,15024,3426,6704,9859,6145,4284,7801,3331,7449.025054,6430,10847,47365,-547,-14487,4229,6157,53243,46818,32878,51594,53522
25001,MA,14112,10125,7786,7901,6204,3987,8961,10695,9990.820621,7114,7852,53750,7055,-12587,6657,8057,59076,60805,41163,60407,61807
25003,MA,9648,10125,7786,7901,6204,3987,8214,11272,9544.303498,7114,7470,49036,6220,-13422,5426,7222,53865,55256,35614,54462,56258
25005,MA,11262,10125,7786,7901,6204,3987,8484,9830,8344.288731,7114,7904,48441,6220,-13422,5426,7222,55749,54661,35019,53867,55663
25007,MA,15648,10125,7786,7901,6204,3987,9217,10009,9014.064415,7114,8552,54324,7611,-12031,7477,8613,60868,61935,42293,61801,62937
25009,MA,15798,10125,7786,7901,6204,3987,9242,10244,8707.083893,7114,8596,54447,7611,-12031,7477,8613,61043,62058,42416,61924,63060
25011,MA,11423,10125,7786,7901,6204,3987,8511,10774,8930.342454,7114,7743,49971,6499,-13143,5837,7501,55937,56470,36828,55808,57472
25013,MA,11412,10125,7786,7901,6204,3987,8509,9095,7981.493569,7114,7714,47304,6220,-13422,5426,7222,55924,53524,33882,52730,54526
25015,MA,11412,10125,7786,7901,6204,3987,8509,12988,9181.508336,7114,7730,52412,7055,-12587,6657,8057,55924,59467,39825,59069,60469
25017,MA,16742,10125,7786,7901,6204,3987,9400,12924,9014.064415,7114,8625,58406,8723,-10591,9117,9725,62145,67129,47815,67523,68131
25019,MA,21588,10125,7786,7901,6204,3987,10211,10125,8874.527814,7114,7901,59590,9279,-9611,9937,10281,67802,68869,49979,69527,69871
25021,MA,17424,10125,7786,7901,6204,3987,9514,11654,8762.898533,7114,8605,57547,8723,-10591,9117,9725,62941,66270,46956,66664,67272
25023,MA,15676,10125,7786,7901,6204,3987,9222,11762,9293.137616,7114,8546,56378,8167,-11475,8297,9169,60901,64545,44903,64675,65547
25025,MA,17448,10125,7786,7901,6204,3987,9518,11139,9544.303498,7114,8824,58056,8723,-10591,9117,9725,62969,66779,47465,67173,67781
25027,MA,11371,10125,7786,7901,6204,3987,8502,12346,8483.825332,7114,8414,51715,7055,-12587,6657,8057,55876,58770,39128,58372,59772
26001,MI,7644,5881,6849,9589,5589,4046,7011,5881,6554.539169,6086,9589,39801,3747,-16198,2027,3826,46609,43548,23603,41828,43627
26003,MI,7644,5881,6849,9589,5589,4046,7011,5881,6922.771707,6086,9589,40169,3747,-16198,2027,3826,46609,43916,23971,42196,43995
26005,MI,8328,5881,6849,9589,5589,4046,7118,6308,6652.734512,6086,9552,40973,4228,-16118,2427,4306,47400,45201,24855,43400,45279
26007,MI,7644,5881,6849,9589,5589,4046,7011,5424,6628.185677,6086,8320,38149,528,-18616,-1033,606,46609,38677,19533,37116,38755
26009,MI,7776,5881,6849,9589,5589,4046,7031,5881,7438.297259,6086,9589,40816,3747,-16198,2027,3826,46761,44563,24618,42843,44642
26011,MI,7644,5881,6849,9589,5589,4046,7011,5881,6358.148482,6086,9589,39604,3747,-16198,2027,3826,46609,43351,23406,41631,43430
26013,MI,7644,5881,6849,9589,5589,4046,7011,5881,7020.96705,6086,9589,40267,3747,-16198,2027,3826,46609,44014,24069,42294,44093
26015,MI,8160,5881,6849,9589,5589,4046,7092,5951,6431.79499,6086,9623,40298,3747,-16198,2027,3826,47206,44045,24100,42325,44124
26017,MI,7896,5881,6849,9589,5589,4046,7050,5856,6161.757796,6086,9071,39117,1010,-18535,-632,1088,46900,40127,20582,38485,40205
26019,MI,8208,5881,6849,9589,5589,4046,7100,5602,6873.674035,6086,9291,40107,3747,-16198,2027,3826,47262,43854,23909,42134,43933
26021,MI,8328,5881,6849,9589,5589,4046,7118,5872,6259.953139,6086,9117,39709,3747,-16198,2027,3826,47400,43456,23511,41736,43535
26023,MI,7944,5881,6849,9589,5589,4046,7058,5681,5695.329915,6086,9053,38505,1010,-18535,-632,1088,46956,39515,19970,37873,39593
26025,MI,8268,5881,6849,9589,5589,4046,7109,5942,6235.404303,6086,9029,39606,3747,-16198,2027,3826,47331,43353,23408,41633,43432
26027,MI,7644,5881,6849,9589,5589,4046,7011,5630,6800.027527,6086,9254,39461,1010,-18535,-632,1088,46609,40471,20926,38829,40549
26029,MI,8244,5881,6849,9589,5589,4046,7105,5881,7511.943767,6086,9589,41358,3747,-16198,2027,3826,47303,45105,25160,43385,45184
26031,MI,7644,5881,6849,9589,5589,4046,7011,5881,6554.539169,6086,9589,39801,3747,-16198,2027,3826,46609,43548,23603,41828,43627
26033,MI,7728,5881,6849,9589,5589,4046,7024,5859,6726.38102,6086,8738,39183,1010,-18535,-632,1088,46706,40193,20648,38551,40271
26035,MI,7644,5881,6849,9589,5589,4046,7011,5881,5867.171766,6086,9589,39113,3747,-16198,2027,3826,46609,42860,22915,41140,42939
26037,MI,9144,5881,6849,9589,5589,4046,7247,6598,6873.674035,6086,9349,42097,4708,-15857,2829,4787,48345,46805,26240,44926,46884
26039,MI,8256,5881,6849,9589,5589,4046,7107,5881,6628.185677,6086,9589,40486,3747,-16198,2027,3826,47317,44233,24288,42513,44312
26041,MI,7644,5881,6849,9589,5589,4046,7011,5513,6775.478692,6086,8857,38922,528,-18616,-1033,606,46609,39450,20306,37889,39528
26043,MI,7644,5881,6849,9589,5589,4046,7011,5287,6824.576363,6086,8934,38821,528,-18616,-1033,606,46609,39349,20205,37788,39427
26045,MI,9144,5881,6849,9589,5589,4046,7247,6708,6407.246154,6086,9336,41727,4708,-15857,2829,4787,48345,46435,25870,44556,46514
26047,MI,9228,5881,6849,9589,5589,4046,7260,5881,7241.906572,6086,9589,42072,4228,-16118,2427,4306,48442,46300,25954,44499,46378
26049,MI,8520,5881,6849,9589,5589,4046,7149,6170,6358.148482,6086,8874,40054,3747,-16198,2027,3826,47623,43801,23856,42081,43880
26051,MI,7644,5881,6849,9589,5589,4046,7011,5881,7020.96705,6086,9589,40267,3747,-16198,2027,3826,46609,44014,24069,42294,44093
26053,MI,7644,5881,6849,9589,5589,4046,7011,5881,6407.246154,6086,9589,39653,3747,-16198,2027,3826,46609,43400,23455,41680,43479
26055,MI,9780,5881,6849,9589,5589,4046,7347,6627,7143.711229,6086,9264,42947,4708,-15857,2829,4787,49081,47655,27090,45776,47734
26057,MI,7644,5881,6849,9589,5589,4046,7011,5678,6235.404303,6086,8769,38458,1010,-18535,-632,1088,46609,39468,19923,37826,39546
26059,MI,7932,5881,6849,9589,5589,4046,7056,5697,6039.013616,6086,9016,38816,1010,-18535,-632,1088,46942,39826,20281,38184,39904
26061,MI,7764,5881,6849,9589,5589,4046,7030,5529,7045.515886,6086,8457,38927,528,-18616,-1033,606,46748,39455,20311,37894,39533
26063,MI,7644,5881,6849,9589,5589,4046,7011,5881,6358.148482,6086,9589,39604,3747,-16198,2027,3826,46609,43351,23406,41631,43430
26065,MI,9144,5881,6849,9589,5589,4046,7247,6903,6726.38102,6086,9316,42222,4708,-15857,2829,4787,48345,46930,26365,45051,47009
26067,MI,8112,5881,6849,9589,5589,4046,7084,6185,6284.501975,6086,9307,40021,3747,-16198,2027,3826,47150,43768,23823,42048,43847
26069,MI,7644,5881,6849,9589,5589,4046,7011,5881,6775.478692,6086,9589,40021,3747,-16198,2027,3826,46609,43768,23823,42048,43847
26071,MI,7644,5881,6849,9589,5589,4046,7011,5881,6480.892661,6086,9589,39727,3747,-16198,2027,3826,46609,43474,23529,41754,43553
26073,MI,8328,5881,6849,9589,5589,4046,7118,6638,6431.79499,6086,8756,40285,3747,-16198,2027,3826,47400,44032,24087,42312,44111
26075,MI,9264,5881,6849,9589,5589,4046,7266,6094,6112.660124,6086,9137,40739,4228,-16118,2427,4306,48484,44967,24621,43166,45045
26077,MI,8616,5881,6849,9589,5589,4046,7164,6678,6529.990333,6086,9245,41201,4228,-16118,2427,4306,47734,45429,25083,43628,45507
26079,MI,8604,5881,6849,9589,5589,4046,7162,5614,6849.125199,6086,9270,40470,3747,-16198,2027,3826,47720,44217,24272,42497,44296
26081,MI,8880,5881,6849,9589,5589,4046,7206,6835,6431.79499,6086,9630,41909,4708,-15857,2829,4787,48040,46617,26052,44738,46696
26083,MI,7716,5881,6849,9589,5589,4046,7022,4979,7020.96705,6086,8564,38412,528,-18616,-1033,606,46692,38940,19796,37379,39018
26085,MI,7644,5881,6849,9589,5589,4046,7011,5881,6186.306631,6086,9589,39432,3747,-16198,2027,3826,46609,43179,23234,41459,43258
26087,MI,10116,5881,6849,9589,5589,4046,7400,6232,6628.185677,6086,9403,42511,4708,-15857,2829,4787,49470,47219,26654,45340,47298
26089,MI,9612,5881,6849,9589,5589,4046,7321,6408,11243.36681,6086,9300,46696,4708,-15857,2829,4787,48887,51404,30839,49525,51483
26091,MI,8388,5881,6849,9589,5589,4046,7128,6023,5891.720601,6086,9217,39651,3747,-16198,2027,3826,47470,43398,23453,41678,43477
26093,MI,10656,5881,6849,9589,5589,4046,7486,7145,6628.185677,6086,9394,43954,5670,-14895,3631,5749,50096,49624,29059,47585,49703
26095,MI,7644,5881,6849,9589,5589,4046,7011,5881,6922.771707,6086,9589,40169,3747,-16198,2027,3826,46609,43916,23971,42196,43995
26097,MI,7836,5881,6849,9589,5589,4046,7041,5881,6873.674035,6086,9589,40312,3747,-16198,2027,3826,46831,44059,24114,42339,44138
26099,MI,10116,5881,6849,9589,5589,4046,7400,6991,6652.734512,6086,9373,43265,5190,-15376,3229,5268,49470,48455,27889,46494,48533
26101,MI,7680,5881,6849,9589,5589,4046,7016,5881,6898.222871,6086,9589,40180,3747,-16198,2027,3826,46650,43927,23982,42207,44006
26103,MI,8340,5881,6849,9589,5589,4046,7120,5926,7094.613557,6086,9115,40608,3747,-16198,2027,3826,47414,44355,24410,42635,44434
26105,MI,8040,5881,6849,9589,5589,4046,7073,5981,6284.501975,6086,8764,39201,1010,-18535,-632,1088,47067,40211,20666,38569,40289
26107,MI,7644,5881,6849,9589,5589,4046,7011,6033,6235.404303,6086,8656,38700,1010,-18535,-632,1088,46609,39710,20165,38068,39788
26109,MI,7644,5881,6849,9589,5589,4046,7011,5258,7953.822812,6086,8744,39733,528,-18616,-1033,606,46609,40261,21117,38700,40339
26111,MI,8928,5881,6849,9589,5589,4046,7213,6389,6898.222871,6086,9346,41693,4228,-16118,2427,4306,48095,45921,25575,44120,45999
26113,MI,7644,5881,6849,9589,5589,4046,7011,5425,6726.38102,6086,9047,38974,1010,-18535,-632,1088,46609,39984,20439,38342,40062
26115,MI,10116,5881,6849,9589,5589,4046,7400,6522,6505.441497,6086,9476,42752,5190,-15376,3229,5268,49470,47942,27376,45981,48020
26117,MI,7812,5881,6849,9589,5589,4046,7037,5686,6186.306631,6086,9623,39439,3747,-16198,2027,3826,46803,43186,23241,41466,43265
26119,MI,7992,5881,6849,9589,5589,4046,7065,5881,6652.734512,6086,9589,40247,3747,-16198,2027,3826,47011,43994,24049,42274,44073
26121,MI,7656,5881,6849,9589,5589,4046,7012,5747,6137.20896,6086,8926,38598,1010,-18535,-632,1088,46622,39608,20063,37966,39686
26123,MI,7644,5881,6849,9589,5589,4046,7011,5881,6039.013616,6086,9589,39285,3747,-16198,2027,3826,46609,43032,23087,41312,43111
26125,MI,10116,5881,6849,9589,5589,4046,7400,7780,6775.478692,6086,9375,44178,5670,-14895,3631,5749,49470,49848,29283,47809,49927
26127,MI,7764,5881,6849,9589,5589,4046,7030,5881,6554.539169,6086,9589,39921,3747,-16198,2027,3826,46748,43668,23723,41948,43747
26129,MI,7656,5881,6849,9589,5589,4046,7012,5881,6358.148482,6086,9589,39616,3747,-16198,2027,3826,46622,43363,23418,41643,43442
26131,MI,7644,5881,6849,9589,5589,4046,7011,5881,6505.441497,6086,9589,39751,3747,-16198,2027,3826,46609,43498,23553,41778,43577
26133,MI,7644,5881,6849,9589,5589,4046,7011,5881,5253.45087,6086,9589,38499,3747,-16198,2027,3826,46609,42246,22301,40526,42325
26135,MI,8220,5881,6849,9589,5589,4046,7101,5881,6628.185677,6086,9589,40450,3747,-16198,2027,3826,47275,44197,24252,42477,44276
26137,MI,7956,5881,6849,9589,5589,4046,7060,5881,6750.929856,6086,9589,40309,3747,-16198,2027,3826,46970,44056,24111,42336,44135
26139,MI,9444,5881,6849,9589,5589,4046,7294,6690,6259.953139,6086,9627,42154,4708,-15857,2829,4787,48692,46862,26297,44983,46941
26141,MI,7644,5881,6849,9589,5589,4046,7011,5881,6824.576363,6086,9589,40071,3747,-16198,2027,3826,46609,43818,23873,42098,43897
26143,MI,7644,5881,6849,9589,5589,4046,7011,5881,6456.343826,6086,9589,39702,3747,-16198,2027,3826,46609,43449,23504,41729,43528
26145,MI,8508,5881,6849,9589,5589,4046,7147,5888,6186.306631,6086,8992,39706,3747,-16198,2027,3826,47609,43453,23508,41733,43532
26147,MI,10116,5881,6849,9589,5589,4046,7400,6275,6358.148482,6086,9392,42273,4708,-15857,2829,4787,49470,46981,26416,45102,47060
26149,MI,7884,5881,6849,9589,5589,4046,7048,5620,6235.404303,6086,9243,39114,1010,-18535,-632,1088,46886,40124,20579,38482,40202
26151,MI,7644,5881,6849,9589,5589,4046,7011,5881,6186.306631,6086,9589,39432,3747,-16198,2027,3826,46609,43179,23234,41459,43258
26153,MI,7644,5881,6849,9589,5589,4046,7011,5881,6750.929856,6086,9589,39997,3747,-16198,2027,3826,46609,43744,23799,42024,43823
26155,MI,8100,5881,6849,9589,5589,4046,7083,5873,5891.720601,6086,9169,39165,3747,-16198,2027,3826,47137,42912,22967,41192,42991
26157,MI,7644,5881,6849,9589,5589,4046,7011,5881,6137.20896,6086,9589,39383,3747,-16198,2027,3826,46609,43130,23185,41410,43209
26159,MI,8616,5881,6849,9589,5589,4046,7164,6071,6529.990333,6086,9251,40600,3747,-16198,2027,3826,47734,44347,24402,42627,44426
26161,MI,11424,5881,6849,9589,5589,4046,7607,8160,6947.320542,6086,9553,46217,6282,-14283,4433,6361,50985,52499,31934,50650,52578
26163,MI,10116,5881,6849,9589,5589,4046,7400,6556,6480.892661,6086,9364,42649,5190,-15376,3229,5268,49470,47839,27273,45878,47917
26165,MI,7788,5881,6849,9589,5589,4046,7033,5895,6259.953139,6086,9014,39089,1010,-18535,-632,1088,46775,40099,20554,38457,40177
27001,MN,8472,10125,6849,9589,5836,4046,8749,10125,6701.832184,6302,9589,45236,3421,-14839,3745,5805,53666,48657,30397,48981,51041
27003,MN,11352,10125,6849,9589,5836,4046,9284,11498,6554.539169,6302,10307,50060,4906,-13354,5890,7290,57081,54966,36706,55950,57350
27005,MN,7644,10125,6849,9589,5836,4046,8596,10125,6726.38102,6302,9589,44432,3050,-15210,3316,5434,52685,47482,29222,47748,49866
27007,MN,8088,10125,6849,9589,5836,4046,8678,9999,6628.185677,6302,9212,44276,3050,-15210,3316,5434,53211,47326,29066,47592,49710
27009,MN,9024,10125,6849,9589,5836,4046,8852,10543,7438.297259,6302,9680,47033,3718,-14542,4174,6102,54321,50751,32491,51207,53135
27011,MN,7644,10125,6849,9589,5836,4046,8596,10125,6701.832184,6302,9589,44408,3050,-15210,3316,5434,52685,47458,29198,47724,49842
27013,MN,8448,10125,6849,9589,5836,4046,8745,10530,6579.088005,6302,9757,45662,3421,-14839,3745,5805,53638,49083,30823,49407,51467
27015,MN,7644,10125,6849,9589,5836,4046,8596,8820,6996.418214,6302,9212,43021,2055,-16204,2482,4440,52685,45076,26817,45503,47461
27017,MN,8304,10125,6849,9589,5836,4046,8718,9313,7020.96705,6302,9117,44103,2548,-15712,2893,4932,53467,46651,28391,46996,49035
27019,MN,11352,10125,6849,9589,5836,4046,9284,12785,8935.776245,6302,10287,53708,4906,-13354,5890,7290,57081,58614,40354,59598,60998
27021,MN,8580,10125,6849,9589,5836,4046,8770,9043,6407.246154,6302,8991,43370,2548,-15712,2893,4932,53795,45918,27658,46263,48302
27023,MN,7752,10125,6849,9589,5836,4046,8616,10125,6873.674035,6302,9589,44688,3050,-15210,3316,5434,52813,47738,29478,48004,50122
27025,MN,11352,10125,6849,9589,5836,4046,9284,10632,7291.004244,6302,10276,49899,4609,-13651,5461,6993,57081,54508,36248,55360,56892
27027,MN,8208,10125,6849,9589,5836,4046,8700,10542,7192.808901,6302,9618,45909,3421,-14839,3745,5805,53353,49330,31070,49654,51714
27029,MN,7644,10125,6849,9589,5836,4046,8596,10125,6726.38102,6302,9589,44432,3050,-15210,3316,5434,52685,47482,29222,47748,49866
27031,MN,9504,10125,6849,9589,5836,4046,8941,10125,6849.125199,6302,9589,46415,3718,-14542,4174,6102,54890,50133,31873,50589,52517
27033,MN,7644,10125,6849,9589,5836,4046,8596,10125,6726.38102,6302,9589,44432,3050,-15210,3316,5434,52685,47482,29222,47748,49866
27035,MN,8652,10125,6849,9589,5836,4046,8783,9502,6480.892661,6302,8941,43924,3050,-15210,3316,5434,53880,46974,28714,47240,49358
27037,MN,11352,10125,6849,9589,5836,4046,9284,12887,7168.260065,6302,10325,52081,4906,-13354,5890,7290,57081,56987,38727,57971,59371
27039,MN,10356,10125,6849,9589,5836,4046,9099,9910,6750.929856,6302,10195,47560,4015,-14245,4603,6399,55900,51575,33315,52163,53959
27041,MN,7644,10125,6849,9589,5836,4046,8596,9740,6873.674035,6302,9270,43876,2548,-15712,2893,4932,52685,46424,28164,46769,48808
27043,MN,7644,10125,6849,9589,5836,4046,8596,10125,6677.283348,6302,9589,44383,3050,-15210,3316,5434,52685,47433,29173,47699,49817
27045,MN,7644,10125,6849,9589,5836,4046,8596,8897,6652.734512,6302,10182,43723,2548,-15712,2893,4932,52685,46271,28011,46616,48655
27047,MN,7644,10125,6849,9589,5836,4046,8596,8716,7168.260065,6302,9137,43013,2055,-16204,2482,4440,52685,45068,26809,45495,47453
27049,MN,8940,10125,6849,9589,5836,4046,8836,10827,7487.394931,6302,9601,47203,3718,-14542,4174,6102,54221,50921,32661,51377,53305
27051,MN,7644,10125,6849,9589,5836,4046,8596,10125,6873.674035,6302,9589,44580,3050,-15210,3316,5434,52685,47630,29370,47896,50014
27053,MN,11352,10125,6849,9589,5836,4046,9284,13049,7241.906572,6302,10370,52361,4906,-13354,5890,7290,57081,57267,39007,58251,59651
27055,MN,8388,10125,6849,9589,5836,4046,8734,9039,6603.636841,6302,9556,43935,3050,-15210,3316,5434,53567,46985,28725,47251,49369
27057,MN,7644,10125,6849,9589,5836,4046,8596,10125,6824.576363,6302,9589,44531,3050,-15210,3316,5434,52685,47581,29321,47847,49965
27059,MN,11352,10125,6849,9589,5836,4046,9284,10437,7020.96705,6302,10283,49440,4609,-13651,5461,6993,57081,54049,35789,54901,56433
27061,MN,8964,10125,6849,9589,5836,4046,8841,10125,6750.929856,6302,9589,45777,3421,-14839,3745,5805,54250,49198,30938,49522,51582
27063,MN,7644,10125,6849,9589,5836,4046,8596,10125,6603.636841,6302,9589,44310,3050,-15210,3316,5434,52685,47360,29100,47626,49744
27065,MN,9240,10125,6849,9589,5836,4046,8892,10125,6750.929856,6302,9589,46053,3718,-14542,4174,6102,54577,49771,31511,50227,52155
27067,MN,7848,10125,6849,9589,5836,4046,8634,9850,6849.125199,6302,9468,44363,3050,-15210,3316,5434,52927,47413,29153,47679,49797
27069,MN,7644,10125,6849,9589,5836,4046,8596,10125,6849.125199,6302,9589,44555,3050,-15210,3316,5434,52685,47605,29345,47871,49989
27071,MN,7644,10125,6849,9589,5836,4046,8596,10125,6701.832184,6302,9589,44408,3050,-15210,3316,5434,52685,47458,29198,47724,49842
27073,MN,7644,10125,6849,9589,5836,4046,8596,10125,6849.125199,6302,9589,44555,3050,-15210,3316,5434,52685,47605,29345,47871,49989
27075,MN,7752,10125,6849,9589,5836,4046,8616,10125,6898.222871,6302,9589,44712,3050,-15210,3316,5434,52813,47762,29502,48028,50146
27077,MN,7644,10125,6849,9589,5836,4046,8596,10125,6701.832184,6302,9589,44408,3050,-15210,3316,5434,52685,47458,29198,47724,49842
27079,MN,8544,10125,6849,9589,5836,4046,8763,9806,6677.283348,6302,10276,45652,3421,-14839,3745,5805,53752,49073,30813,49397,51457
27081,MN,7644,10125,6849,9589,5836,4046,8596,10125,7094.613557,6302,9589,44801,3050,-15210,3316,5434,52685,47851,29591,48117,50235
27083,MN,7644,10125,6849,9589,5836,4046,8596,9413,7020.96705,6302,9514,43940,2548,-15712,2893,4932,52685,46488,28228,46833,48872
27085,MN,8052,10125,6849,9589,5836,4046,8671,10243,7094.613557,6302,9607,45345,3421,-14839,3745,5805,53168,48766,30506,49090,51150
27087,MN,7644,10125,6849,9589,5836,4046,8596,10125,6873.674035,6302,9589,44580,3050,-15210,3316,5434,52685,47630,29370,47896,50014
27089,MN,7644,10125,6849,9589,5836,4046,8596,10125,6750.929856,6302,9589,44457,3050,-15210,3316,5434,52685,47507,29247,47773,49891
27091,MN,7980,10125,6849,9589,5836,4046,8658,10125,6922.771707,6302,9589,44965,3050,-15210,3316,5434,53083,48015,29755,48281,50399
27093,MN,9012,10125,6849,9589,5836,4046,8850,10125,7020.96705,6302,9589,46095,3421,-14839,3745,5805,54307,49516,31256,49840,51900
27095,MN,8712,10125,6849,9589,5836,4046,8794,9882,6726.38102,6302,10276,45944,3718,-14542,4174,6102,53951,49662,31402,50118,52046
27097,MN,7656,10125,6849,9589,5836,4046,8598,10125,6873.674035,6302,9589,44592,3050,-15210,3316,5434,52699,47642,29382,47908,50026
27099,MN,8376,10125,6849,9589,5836,4046,8732,8934,5965.367109,6302,9307,42930,2548,-15712,2893,4932,53553,45478,27218,45823,47862
27101,MN,7644,10125,6849,9589,5836,4046,8596,10125,6628.185677,6302,9589,44334,3050,-15210,3316,5434,52685,47384,29124,47650,49768
27103,MN,8448,10125,6849,9589,5836,4046,8745,10571,7659.236782,6302,9755,46781,3421,-14839,3745,5805,53638,50202,31942,50526,52586
27105,MN,7644,10125,6849,9589,5836,4046,8596,8867,6210.855467,6302,9613,42683,2548,-15712,2893,4932,52685,45231,26971,45576,47615
27107,MN,7644,10125,6849,9589,5836,4046,8596,10125,6898.222871,6302,9589,44604,3050,-15210,3316,5434,52685,47654,29394,47920,50038
27109,MN,10356,10125,6849,9589,5836,4046,9099,11092,6750.929856,6302,10217,48764,4312,-13948,5032,6696,55900,53076,34816,53796,55460
27111,MN,7644,10125,6849,9589,5836,4046,8596,9316,6898.222871,6302,9187,43393,2548,-15712,2893,4932,52685,45941,27681,46286,48325
27113,MN,7644,10125,6849,9589,5836,4046,8596,10125,6750.929856,6302,9589,44457,3050,-15210,3316,5434,52685,47507,29247,47773,49891
27115,MN,8664,10125,6849,9589,5836,4046,8785,10125,6947.320542,6302,9589,45673,3421,-14839,3745,5805,53894,49094,30834,49418,51478
27117,MN,7644,10125,6849,9589,5836,4046,8596,10125,6652.734512,6302,9589,44359,3050,-15210,3316,5434,52685,47409,29149,47675,49793
27119,MN,8700,10125,6849,9589,5836,4046,8792,9460,6996.418214,6302,9414,44919,3050,-15210,3316,5434,53937,47969,29709,48235,50353
27121,MN,8376,10125,6849,9589,5836,4046,8732,10125,6849.125199,6302,9589,45287,3421,-14839,3745,5805,53553,48708,30448,49032,51092
27123,MN,11352,10125,6849,9589,5836,4046,9284,12349,7168.260065,6302,10373,51591,4906,-13354,5890,7290,57081,56497,38237,57481,58881
27125,MN,7644,10125,6849,9589,5836,4046,8596,10125,6971.869378,6302,9589,44678,3050,-15210,3316,5434,52685,47728,29468,47994,50112
27127,MN,7644,10125,6849,9589,5836,4046,8596,10125,6922.771707,6302,9589,44629,3050,-15210,3316,5434,52685,47679,29419,47945,50063
27129,MN,7644,10125,6849,9589,5836,4046,8596,10125,6971.869378,6302,9589,44678,3050,-15210,3316,5434,52685,47728,29468,47994,50112
27131,MN,10188,10125,6849,9589,5836,4046,9068,10866,6628.185677,6302,9634,47665,4015,-14245,4603,6399,55701,51680,33420,52268,54064
27133,MN,7644,10125,6849,9589,5836,4046,8596,10125,6603.636841,6302,9589,44310,3050,-15210,3316,5434,52685,47360,29100,47626,49744
27135,MN,7644,10125,6849,9589,5836,4046,8596,10125,6750.929856,6302,9589,44457,3050,-15210,3316,5434,52685,47507,29247,47773,49891
27137,MN,8304,10125,6849,9589,5836,4046,8718,9627,6873.674035,6302,9076,44229,3050,-15210,3316,5434,53467,47279,29019,47545,49663
27139,MN,11352,10125,6849,9589,5836,4046,9284,12686,6726.38102,6302,10288,51400,4906,-13354,5890,7290,57081,56306,38046,57290,58690
27141,MN,11352,10125,6849,9589,5836,4046,9284,10676,6431.79499,6302,10254,49061,4609,-13651,5461,6993,57081,53670,35410,54522,56054
27143,MN,7644,10125,6849,9589,5836,4046,8596,9084,7045.515886,6302,10268,44389,3050,-15210,3316,5434,52685,47439,29179,47705,49823
27145,MN,9024,10125,6849,9589,5836,4046,8852,10069,6873.674035,6302,9679,45993,3421,-14839,3745,5805,54321,49414,31154,49738,51798
27147,MN,8868,10125,6849,9589,5836,4046,8823,10093,7217.357737,6302,9728,46255,3421,-14839,3745,5805,54136,49676,31416,50000,52060
27149,MN,7644,10125,6849,9589,5836,4046,8596,10125,6824.576363,6302,9589,44531,3050,-15210,3316,5434,52685,47581,29321,47847,49965
27151,MN,7644,10125,6849,9589,5836,4046,8596,10125,6824.576363,6302,9589,44531,3050,-15210,3316,5434,52685,47581,29321,47847,49965
27153,MN,8580,10125,6849,9589,5836,4046,8770,10125,6849.125199,6302,9589,45491,3421,-14839,3745,5805,53795,48912,30652,49236,51296
27155,MN,7644,10125,6849,9589,5836,4046,8596,10125,6873.674035,6302,9589,44580,3050,-15210,3316,5434,52685,47630,29370,47896,50014
27157,MN,7644,10125,6849,9589,5836,4046,8596,9880,7217.357737,6302,10198,45287,3050,-15210,3316,5434,52685,48337,30077,48603,50721
27159,MN,7644,10125,6849,9589,5836,4046,8596,10125,6628.185677,6302,9589,44334,3050,-15210,3316,5434,52685,47384,29124,47650,49768
27161,MN,7740,10125,6849,9589,5836,4046,8614,10125,6750.929856,6302,9589,44553,3050,-15210,3316,5434,52799,47603,29343,47869,49987
27163,MN,11352,10125,6849,9589,5836,4046,9284,12466,7143.711229,6302,10291,51601,4906,-13354,5890,7290,57081,56507,38247,57491,58891
27165,MN,7644,10125,6849,9589,5836,4046,8596,10125,6701.832184,6302,9589,44408,3050,-15210,3316,5434,52685,47458,29198,47724,49842
27167,MN,7644,10125,6849,9589,5836,4046,8596,8387,6922.771707,6302,9408,42710,2055,-16204,2482,4440,52685,44765,26506,45192,47150
27169,MN,7692,10125,6849,9589,5836,4046,8605,9956,7561.041438,6302,9574,45131,3050,-15210,3316,5434,52742,48181,29921,48447,50565
27171,MN,11352,10125,6849,9589,5836,4046,9284,11167,7610.13911,6302,10282,50759,4609,-13651,5461,6993,57081,55368,37108,56220,57752
27173,MN,7644,10125,6849,9589,5836,4046,8596,10125,6922.771707,6302,9589,44629,3050,-15210,3316,5434,52685,47679,29419,47945,50063
28001,MS,7368,10432,6704,9859,6006,4284,6502,10051,6872.32634,7066,9859,45500,5871,-14760,3824,5884,51155,51371,30740,49324,51384
28003,MS,7368,10432,6704,9859,6006,4284,6502,10119,6944.413679,7066,9859,45641,5871,-14760,3824,5884,51155,51512,30881,49465,51525
28005,MS,7368,10432,6704,9859,6006,4284,6502,10426,7112.617471,7066,9859,46115,5871,-14760,3824,5884,51155,51986,31355,49939,51999
28007,MS,7368,10432,6704,9859,6006,4284,6502,10432,7424.995941,7066,9859,46434,5871,-14760,3824,5884,51155,52305,31674,50258,52318
28009,MS,7368,10432,6704,9859,6006,4284,6502,9844,6944.413679,7066,9859,45365,5871,-14760,3824,5884,51155,51236,30605,49189,51249
28011,MS,7464,10432,6704,9859,6006,4284,6517,10138,7088.588358,7066,9859,45899,5871,-14760,3824,5884,51266,51770,31139,49723,51783
28013,MS,7368,10432,6704,9859,6006,4284,6502,10432,7112.617471,7066,9859,46122,5871,-14760,3824,5884,51155,51993,31362,49946,52006
28015,MS,10656,10432,6704,9859,6006,4284,7012,10518,7064.559245,7066,9859,49447,6977,-13654,5458,6990,54953,56424,35793,54905,56437
28017,MS,7368,10432,6704,9859,6006,4284,6502,10432,6896.355453,7066,9859,45905,5871,-14760,3824,5884,51155,51776,31145,49729,51789
28019,MS,7368,10432,6704,9859,6006,4284,6502,10432,7184.70481,7066,9859,46194,5871,-14760,3824,5884,51155,52065,31434,50018,52078
28021,MS,7368,10432,6704,9859,6006,4284,6502,10355,6872.32634,7066,9859,45804,5871,-14760,3824,5884,51155,51675,31044,49628,51688
28023,MS,7368,10432,6704,9859,6006,4284,6502,10406,6800.239001,7066,9859,45783,5871,-14760,3824,5884,51155,51654,31023,49607,51667
28025,MS,7896,10432,6704,9859,6006,4284,6584,10432,6824.268114,7066,9859,46361,6148,-14483,4233,6161,51765,52509,31878,50594,52522
28027,MS,7680,10432,6704,9859,6006,4284,6550,10031,6896.355453,7066,9859,45817,5871,-14760,3824,5884,51515,51688,31057,49641,51701
28029,MS,9252,10432,6704,9859,6006,4284,6794,10530,6704.122548,7066,9859,47695,6424,-14207,4641,6437,53331,54119,33488,52336,54132
28031,MS,7368,10432,6704,9859,6006,4284,6502,10432,6800.239001,7066,9859,45809,5871,-14760,3824,5884,51155,51680,31049,49633,51693
28033,MS,9360,10432,6704,9859,6006,4284,6811,11385,6656.064322,7066,9859,48611,6701,-13930,5050,6714,53456,55312,34681,53661,55325
28035,MS,8616,10432,6704,9859,6006,4284,6695,11334,7088.588358,7066,9859,48247,6424,-14207,4641,6437,52596,54671,34040,52888,54684
28037,MS,7368,10432,6704,9859,6006,4284,6502,10432,6752.180775,7066,9859,45761,5871,-14760,3824,5884,51155,51632,31001,49585,51645
28039,MS,9816,10432,6704,9859,6006,4284,6882,10432,6824.268114,7066,9859,48281,6701,-13930,5050,6714,53983,54982,34351,53331,54995
28041,MS,7368,10432,6704,9859,6006,4284,6502,10432,7160.675697,7066,9859,46170,5871,-14760,3824,5884,51155,52041,31410,49994,52054
28043,MS,7368,10432,6704,9859,6006,4284,6502,9926,7160.675697,7066,9859,45664,5871,-14760,3824,5884,51155,51535,30904,49488,51548
28045,MS,9936,10432,6704,9859,6006,4284,6900,11613,7232.763036,7066,9859,49991,6977,-13654,5458,6990,54121,56968,36337,55449,56981
28047,MS,9936,10432,6704,9859,6006,4284,6900,12333,6968.442792,7066,9859,50446,7254,-13377,5867,7267,54121,57700,37069,56313,57713
28049,MS,9252,10432,6704,9859,6006,4284,6794,11020,6920.384566,7066,9859,48401,6701,-13930,5050,6714,53331,55102,34471,53451,55115
28051,MS,7368,10432,6704,9859,6006,4284,6502,10432,7617.228845,7066,9859,46626,5871,-14760,3824,5884,51155,52497,31866,50450,52510
28053,MS,7368,10432,6704,9859,6006,4284,6502,10432,6968.442792,7066,9859,45977,5871,-14760,3824,5884,51155,51848,31217,49801,51861
28055,MS,11640,10432,6704,9859,6006,4284,7165,10432,6920.384566,7066,9859,50201,6977,-13654,5458,6990,56090,57178,36547,55659,57191
28057,MS,7368,10432,6704,9859,6006,4284,6502,10076,6752.180775,7066,9859,45405,5871,-14760,3824,5884,51155,51276,30645,49229,51289
28059,MS,9816,10432,6704,9859,6006,4284,6882,11638,7376.937715,7066,9859,50040,6977,-13654,5458,6990,53983,57017,36386,55498,57030
28061,MS,7368,10432,6704,9859,6006,4284,6502,10222,6776.209888,7066,9859,45575,5871,-14760,3824,5884,51155,51446,30815,49399,51459
28063,MS,7368,10432,6704,9859,6006,4284,6502,10432,6896.355453,7066,9859,45905,5871,-14760,3824,5884,51155,51776,31145,49729,51789
28065,MS,7368,10432,6704,9859,6006,4284,6502,10432,6728.151662,7066,9859,45737,5871,-14760,3824,5884,51155,51608,30977,49561,51621
28067,MS,9852,10432,6704,9859,6006,4284,6887,10681,6752.180775,7066,9859,48494,6701,-13930,5050,6714,54024,55195,34564,53544,55208
28069,MS,7716,10432,6704,9859,6006,4284,6556,9215,6944.413679,7066,9859,45084,5521,-15110,3416,5534,51557,50605,29974,48500,50618
28071,MS,9792,10432,6704,9859,6006,4284,6878,12346,8073.781994,7066,9859,51420,7254,-13377,5867,7267,53955,58674,38043,57287,58687
28073,MS,8616,10432,6704,9859,6006,4284,6695,12246,6752.180775,7066,9859,48823,6701,-13930,5050,6714,52596,55524,34893,53873,55537
28075,MS,7368,10432,6704,9859,6006,4284,6502,11346,6800.239001,7066,9859,46724,6148,-14483,4233,6161,51155,52872,32241,50957,52885
28077,MS,8052,10432,6704,9859,6006,4284,6608,10432,6848.297227,7066,9859,46541,6148,-14483,4233,6161,51945,52689,32058,50774,52702
28079,MS,7440,10432,6704,9859,6006,4284,6513,10432,6583.976983,7066,9859,45665,5871,-14760,3824,5884,51238,51536,30905,49489,51549
28081,MS,7368,10432,6704,9859,6006,4284,6502,10867,6680.093435,7066,9859,46124,6148,-14483,4233,6161,51155,52272,31641,50357,52285
28083,MS,7368,10432,6704,9859,6006,4284,6502,9712,7208.733923,7066,9859,45498,5521,-15110,3416,5534,51155,51019,30388,48914,51032
28085,MS,7368,10432,6704,9859,6006,4284,6502,11374,6992.471905,7066,9859,46944,6148,-14483,4233,6161,51155,53092,32461,51177,53105
28087,MS,7944,10432,6704,9859,6006,4284,6591,10872,7136.646584,7066,9859,47161,6148,-14483,4233,6161,51820,53309,32678,51394,53322
28089,MS,9252,10432,6704,9859,6006,4284,6794,12681,7953.636428,7066,9859,51096,6977,-13654,5458,6990,53331,58073,37442,56554,58086
28091,MS,7368,10432,6704,9859,6006,4284,6502,10432,6800.239001,7066,9859,45809,5871,-14760,3824,5884,51155,51680,31049,49633,51693
28093,MS,7368,10432,6704,9859,6006,4284,6502,11530,6848.297227,7066,9859,46955,6148,-14483,4233,6161,51155,53103,32472,51188,53116
28095,MS,7512,10432,6704,9859,6006,4284,6524,10432,6656.064322,7066,9859,45809,5871,-14760,3824,5884,51321,51680,31049,49633,51693
28097,MS,7368,10432,6704,9859,6006,4284,6502,10432,7040.530132,7066,9859,46050,5871,-14760,3824,5884,51155,51921,31290,49874,51934
28099,MS,7368,10432,6704,9859,6006,4284,6502,10432,6800.239001,7066,9859,45809,5871,-14760,3824,5884,51155,51680,31049,49633,51693
28101,MS,7872,10432,6704,9859,6006,4284,6580,10432,6824.268114,7066,9859,46337,6148,-14483,4233,6161,51737,52485,31854,50570,52498
28103,MS,7368,10432,6704,9859,6006,4284,6502,10432,7088.588358,7066,9859,46098,5871,-14760,3824,5884,51155,51969,31338,49922,51982
28105,MS,8592,10432,6704,9859,6006,4284,6692,12377,7352.908602,7066,9859,49531,6701,-13930,5050,6714,52569,56232,35601,54581,56245
28107,MS,7536,10432,6704,9859,6006,4284,6528,10432,6992.471905,7066,9859,46169,5871,-14760,3824,5884,51349,52040,31409,49993,52053
28109,MS,8124,10432,6704,9859,6006,4284,6619,11139,6992.471905,7066,9859,47465,6424,-14207,4641,6437,52028,53889,33258,52106,53902
28111,MS,8616,10432,6704,9859,6006,4284,6695,11112,6800.239001,7066,9859,47737,6424,-14207,4641,6437,52596,54161,33530,52378,54174
28113,MS,7836,10432,6704,9859,6006,4284,6574,11043,6583.976983,7066,9859,46672,6148,-14483,4233,6161,51695,52820,32189,50905,52833
28115,MS,7368,10432,6704,9859,6006,4284,6502,10569,7088.588358,7066,9859,46234,5871,-14760,3824,5884,51155,52105,31474,50058,52118
28117,MS,7368,10432,6704,9859,6006,4284,6502,10432,6680.093435,7066,9859,45689,5871,-14760,3824,5884,51155,51560,30929,49513,51573
28119,MS,7368,10432,6704,9859,6006,4284,6502,10432,6824.268114,7066,9859,45833,5871,-14760,3824,5884,51155,51704,31073,49657,51717
28121,MS,9252,10432,6704,9859,6006,4284,6794,11932,6968.442792,7066,9859,49361,6977,-13654,5458,6990,53331,56338,35707,54819,56351
28123,MS,7944,10432,6704,9859,6006,4284,6591,10432,6728.151662,7066,9859,46313,6148,-14483,4233,6161,51820,52461,31830,50546,52474
28125,MS,7368,10432,6704,9859,6006,4284,6502,10432,6920.384566,7066,9859,45929,5871,-14760,3824,5884,51155,51800,31169,49753,51813
28127,MS,7368,10432,6704,9859,6006,4284,6502,10928,6872.32634,7066,9859,46377,6148,-14483,4233,6161,51155,52525,31894,50610,52538
28129,MS,8412,10432,6704,9859,6006,4284,6664,10432,6896.355453,7066,9859,46949,6148,-14483,4233,6161,52361,53097,32466,51182,53110
28131,MS,9936,10432,6704,9859,6006,4284,6900,10432,7232.763036,7066,9859,48810,6701,-13930,5050,6714,54121,55511,34880,53860,55524
28133,MS,7368,10432,6704,9859,6006,4284,6502,9061,7184.70481,7066,9859,44823,5521,-15110,3416,5534,51155,50344,29713,48239,50357
28135,MS,7368,10432,6704,9859,6006,4284,6502,10432,7064.559245,7066,9859,46074,5871,-14760,3824,5884,51155,51945,31314,49898,51958
28137,MS,8520,10432,6704,9859,6006,4284,6680,11644,6583.976983,7066,9859,47957,6701,-13930,5050,6714,52485,54658,34027,53007,54671
28139,MS,7368,10432,6704,9859,6006,4284,6502,10432,7136.646584,7066,9859,46146,5871,-14760,3824,5884,51155,52017,31386,49970,52030
28141,MS,7368,10432,6704,9859,6006,4284,6502,10432,6632.035209,7066,9859,45641,5871,-14760,3824,5884,51155,51512,30881,49465,51525
28143,MS,8328,10432,6704,9859,6006,4284,6651,11565,6704.122548,7066,9859,47806,6424,-14207,4641,6437,52264,54230,33599,52447,54243
28145,MS,7368,10432,6704,9859,6006,4284,6502,10432,6776.209888,7066,9859,45785,5871,-14760,3824,5884,51155,51656,31025,49609,51669
28147,MS,9192,10432,6704,9859,6006,4284,6785,10432,6872.32634,7066,9859,47705,6424,-14207,4641,6437,53262,54129,33498,52346,54142
28149,MS,8196,10432,6704,9859,6006,4284,6630,11234,6992.471905,7066,9859,47632,6424,-14207,4641,6437,52111,54056,33425,52273,54069
28151,MS,7392,10432,6704,9859,6006,4284,6505,10122,6824.268114,7066,9859,45548,5871,-14760,3824,5884,51182,51419,30788,49372,51432
28153,MS,7368,10432,6704,9859,6006,4284,6502,10432,7136.646584,7066,9859,46146,5871,-14760,3824,5884,51155,52017,31386,49970,52030
28155,MS,7368,10432,6704,9859,6006,4284,6502,10432,7184.70481,7066,9859,46194,5871,-14760,3824,5884,51155,52065,31434,50018,52078
28157,MS,7440,10432,6704,9859,6006,4284,6513,10432,7088.588358,7066,9859,46170,5871,-14760,3824,5884,51238,52041,31410,49994,52054
28159,MS,7368,10432,6704,9859,6006,4284,6502,10432,7040.530132,7066,9859,46050,5871,-14760,3824,5884,51155,51921,31290,49874,51934
28161,MS,7368,10432,6704,9859,6006,4284,6502,10432,7400.966828,7066,9859,46410,5871,-14760,3824,5884,51155,52281,31650,50234,52294
28163,MS,8028,10432,6704,9859,6006,4284,6604,11061,7449.025054,7066,9859,47747,6424,-14207,4641,6437,51917,54171,33540,52388,54184
29001,MO,7152,15443,6849,9589,6087,4046,5659,14808,5965.367109,7478,8369,47818,5494,-13946,5034,6698,54825,53312,33872,52852,54516
29003,MO,8940,15443,6849,9589,6087,4046,5900,15555,6235.404303,7478,9358,51613,6676,-12764,6744,7880,56854,58289,38849,58357,59493
29005,MO,7152,15443,6849,9589,6087,4046,5659,15443,6701.832184,7478,9589,50410,6085,-13355,5889,7289,54825,56495,37055,56299,57699
29007,MO,7884,15443,6849,9589,6087,4046,5758,13922,5768.976422,7478,9137,48236,5789,-13651,5461,6993,55656,54025,34585,53697,55229
29009,MO,7152,15443,6849,9589,6087,4046,5659,15443,6652.734512,7478,9589,50361,6085,-13355,5889,7289,54825,56446,37006,56250,57650
29011,MO,7152,15443,6849,9589,6087,4046,5659,15443,6161.757796,7478,9589,49870,6085,-13355,5889,7289,54825,55955,36515,55759,57159
29013,MO,7752,15443,6849,9589,6087,4046,5740,14833,6505.441497,7478,9681,50295,6085,-13355,5889,7289,55506,56380,36940,56184,57584
29015,MO,7260,15443,6849,9589,6087,4046,5673,15443,6284.501975,7478,9589,50101,6085,-13355,5889,7289,54947,56186,36746,55990,57390
29017,MO,8148,15443,6849,9589,6087,4046,5793,14095,6554.539169,7478,9263,49585,5789,-13651,5461,6993,55955,55374,35934,55046,56578
29019,MO,8292,15443,6849,9589,6087,4046,5813,17517,7094.613557,7478,9453,53881,6676,-12764,6744,7880,56119,60557,41117,60625,61761
29021,MO,8940,15443,6849,9589,6087,4046,5900,15427,6063.562452,7478,9338,51293,6676,-12764,6744,7880,56854,57969,38529,58037,59173
29023,MO,7260,15443,6849,9589,6087,4046,5673,14263,5940.818273,7478,8477,47465,5494,-13946,5034,6698,54947,52959,33519,52499,54163
29025,MO,10224,15443,6849,9589,6087,4046,6074,14743,6800.027527,7478,9679,52970,6676,-12764,6744,7880,58312,59646,40206,59714,60850
29027,MO,7416,15443,6849,9589,6087,4046,5694,15314,6922.771707,7478,9453,50630,6085,-13355,5889,7289,55124,56715,37275,56519,57919
29029,MO,7500,15443,6849,9589,6087,4046,5706,15443,7241.906572,7478,9589,51298,6085,-13355,5889,7289,55220,57383,37943,57187,58587
29031,MO,8148,15443,6849,9589,6087,4046,5793,15573,6382.697318,7478,9218,50845,6085,-13355,5889,7289,55955,56930,37490,56734,58134
29033,MO,7152,15443,6849,9589,6087,4046,5659,15443,6161.757796,7478,9589,49870,6085,-13355,5889,7289,54825,55955,36515,55759,57159
29035,MO,7152,15443,6849,9589,6087,4046,5659,15443,5965.367109,7478,9589,49673,6085,-13355,5889,7289,54825,55758,36318,55562,56962
29037,MO,10224,15443,6849,9589,6087,4046,6074,17316,6603.636841,7478,9685,55353,7267,-12173,7599,8471,58312,62620,43180,62952,63824
29039,MO,7152,15443,6849,9589,6087,4046,5659,15443,6186.306631,7478,9589,49894,6085,-13355,5889,7289,54825,55979,36539,55783,57183
29041,MO,7152,15443,6849,9589,6087,4046,5659,15443,6039.013616,7478,9589,49747,6085,-13355,5889,7289,54825,55832,36392,55636,57036
29043,MO,7800,15443,6849,9589,6087,4046,5746,15763,7070.064722,7478,9126,51284,6085,-13355,5889,7289,55560,57369,37929,57173,58573
29045,MO,7152,15443,6849,9589,6087,4046,5659,13679,5768.976422,7478,9099,47223,5494,-13946,5034,6698,54825,52717,33277,52257,53921
29047,MO,10224,15443,6849,9589,6087,4046,6074,17615,6701.832184,7478,9683,55747,7267,-12173,7599,8471,58312,63014,43574,63346,64218
29049,MO,10224,15443,6849,9589,6087,4046,6074,15939,7192.808901,7478,9682,54562,7267,-12173,7599,8471,58312,61829,42389,62161,63033
29051,MO,7668,15443,6849,9589,6087,4046,5728,15876,6579.088005,7478,9444,51091,6085,-13355,5889,7289,55410,57176,37736,56980,58380
29053,MO,7152,15443,6849,9589,6087,4046,5659,15443,6554.539169,7478,9589,50263,6085,-13355,5889,7289,54825,56348,36908,56152,57552
29055,MO,7152,15443,6849,9589,6087,4046,5659,15443,7168.260065,7478,9589,50876,6085,-13355,5889,7289,54825,56961,37521,56765,58165
29056,MO,9768,15443,6849,9589,6087,4046,6012,15443,6849,7478,9589,53173,6676,-12764,6744,7880,57794,59849,40409,59917,61053
29057,MO,7152,15443,6849,9589,6087,4046,5659,15443,6456.343826,7478,9589,50164,6085,-13355,5889,7289,54825,56249,36809,56053,57453
29059,MO,7152,15443,6849,9589,6087,4046,5659,14040,6529.990333,7478,9144,48390,5494,-13946,5034,6698,54825,53884,34444,53424,55088
29061,MO,7152,15443,6849,9589,6087,4046,5659,15443,6677.283348,7478,9589,50385,6085,-13355,5889,7289,54825,56470,37030,56274,57674
29063,MO,8940,15443,6849,9589,6087,4046,5900,15485,6161.757796,7478,9339,51450,6676,-12764,6744,7880,56854,58126,38686,58194,59330
29065,MO,7152,15443,6849,9589,6087,4046,5659,15443,6407.246154,7478,9589,50115,6085,-13355,5889,7289,54825,56200,36760,56004,57404
29067,MO,7152,15443,6849,9589,6087,4046,5659,15443,6603.636841,7478,9589,50312,6085,-13355,5889,7289,54825,56397,36957,56201,57601
29069,MO,7152,15443,6849,9589,6087,4046,5659,13097,5670.781079,7478,8169,45613,4903,-14537,4179,6107,54825,50516,31076,49792,51720
29071,MO,9768,15443,6849,9589,6087,4046,6012,16170,6088.111288,7478,9537,53087,6676,-12764,6744,7880,57794,59763,40323,59831,60967
29073,MO,7152,15443,6849,9589,6087,4046,5659,15443,6210.855467,7478,9589,49919,6085,-13355,5889,7289,54825,56004,36564,55808,57208
29075,MO,7152,15443,6849,9589,6087,4046,5659,15443,6210.855467,7478,9589,49919,6085,-13355,5889,7289,54825,56004,36564,55808,57208
29077,MO,7800,15443,6849,9589,6087,4046,5746,15269,6603.636841,7478,9102,50299,6085,-13355,5889,7289,55560,56384,36944,56188,57588
29079,MO,7152,15443,6849,9589,6087,4046,5659,15443,6628.185677,7478,9589,50336,6085,-13355,5889,7289,54825,56421,36981,56225,57625
29081,MO,7200,15443,6849,9589,6087,4046,5665,15443,6677.283348,7478,9589,50433,6085,-13355,5889,7289,54879,56518,37078,56322,57722
29083,MO,7596,15443,6849,9589,6087,4046,5719,15443,5646.232243,7478,9589,49798,6085,-13355,5889,7289,55329,55883,36443,55687,57087
29085,MO,7152,15443,6849,9589,6087,4046,5659,15443,6112.660124,7478,9589,49821,6085,-13355,5889,7289,54825,55906,36466,55710,57110
29087,MO,7152,15443,6849,9589,6087,4046,5659,15443,6333.599646,7478,9589,50042,6085,-13355,5889,7289,54825,56127,36687,55931,57331
29089,MO,8292,15443,6849,9589,6087,4046,5813,15443,6775.478692,7478,9589,51623,6085,-13355,5889,7289,56119,57708,38268,57512,58912
29091,MO,7152,15443,6849,9589,6087,4046,5659,14401,5867.171766,7478,8408,47352,5494,-13946,5034,6698,54825,52846,33406,52386,54050
29093,MO,7152,15443,6849,9589,6087,4046,5659,15443,6407.246154,7478,9589,50115,6085,-13355,5889,7289,54825,56200,36760,56004,57404
29095,MO,10224,15443,6849,9589,6087,4046,6074,17038,6456.343826,7478,9687,54929,7267,-12173,7599,8471,58312,62196,42756,62528,63400
29097,MO,7404,15443,6849,9589,6087,4046,5693,14437,6112.660124,7478,9185,48662,5789,-13651,5461,6993,55111,54451,35011,54123,55655
29099,MO,9768,15443,6849,9589,6087,4046,6012,16709,6800.027527,7478,9535,54336,7267,-12173,7599,8471,57794,61603,42163,61935,62807
29101,MO,8088,15443,6849,9589,6087,4046,5785,16649,6186.306631,7478,9375,51822,6676,-12764,6744,7880,55887,58498,39058,58566,59702
29103,MO,7152,15443,6849,9589,6087,4046,5659,15443,6039.013616,7478,9589,49747,6085,-13355,5889,7289,54825,55832,36392,55636,57036
29105,MO,7152,15443,6849,9589,6087,4046,5659,15239,5719.87875,7478,8722,48357,5789,-13651,5461,6993,54825,54146,34706,53818,55350
29107,MO,10224,15443,6849,9589,6087,4046,6074,15179,7413.748423,7478,9683,54024,6676,-12764,6744,7880,58312,60700,41260,60768,61904
29109,MO,7152,15443,6849,9589,6087,4046,5659,15443,6701.832184,7478,9589,50410,6085,-13355,5889,7289,54825,56495,37055,56299,57699
29111,MO,7152,15443,6849,9589,6087,4046,5659,14271,6039.013616,7478,9266,48253,5789,-13651,5461,6993,54825,54042,34602,53714,55246
29113,MO,9768,15443,6849,9589,6087,4046,6012,16483,6112.660124,7478,9538,53426,7267,-12173,7599,8471,57794,60693,41253,61025,61897
29115,MO,7152,15443,6849,9589,6087,4046,5659,15443,6112.660124,7478,9589,49821,6085,-13355,5889,7289,54825,55906,36466,55710,57110
29117,MO,7704,15443,6849,9589,6087,4046,5733,15443,6652.734512,7478,9589,50913,6085,-13355,5889,7289,55451,56998,37558,56802,58202
29119,MO,7152,15443,6849,9589,6087,4046,5659,14931,7094.613557,7478,9489,50190,5789,-13651,5461,6993,54825,55979,36539,55651,57183
29121,MO,7152,15443,6849,9589,6087,4046,5659,15443,5989.915945,7478,9589,49698,6085,-13355,5889,7289,54825,55783,36343,55587,56987
29123,MO,7500,15443,6849,9589,6087,4046,5706,15443,6480.892661,7478,9589,50537,6085,-13355,5889,7289,55220,56622,37182,56426,57826
29125,MO,7152,15443,6849,9589,6087,4046,5659,15443,6529.990333,7478,9589,50238,6085,-13355,5889,7289,54825,56323,36883,56127,57527
29127,MO,7440,15443,6849,9589,6087,4046,5698,14324,5842.62293,7478,9141,48271,5789,-13651,5461,6993,55152,54060,34620,53732,55264
29129,MO,7152,15443,6849,9589,6087,4046,5659,15443,6039.013616,7478,9589,49747,6085,-13355,5889,7289,54825,55832,36392,55636,57036
29131,MO,7320,15443,6849,9589,6087,4046,5681,15443,7315.55308,7478,9589,51192,6085,-13355,5889,7289,55015,57277,37837,57081,58481
29133,MO,7152,15443,6849,9589,6087,4046,5659,15443,6112.660124,7478,9589,49821,6085,-13355,5889,7289,54825,55906,36466,55710,57110
29135,MO,7848,15443,6849,9589,6087,4046,5753,14499,6873.674035,7478,9458,50203,6085,-13355,5889,7289,55615,56288,36848,56092,57492
29137,MO,7152,15443,6849,9589,6087,4046,5659,15443,5793.525258,7478,9589,49502,6085,-13355,5889,7289,54825,55587,36147,55391,56791
29139,MO,7524,15443,6849,9589,6087,4046,5709,15443,6063.562452,7478,9589,50144,6085,-13355,5889,7289,55247,56229,36789,56033,57433
29141,MO,7416,15443,6849,9589,6087,4046,5694,15443,6824.576363,7478,9589,50797,6085,-13355,5889,7289,55124,56882,37442,56686,58086
29143,MO,7152,15443,6849,9589,6087,4046,5659,15443,6210.855467,7478,9589,49919,6085,-13355,5889,7289,54825,56004,36564,55808,57208
29145,MO,7404,15443,6849,9589,6087,4046,5693,14733,6014.464781,7478,9208,48883,5789,-13651,5461,6993,55111,54672,35232,54344,55876
29147,MO,7152,15443,6849,9589,6087,4046,5659,15051,6873.674035,7478,8700,49301,5789,-13651,5461,6993,54825,55090,35650,54762,56294
29149,MO,7152,15443,6849,9589,6087,4046,5659,15443,6112.660124,7478,9589,49821,6085,-13355,5889,7289,54825,55906,36466,55710,57110
29151,MO,7668,15443,6849,9589,6087,4046,5728,13995,6824.576363,7478,9463,49474,5789,-13651,5461,6993,55410,55263,35823,54935,56467
29153,MO,7152,15443,6849,9589,6087,4046,5659,15443,6652.734512,7478,9589,50361,6085,-13355,5889,7289,54825,56446,37006,56250,57650
29155,MO,7152,15443,6849,9589,6087,4046,5659,15443,6137.20896,7478,9589,49845,6085,-13355,5889,7289,54825,55930,36490,55734,57134
29157,MO,7284,15443,6849,9589,6087,4046,5676,15443,6431.79499,7478,9589,50272,6085,-13355,5889,7289,54974,56357,36917,56161,57561
29159,MO,7944,15443,6849,9589,6087,4046,5766,14399,5916.269437,7478,8795,48578,5789,-13651,5461,6993,55724,54367,34927,54039,55571
29161,MO,7608,15443,6849,9589,6087,4046,5720,15713,6088.111288,7478,9030,49963,6085,-13355,5889,7289,55342,56048,36608,55852,57252
29163,MO,7152,15443,6849,9589,6087,4046,5659,15443,6063.562452,7478,9589,49772,6085,-13355,5889,7289,54825,55857,36417,55661,57061
29165,MO,10224,15443,6849,9589,6087,4046,6074,19310,8125.664663,7478,9681,58865,7858,-11254,8454,9062,58312,66723,47611,67319,67927
29167,MO,7152,15443,6849,9589,6087,4046,5659,14065,5793.525258,7478,9134,47669,5494,-13946,5034,6698,54825,53163,33723,52703,54367
29169,MO,8880,15443,6849,9589,6087,4046,5892,17193,6701.832184,7478,9342,53641,6676,-12764,6744,7880,56786,60317,40877,60385,61521
29171,MO,7656,15443,6849,9589,6087,4046,5727,15443,5818.074094,7478,9589,50030,6085,-13355,5889,7289,55397,56115,36675,55919,57319
29173,MO,7152,15443,6849,9589,6087,4046,5659,14316,6088.111288,7478,9182,48263,5789,-13651,5461,6993,54825,54052,34612,53724,55256
29175,MO,7536,15443,6849,9589,6087,4046,5711,14401,5744.427586,7478,8590,47796,5494,-13946,5034,6698,55261,53290,33850,52830,54494
29177,MO,10224,15443,6849,9589,6087,4046,6074,15232,6775.478692,7478,9680,53435,6676,-12764,6744,7880,58312,60111,40671,60179,61315
29179,MO,7152,15443,6849,9589,6087,4046,5659,15443,6603.636841,7478,9589,50312,6085,-13355,5889,7289,54825,56397,36957,56201,57601
29181,MO,7152,15443,6849,9589,6087,4046,5659,15443,6112.660124,7478,9589,49821,6085,-13355,5889,7289,54825,55906,36466,55710,57110
29183,MO,9768,15443,6849,9589,6087,4046,6012,18678,6898.222871,7478,9530,56399,7858,-11254,8454,9062,57794,64257,45145,64853,65461
29185,MO,7152,15443,6849,9589,6087,4046,5659,15443,5965.367109,7478,9589,49673,6085,-13355,5889,7289,54825,55758,36318,55562,56962
29186,MO,7236,15443,6849,9589,6087,4046,5670,15443,6677.283348,7478,9589,50469,6085,-13355,5889,7289,54920,56554,37114,56358,57758
29187,MO,7896,15443,6849,9589,6087,4046,5759,15016,6309.050811,7478,8287,49032,5789,-13651,5461,6993,55669,54821,35381,54493,56025
29189,MO,9768,15443,6849,9589,6087,4046,6012,18721,7020.96705,7478,9524,56558,7858,-11254,8454,9062,57794,64416,45304,65012,65620
29195,MO,7152,15443,6849,9589,6087,4046,5659,13757,5621.683407,7478,8758,46813,5494,-13946,5034,6698,54825,52307,32867,51847,53511
29197,MO,7152,15443,6849,9589,6087,4046,5659,13120,5916.269437,7478,8480,46192,5198,-14242,4606,6402,54825,51390,31950,50798,52594
29199,MO,7152,15443,6849,9589,6087,4046,5659,15443,6333.599646,7478,9589,50042,6085,-13355,5889,7289,54825,56127,36687,55931,57331
29201,MO,7392,15443,6849,9589,6087,4046,5691,14133,7241.906572,7478,9177,49468,5789,-13651,5461,6993,55097,55257,35817,54929,56461
29203,MO,7152,15443,6849,9589,6087,4046,5659,15443,6063.562452,7478,9589,49772,6085,-13355,5889,7289,54825,55857,36417,55661,57061
29205,MO,7152,15443,6849,9589,6087,4046,5659,15443,5842.62293,7478,9589,49551,6085,-13355,5889,7289,54825,55636,36196,55440,56840
29207,MO,7152,15443,6849,9589,6087,4046,5659,15443,6971.869378,7478,9589,50680,6085,-13355,5889,7289,54825,56765,37325,56569,57969
29209,MO,7980,15443,6849,9589,6087,4046,5771,15723,6947.320542,7478,8577,50752,6085,-13355,5889,7289,55765,56837,37397,56641,58041
29211,MO,7536,15443,6849,9589,6087,4046,5711,15443,6309.050811,7478,9589,50401,6085,-13355,5889,7289,55261,56486,37046,56290,57690
29213,MO,7920,15443,6849,9589,6087,4046,5762,16920,7217.357737,7478,8540,52121,6085,-13355,5889,7289,55696,58206,38766,58010,59410
29215,MO,7152,15443,6849,9589,6087,4046,5659,15443,6775.478692,7478,9589,50483,6085,-13355,5889,7289,54825,56568,37128,56372,57772
29217,MO,7500,15443,6849,9589,6087,4046,5706,15443,6775.478692,7478,9589,50831,6085,-13355,5889,7289,55220,56916,37476,56720,58120
29219,MO,9768,15443,6849,9589,6087,4046,6012,16551,5867.171766,7478,9539,53249,7267,-12173,7599,8471,57794,60516,41076,60848,61720
29221,MO,7152,15443,6849,9589,6087,4046,5659,15443,6922.771707,7478,9589,50631,6085,-13355,5889,7289,54825,56716,37276,56520,57920
29223,MO,7152,15443,6849,9589,6087,4046,5659,15443,6235.404303,7478,9589,49943,6085,-13355,5889,7289,54825,56028,36588,55832,57232
29225,MO,7800,15443,6849,9589,6087,4046,5746,14289,6701.832184,7478,9126,49441,5789,-13651,5461,6993,55560,55230,35790,54902,56434
29227,MO,7152,15443,6849,9589,6087,4046,5659,15443,6726.38102,7478,9589,50434,6085,-13355,5889,7289,54825,56519,37079,56323,57723
29229,MO,7152,15443,6849,9589,6087,4046,5659,15443,6161.757796,7478,9589,49870,6085,-13355,5889,7289,54825,55955,36515,55759,57159
29510,MO,9768,15443,6849,9589,6087,4046,6012,18247,6726.38102,7478,9512,55777,7267,-12173,7599,8471,57794,63044,43604,63376,64248
30001,MT,7644,6597,8002,8509,5105,4344,6403,6597,8260.280027,8057,8509,43411,2632,-15615,2990,5029,46604,46043,27796,46401,48440
30003,MT,7644,6597,8002,8509,5105,4344,6403,6597,8030.827804,8057,8509,43182,2632,-15615,2990,5029,46604,45814,27567,46172,48211
30005,MT,7644,6597,8002,8509,5105,4344,6403,6597,8346.32461,8057,8509,43497,2632,-15615,2990,5029,46604,46129,27882,46487,48526
30007,MT,7872,6597,8002,8509,5105,4344,6434,6597,8202.916971,8057,8509,43582,2632,-15615,2990,5029,46863,46214,27967,46572,48611
30009,MT,8388,6597,8002,8509,5105,4344,6504,6900,8002.146276,8057,8422,44113,3139,-15108,3418,5536,47449,47252,29005,47531,49649
30011,MT,7644,6597,8002,8509,5105,4344,6403,6597,8346.32461,8057,8509,43497,2632,-15615,2990,5029,46604,46129,27882,46487,48526
30013,MT,7644,6597,8002,8509,5105,4344,6403,7422,7744.012525,8057,8153,43364,2632,-15615,2990,5029,46604,45996,27749,46354,48393
30015,MT,7644,6597,8002,8509,5105,4344,6403,6597,7858.738636,8057,8509,43010,2632,-15615,2990,5029,46604,45642,27395,46000,48039
30017,MT,7644,6597,8002,8509,5105,4344,6403,6597,8088.190859,8057,8509,43239,2632,-15615,2990,5029,46604,45871,27624,46229,48268
30019,MT,7644,6597,8002,8509,5105,4344,6403,6597,9092.044335,8057,8509,44243,2632,-15615,2990,5029,46604,46875,28628,47233,49272
30021,MT,7644,6597,8002,8509,5105,4344,6403,6597,8776.547528,8057,8509,43928,2632,-15615,2990,5029,46604,46560,28313,46918,48957
30023,MT,7644,6597,8002,8509,5105,4344,6403,6597,8346.32461,8057,8509,43497,2632,-15615,2990,5029,46604,46129,27882,46487,48526
30025,MT,7644,6597,8002,8509,5105,4344,6403,6597,8575.776833,8057,8509,43727,2632,-15615,2990,5029,46604,46359,28112,46717,48756
30027,MT,7644,6597,8002,8509,5105,4344,6403,6597,8088.190859,8057,8509,43239,2632,-15615,2990,5029,46604,45871,27624,46229,48268
30029,MT,8832,6597,8002,8509,5105,4344,6564,7948,7887.420164,8057,8166,45234,3508,-14739,3845,5905,47953,48742,30495,49079,51139
30031,MT,8964,6597,8002,8509,5105,4344,6581,9351,8174.235443,8057,8433,47323,4099,-14148,4700,6496,48102,51422,33175,52023,53819
30033,MT,7644,6597,8002,8509,5105,4344,6403,6597,8002.146276,8057,8509,43153,2632,-15615,2990,5029,46604,45785,27538,46143,48182
30035,MT,7644,6597,8002,8509,5105,4344,6403,6597,8030.827804,8057,8509,43182,2632,-15615,2990,5029,46604,45814,27567,46172,48211
30037,MT,7704,6597,8002,8509,5105,4344,6411,6252,7973.464748,8057,8430,42761,2124,-16123,2563,4521,46672,44885,26638,45324,47282
30039,MT,7680,6597,8002,8509,5105,4344,6408,6597,8346.32461,8057,8509,43533,2632,-15615,2990,5029,46645,46165,27918,46523,48562
30041,MT,7644,6597,8002,8509,5105,4344,6403,6597,8231.598499,8057,8509,43383,2632,-15615,2990,5029,46604,46015,27768,46373,48412
30043,MT,8844,6597,8002,8509,5105,4344,6565,7311,8202.916971,8057,8469,45228,3508,-14739,3845,5905,47966,48736,30489,49073,51133
30045,MT,7644,6597,8002,8509,5105,4344,6403,6597,7973.464748,8057,8509,43124,2632,-15615,2990,5029,46604,45756,27509,46114,48153
30047,MT,7644,6597,8002,8509,5105,4344,6403,6597,9292.81503,8057,8509,44444,2632,-15615,2990,5029,46604,47076,28829,47434,49473
30049,MT,8388,6597,8002,8509,5105,4344,6504,8135,8116.872387,8057,8460,45501,3508,-14739,3845,5905,47449,49009,30762,49346,51406
30051,MT,7644,6597,8002,8509,5105,4344,6403,6597,7830.057109,8057,8509,42981,2632,-15615,2990,5029,46604,45613,27366,45971,48010
30053,MT,7644,6597,8002,8509,5105,4344,6403,6597,8002.146276,8057,8509,43153,2632,-15615,2990,5029,46604,45785,27538,46143,48182
30055,MT,7644,6597,8002,8509,5105,4344,6403,6597,8747.866,8057,8509,43899,2632,-15615,2990,5029,46604,46531,28284,46889,48928
30057,MT,8364,6597,8002,8509,5105,4344,6500,6597,8288.961554,8057,8509,44160,2632,-15615,2990,5029,47421,46792,28545,47150,49189
30059,MT,7644,6597,8002,8509,5105,4344,6403,6597,8145.553915,8057,8509,43297,2632,-15615,2990,5029,46604,45929,27682,46287,48326
30061,MT,7644,6597,8002,8509,5105,4344,6403,6597,8059.509332,8057,8509,43211,2632,-15615,2990,5029,46604,45843,27596,46201,48240
30063,MT,10140,6597,8002,8509,5105,4344,6740,8525,8288.961554,8057,8253,47608,4099,-14148,4700,6496,49437,51707,33460,52308,54104
30065,MT,7644,6597,8002,8509,5105,4344,6403,6597,7916.101692,8057,8509,43067,2632,-15615,2990,5029,46604,45699,27452,46057,48096
30067,MT,8988,6597,8002,8509,5105,4344,6585,6597,8059.509332,8057,8509,44555,3139,-15108,3418,5536,48130,47694,29447,47973,50091
30069,MT,7644,6597,8002,8509,5105,4344,6403,6597,7916.101692,8057,8509,43067,2632,-15615,2990,5029,46604,45699,27452,46057,48096
30071,MT,7644,6597,8002,8509,5105,4344,6403,6597,8403.687666,8057,8509,43555,2632,-15615,2990,5029,46604,46187,27940,46545,48584
30073,MT,7644,6597,8002,8509,5105,4344,6403,6597,7830.057109,8057,8509,42981,2632,-15615,2990,5029,46604,45613,27366,45971,48010
30075,MT,7644,6597,8002,8509,5105,4344,6403,6597,8432.369194,8057,8509,43583,2632,-15615,2990,5029,46604,46215,27968,46573,48612
30077,MT,7644,6597,8002,8509,5105,4344,6403,6597,8174.235443,8057,8509,43325,2632,-15615,2990,5029,46604,45957,27710,46315,48354
30079,MT,7644,6597,8002,8509,5105,4344,6403,6597,8747.866,8057,8509,43899,2632,-15615,2990,5029,46604,46531,28284,46889,48928
30081,MT,8244,6597,8002,8509,5105,4344,6484,6597,9751.719476,8057,8509,45503,2632,-15615,2990,5029,47285,48135,29888,48493,50532
30083,MT,7644,6597,8002,8509,5105,4344,6403,6597,9149.407391,8057,8509,44300,2632,-15615,2990,5029,46604,46932,28685,47290,49329
30085,MT,7644,6597,8002,8509,5105,4344,6403,6597,9407.541141,8057,8509,44559,2632,-15615,2990,5029,46604,47191,28944,47549,49588
30087,MT,7644,6597,8002,8509,5105,4344,6403,6597,8030.827804,8057,8509,43182,2632,-15615,2990,5029,46604,45814,27567,46172,48211
30089,MT,7644,6597,8002,8509,5105,4344,6403,6597,8059.509332,8057,8509,43211,2632,-15615,2990,5029,46604,45843,27596,46201,48240
30091,MT,7644,6597,8002,8509,5105,4344,6403,6597,9436.222669,8057,8509,44587,2632,-15615,2990,5029,46604,47219,28972,47577,49616
30093,MT,7644,6597,8002,8509,5105,4344,6403,6106,8690.502945,8057,7550,42391,1617,-16410,2135,4014,46604,44008,25981,44526,46405
30095,MT,7644,6597,8002,8509,5105,4344,6403,6597,8002.146276,8057,8509,43153,2632,-15615,2990,5029,46604,45785,27538,46143,48182
30097,MT,7704,6597,8002,8509,5105,4344,6411,6597,8030.827804,8057,8509,43242,2632,-15615,2990,5029,46672,45874,27627,46232,48271
30099,MT,7644,6597,8002,8509,5105,4344,6403,6597,8088.190859,8057,8509,43239,2632,-15615,2990,5029,46604,45871,27624,46229,48268
30101,MT,7644,6597,8002,8509,5105,4344,6403,6597,7830.057109,8057,8509,42981,2632,-15615,2990,5029,46604,45613,27366,45971,48010
30103,MT,7644,6597,8002,8509,5105,4344,6403,6597,7916.101692,8057,8509,43067,2632,-15615,2990,5029,46604,45699,27452,46057,48096
30105,MT,7644,6597,8002,8509,5105,4344,6403,6597,9092.044335,8057,8509,44243,2632,-15615,2990,5029,46604,46875,28628,47233,49272
30107,MT,7644,6597,8002,8509,5105,4344,6403,6597,8030.827804,8057,8509,43182,2632,-15615,2990,5029,46604,45814,27567,46172,48211
30109,MT,7644,6597,8002,8509,5105,4344,6403,6597,9178.088918,8057,8509,44329,2632,-15615,2990,5029,46604,46961,28714,47319,49358
30111,MT,8388,6597,8002,8509,5105,4344,6504,7918,7887.420164,8057,8410,45004,3508,-14739,3845,5905,47449,48512,30265,48849,50909
31001,NE,7044,5011,6849,9589,6108,4046,6800,4370,6505.441497,8066,9366,39397,-2797,-22339,-4436,-2716,45447,36600,17058,34961,36681
31003,NE,7044,5011,6849,9589,6108,4046,6800,5011,6603.636841,8066,9589,40360,2220,-17723,502,2301,45447,42580,22637,40862,42661
31005,NE,7080,5011,6849,9589,6108,4046,6806,5011,6947.320542,8066,9589,40739,2220,-17723,502,2301,45489,42959,23016,41241,43040
31007,NE,7044,5011,6849,9589,6108,4046,6800,4739,6947.320542,8066,9329,40172,2220,-17723,502,2301,45447,42392,22449,40674,42473
31009,NE,7080,5011,6849,9589,6108,4046,6806,5011,6554.539169,8066,9589,40347,2220,-17723,502,2301,45489,42567,22624,40849,42648
31011,NE,7044,5011,6849,9589,6108,4046,6800,5011,6456.343826,8066,9589,40212,2220,-17723,502,2301,45447,42432,22489,40714,42513
31013,NE,7044,5011,6849,9589,6108,4046,6800,5011,6947.320542,8066,9589,40703,2220,-17723,502,2301,45447,42923,22980,41205,43004
31015,NE,7044,5011,6849,9589,6108,4046,6800,5011,6579.088005,8066,9589,40335,2220,-17723,502,2301,45447,42555,22612,40837,42636
31017,NE,7044,5011,6849,9589,6108,4046,6800,5011,6382.697318,8066,9589,40139,2220,-17723,502,2301,45447,42359,22416,40641,42440
31019,NE,7764,5011,6849,9589,6108,4046,6908,4360,6922.771707,8066,9767,40926,2220,-17723,502,2301,46275,43146,23203,41428,43227
31021,NE,7044,5011,6849,9589,6108,4046,6800,5011,6603.636841,8066,9589,40360,2220,-17723,502,2301,45447,42580,22637,40862,42661
31023,NE,7044,5011,6849,9589,6108,4046,6800,5011,6849.125199,8066,9589,40605,2220,-17723,502,2301,45447,42825,22882,41107,42906
31025,NE,9480,5011,6849,9589,6108,4046,7166,4360,7045.515886,8066,9813,42811,3211,-17352,1334,3292,48249,46022,25459,44145,46103
31027,NE,7044,5011,6849,9589,6108,4046,6800,5011,6554.539169,8066,9589,40311,2220,-17723,502,2301,45447,42531,22588,40813,42612
31029,NE,7044,5011,6849,9589,6108,4046,6800,5011,6849.125199,8066,9589,40605,2220,-17723,502,2301,45447,42825,22882,41107,42906
31031,NE,7548,5011,6849,9589,6108,4046,6876,5011,6726.38102,8066,9589,40986,2716,-17628,917,2796,46027,43702,23358,41903,43782
31033,NE,7044,5011,6849,9589,6108,4046,6800,5011,7045.515886,8066,9589,40802,2220,-17723,502,2301,45447,43022,23079,41304,43103
31035,NE,7044,5011,6849,9589,6108,4046,6800,5011,6382.697318,8066,9589,40139,2220,-17723,502,2301,45447,42359,22416,40641,42440
31037,NE,7044,5011,6849,9589,6108,4046,6800,5011,6579.088005,8066,9589,40335,2220,-17723,502,2301,45447,42555,22612,40837,42636
31039,NE,7164,5011,6849,9589,6108,4046,6818,5011,6579.088005,8066,9589,40455,2220,-17723,502,2301,45585,42675,22732,40957,42756
31041,NE,7044,5011,6849,9589,6108,4046,6800,5011,6554.539169,8066,9589,40311,2220,-17723,502,2301,45447,42531,22588,40813,42612
31043,NE,8352,5011,6849,9589,6108,4046,6997,4406,6235.404303,8066,9647,40752,2716,-17628,917,2796,46952,43468,23124,41669,43548
31045,NE,7044,5011,6849,9589,6108,4046,6800,5011,6922.771707,8066,9589,40679,2220,-17723,502,2301,45447,42899,22956,41181,42980
31047,NE,7212,5011,6849,9589,6108,4046,6825,4857,6309.050811,8066,9647,40137,2220,-17723,502,2301,45640,42357,22414,40639,42438
31049,NE,7044,5011,6849,9589,6108,4046,6800,5011,7070.064722,8066,9589,40826,2220,-17723,502,2301,45447,43046,23103,41328,43127
31051,NE,8352,5011,6849,9589,6108,4046,6997,5532,6505.441497,8066,9634,42136,3211,-17352,1334,3292,46952,45347,24784,43470,45428
31053,NE,7848,5011,6849,9589,6108,4046,6921,4371,6505.441497,8066,9323,40159,2220,-17723,502,2301,46372,42379,22436,40661,42460
31055,NE,9480,5011,6849,9589,6108,4046,7166,4175,6652.734512,8066,9837,42257,3211,-17352,1334,3292,48249,45468,24905,43591,45549
31057,NE,7044,5011,6849,9589,6108,4046,6800,5011,6628.185677,8066,9589,40384,2220,-17723,502,2301,45447,42604,22661,40886,42685
31059,NE,7044,5011,6849,9589,6108,4046,6800,5011,6579.088005,8066,9589,40335,2220,-17723,502,2301,45447,42555,22612,40837,42636
31061,NE,7044,5011,6849,9589,6108,4046,6800,5011,6775.478692,8066,9589,40531,2220,-17723,502,2301,45447,42751,22808,41033,42832
31063,NE,7872,5011,6849,9589,6108,4046,6925,5011,6603.636841,8066,9589,41188,2716,-17628,917,2796,46400,43904,23560,42105,43984
31065,NE,7044,5011,6849,9589,6108,4046,6800,5011,6726.38102,8066,9589,40482,2220,-17723,502,2301,45447,42702,22759,40984,42783
31067,NE,7320,5011,6849,9589,6108,4046,6842,4314,6554.539169,8066,9301,39602,-2797,-22339,-4436,-2716,45765,36805,17263,35166,36886
31069,NE,7044,5011,6849,9589,6108,4046,6800,5011,6947.320542,8066,9589,40703,2220,-17723,502,2301,45447,42923,22980,41205,43004
31071,NE,7044,5011,6849,9589,6108,4046,6800,5011,6407.246154,8066,9589,40163,2220,-17723,502,2301,45447,42383,22440,40665,42464
31073,NE,7272,5011,6849,9589,6108,4046,6834,4164,6750.929856,8066,9640,39940,2220,-17723,502,2301,45709,42160,22217,40442,42241
31075,NE,7044,5011,6849,9589,6108,4046,6800,5011,6922.771707,8066,9589,40679,2220,-17723,502,2301,45447,42899,22956,41181,42980
31077,NE,7044,5011,6849,9589,6108,4046,6800,5011,6775.478692,8066,9589,40531,2220,-17723,502,2301,45447,42751,22808,41033,42832
31079,NE,7644,5011,6849,9589,6108,4046,6890,4245,6309.050811,8066,9670,39980,2220,-17723,502,2301,46137,42200,22257,40482,42281
31081,NE,7044,5011,6849,9589,6108,4046,6800,4560,6382.697318,8066,9658,39756,2220,-17723,502,2301,45447,41976,22033,40258,42057
31083,NE,7044,5011,6849,9589,6108,4046,6800,5011,6800.027527,8066,9589,40556,2220,-17723,502,2301,45447,42776,22833,41058,42857
31085,NE,7080,5011,6849,9589,6108,4046,6806,5011,6824.576363,8066,9589,40617,2220,-17723,502,2301,45489,42837,22894,41119,42918
31087,NE,7044,5011,6849,9589,6108,4046,6800,5011,6628.185677,8066,9589,40384,2220,-17723,502,2301,45447,42604,22661,40886,42685
31089,NE,7044,5011,6849,9589,6108,4046,6800,5011,6701.832184,8066,9589,40458,2220,-17723,502,2301,45447,42678,22735,40960,42759
31091,NE,7080,5011,6849,9589,6108,4046,6806,5011,6898.222871,8066,9589,40690,2220,-17723,502,2301,45489,42910,22967,41192,42991
31093,NE,7044,5011,6849,9589,6108,4046,6800,4619,6505.441497,8066,9656,39936,2220,-17723,502,2301,45447,42156,22213,40438,42237
31095,NE,7044,5011,6849,9589,6108,4046,6800,5011,6480.892661,8066,9589,40237,2220,-17723,502,2301,45447,42457,22514,40739,42538
31097,NE,7044,5011,6849,9589,6108,4046,6800,5011,6873.674035,8066,9589,40630,2220,-17723,502,2301,45447,42850,22907,41132,42931
31099,NE,7044,5011,6849,9589,6108,4046,6800,4417,6800.027527,8066,9744,40117,2220,-17723,502,2301,45447,42337,22394,40619,42418
31101,NE,7044,5011,6849,9589,6108,4046,6800,5011,6898.222871,8066,9589,40654,2220,-17723,502,2301,45447,42874,22931,41156,42955
31103,NE,7044,5011,6849,9589,6108,4046,6800,5011,6382.697318,8066,9589,40139,2220,-17723,502,2301,45447,42359,22416,40641,42440
31105,NE,7308,5011,6849,9589,6108,4046,6840,5011,7070.064722,8066,9589,41090,2220,-17723,502,2301,45751,43310,23367,41592,43391
31107,NE,7044,5011,6849,9589,6108,4046,6800,5011,6750.929856,8066,9589,40507,2220,-17723,502,2301,45447,42727,22784,41009,42808
31109,NE,8400,5011,6849,9589,6108,4046,7004,5178,6996.418214,8066,9601,42287,3211,-17352,1334,3292,47007,45498,24935,43621,45579
31111,NE,7536,5011,6849,9589,6108,4046,6874,4516,6750.929856,8066,9227,40141,2220,-17723,502,2301,46013,42361,22418,40643,42442
31113,NE,8544,5011,6849,9589,6108,4046,7026,4211,6579.088005,8066,9303,40749,2716,-17628,917,2796,47173,43465,23121,41666,43545
31115,NE,7044,5011,6849,9589,6108,4046,6800,5011,6505.441497,8066,9589,40261,2220,-17723,502,2301,45447,42481,22538,40763,42562
31117,NE,7080,5011,6849,9589,6108,4046,6806,4389,6898.222871,8066,9308,39787,-2797,-22339,-4436,-2716,45489,36990,17448,35351,37071
31119,NE,7164,5011,6849,9589,6108,4046,6818,4284,6603.636841,8066,9497,39660,-2797,-22339,-4436,-2716,45585,36863,17321,35224,36944
31121,NE,7044,5011,6849,9589,6108,4046,6800,4272,6431.79499,8066,9658,39518,-2797,-22339,-4436,-2716,45447,36721,17179,35082,36802
31123,NE,7044,5011,6849,9589,6108,4046,6800,5011,6996.418214,8066,9589,40752,2220,-17723,502,2301,45447,42972,23029,41254,43053
31125,NE,7044,5011,6849,9589,6108,4046,6800,5011,6677.283348,8066,9589,40433,2220,-17723,502,2301,45447,42653,22710,40935,42734
31127,NE,7044,5011,6849,9589,6108,4046,6800,5011,6333.599646,8066,9589,40090,2220,-17723,502,2301,45447,42310,22367,40592,42391
31129,NE,7044,5011,6849,9589,6108,4046,6800,5011,6456.343826,8066,9589,40212,2220,-17723,502,2301,45447,42432,22489,40714,42513
31131,NE,7164,5011,6849,9589,6108,4046,6818,5011,6652.734512,8066,9589,40529,2220,-17723,502,2301,45585,42749,22806,41031,42830
31133,NE,7044,5011,6849,9589,6108,4046,6800,5011,6529.990333,8066,9589,40286,2220,-17723,502,2301,45447,42506,22563,40788,42587
31135,NE,7044,5011,6849,9589,6108,4046,6800,5011,6898.222871,8066,9589,40654,2220,-17723,502,2301,45447,42874,22931,41156,42955
31137,NE,7044,5011,6849,9589,6108,4046,6800,5011,6750.929856,8066,9589,40507,2220,-17723,502,2301,45447,42727,22784,41009,42808
31139,NE,7044,5011,6849,9589,6108,4046,6800,4610,6579.088005,8066,9511,39856,2220,-17723,502,2301,45447,42076,22133,40358,42157
31141,NE,7044,5011,6849,9589,6108,4046,6800,5849,6701.832184,8066,9730,41437,2716,-17628,917,2796,45447,44153,23809,42354,44233
31143,NE,7044,5011,6849,9589,6108,4046,6800,5011,6701.832184,8066,9589,40458,2220,-17723,502,2301,45447,42678,22735,40960,42759
31145,NE,7044,5011,6849,9589,6108,4046,6800,5011,6431.79499,8066,9589,40188,2220,-17723,502,2301,45447,42408,22465,40690,42489
31147,NE,7044,5011,6849,9589,6108,4046,6800,5011,6579.088005,8066,9589,40335,2220,-17723,502,2301,45447,42555,22612,40837,42636
31149,NE,7092,5011,6849,9589,6108,4046,6807,5011,6333.599646,8066,9589,40138,2220,-17723,502,2301,45502,42358,22415,40640,42439
31151,NE,8292,5011,6849,9589,6108,4046,6988,5011,6873.674035,8066,9589,41878,2716,-17628,917,2796,46883,44594,24250,42795,44674
31153,NE,9480,5011,6849,9589,6108,4046,7166,4335,6726.38102,8066,9825,42478,3211,-17352,1334,3292,48249,45689,25126,43812,45770
31155,NE,8796,5011,6849,9589,6108,4046,7064,4323,7020.96705,8066,9808,42060,2716,-17628,917,2796,47463,44776,24432,42977,44856
31157,NE,7560,5011,6849,9589,6108,4046,6878,4527,6775.478692,8066,9259,40233,2220,-17723,502,2301,46041,42453,22510,40735,42534
31159,NE,7044,5011,6849,9589,6108,4046,6800,4484,6922.771707,8066,9599,40162,2220,-17723,502,2301,45447,42382,22439,40664,42463
31161,NE,7044,5011,6849,9589,6108,4046,6800,5011,7143.711229,8066,9589,40900,2220,-17723,502,2301,45447,43120,23177,41402,43201
31163,NE,7044,5011,6849,9589,6108,4046,6800,5011,6529.990333,8066,9589,40286,2220,-17723,502,2301,45447,42506,22563,40788,42587
31165,NE,7044,5011,6849,9589,6108,4046,6800,5768,6947.320542,8066,9331,41202,2716,-17628,917,2796,45447,43918,23574,42119,43998
31167,NE,7044,5011,6849,9589,6108,4046,6800,6120,6628.185677,8066,9508,41412,2716,-17628,917,2796,45447,44128,23784,42329,44208
31169,NE,7044,5011,6849,9589,6108,4046,6800,5011,6382.697318,8066,9589,40139,2220,-17723,502,2301,45447,42359,22416,40641,42440
31171,NE,7188,5011,6849,9589,6108,4046,6822,5011,6677.283348,8066,9589,40577,2220,-17723,502,2301,45613,42797,22854,41079,42878
31173,NE,7044,5011,6849,9589,6108,4046,6800,5011,6456.343826,8066,9589,40212,2220,-17723,502,2301,45447,42432,22489,40714,42513
31175,NE,7044,5011,6849,9589,6108,4046,6800,5011,6505.441497,8066,9589,40261,2220,-17723,502,2301,45447,42481,22538,40763,42562
31177,NE,9480,5011,6849,9589,6108,4046,7166,4305,6750.929856,8066,9814,42462,3211,-17352,1334,3292,48249,45673,25110,43796,45754
31179,NE,7044,5011,6849,9589,6108,4046,6800,5011,6529.990333,8066,9589,40286,2220,-17723,502,2301,45447,42506,22563,40788,42587
31181,NE,7044,5011,6849,9589,6108,4046,6800,5011,6505.441497,8066,9589,40261,2220,-17723,502,2301,45447,42481,22538,40763,42562
31183,NE,7044,5011,6849,9589,6108,4046,6800,5011,6603.636841,8066,9589,40360,2220,-17723,502,2301,45447,42580,22637,40862,42661
31185,NE,7200,5011,6849,9589,6108,4046,6824,5011,6382.697318,8066,9589,40295,2220,-17723,502,2301,45627,42515,22572,40797,42596
32001,NV,9780,13449,8002,8509,6190,4344,5574,15554,8805.229056,6665,8346,53494,-2145,-14298,5210,6346,55848,51349,39196,58704,59840
32003,NV,12456,13449,8002,8509,6190,4344,5882,15820,8174.235443,6665,8676,56135,-1668,-13821,5951,6823,58832,54467,42314,62086,62958
32005,NV,11688,13449,8002,8509,6190,4344,5793,17751,8088.190859,6665,8582,57119,-1182,-13007,6701,7309,57975,55937,44112,63820,64428
32007,NV,10560,13449,8002,8509,6190,4344,5663,12387,8805.229056,6665,9382,52143,-2623,-14776,4468,5868,56717,49520,37367,56611,58011
32009,NV,7644,13449,8002,8509,6190,4344,5327,13449,9895.127115,6665,8509,50506,-3100,-15253,3727,5391,53465,47406,35253,54233,55897
32011,NV,9936,13449,8002,8509,6190,4344,5592,15275,8518.413777,6665,9290,54028,-2145,-14298,5210,6346,56022,51883,39730,59238,60374
32013,NV,8328,13449,8002,8509,6190,4344,5406,13653,7944.78322,6665,8637,49572,-2862,-15015,4097,5629,54228,46710,34557,53669,55201
32015,NV,9036,13449,8002,8509,6190,4344,5488,13449,8575.776833,6665,8509,50579,-2623,-14776,4468,5868,55018,47956,35803,55047,56447
32017,NV,9384,13449,8002,8509,6190,4344,5528,13449,8116.872387,6665,8509,50468,-2623,-14776,4468,5868,55406,47845,35692,54936,56336
32019,NV,9420,13449,8002,8509,6190,4344,5532,15466,8030.827804,6665,8130,52056,-2145,-14298,5210,6346,55446,49911,37758,57266,58402
32021,NV,10668,13449,8002,8509,6190,4344,5676,13449,8403.687666,6665,8509,52039,-2623,-14776,4468,5868,56838,49416,37263,56507,57907
32023,NV,9816,13449,8002,8509,6190,4344,5578,13034,7944.78322,6665,7379,49183,-2862,-15015,4097,5629,55888,46321,34168,53280,54812
32027,NV,7644,13449,8002,8509,6190,4344,5327,13449,8288.961554,6665,8509,48900,-3100,-15253,3727,5391,53465,45800,33647,52627,54291
32029,NV,11052,13449,8002,8509,6190,4344,5720,15480,8317.643082,6665,8502,54361,-1668,-13821,5951,6823,57266,52693,40540,60312,61184
32031,NV,11052,13449,8002,8509,6190,4344,5720,15629,8288.961554,6665,8501,54480,-1668,-13821,5951,6823,57266,52812,40659,60431,61303
32033,NV,9120,13449,8002,8509,6190,4344,5498,13449,7801.375581,6665,8509,49888,-2623,-14776,4468,5868,55112,47265,35112,54356,55756
32510,NV,10428,13449,8002,8509,6190,4344,5648,14095,9235.451974,6665,8215,52982,-2623,-14776,4468,5868,56570,50359,38206,57450,58850
33001,NH,11352,10943,7786,7901,6227,3987,8055,9609,8846.620494,6694,7886,48375,-1101,-13998,4850,6646,56251,47274,34377,53225,55021
33003,NH,12156,10943,7786,7901,6227,3987,8188,10943,10018.72794,6694,7901,51700,-512,-13408,5704,7236,57188,51188,38292,57404,58936
33005,NH,11664,10943,7786,7901,6227,3987,8106,9850,8511.732652,6694,7798,48505,-1101,-13998,4850,6646,56614,47404,34507,53355,55151
33007,NH,7884,10943,7786,7901,6227,3987,7482,9844,8679.176573,6694,7193,44281,-2566,-15462,3143,5182,52210,41715,28819,47424,49463
33009,NH,12192,10943,7786,7901,6227,3987,8194,11860,9041.971735,6694,7739,51514,-216,-13112,6132,7532,57230,51298,38402,57646,59046
33011,NH,13414,10943,7786,7901,6227,3987,8395,9284,8372.196051,6694,8548,50299,-512,-13408,5704,7236,58653,49787,36891,56003,57535
33013,NH,12024,10943,7786,7901,6227,3987,8166,9464,8567.547292,6694,8353,49090,-806,-13702,5278,6942,57034,48284,35388,54368,56032
33015,NH,13506,10943,7786,7901,6227,3987,8411,9632,8623.361932,6694,8549,50992,-216,-13112,6132,7532,58761,50776,37880,57124,58524
33017,NH,12780,10943,7786,7901,6227,3987,8291,12596,8455.918011,6694,8570,53082,374,-12523,6985,8121,57915,53456,40559,60067,61203
33019,NH,11004,10943,7786,7901,6227,3987,7997,13530,7953.586248,6694,7739,50907,-216,-13112,6132,7532,55845,50691,37795,57039,58439
34001,NJ,13668,13756,7786,7901,6118,3987,6736,14099,8260.56677,8266,7976,56257,5782,-14257,5515,6387,59952,62039,42000,61772,62644
34003,NJ,16824,13756,7786,7901,6118,3987,7155,18015,9237.322976,8266,8623,64953,7594,-10846,8383,8199,63527,72547,54107,73336,73152
34005,NJ,13620,13756,7786,7901,6118,3987,6730,17190,7869.864288,8266,8337,59270,6688,-12599,6949,7293,59898,65958,46671,66219,66563
34007,NJ,13620,13756,7786,7901,6118,3987,6730,12243,8400.103371,8266,8358,54874,5782,-14257,5515,6387,59898,60656,40617,60389,61261
34009,NJ,12300,13756,7786,7901,6118,3987,6554,14174,9460.581538,8266,7526,55714,5782,-14257,5515,6387,58402,61496,41457,61229,62101
34011,NJ,12852,13756,7786,7901,6118,3987,6628,13734,7507.069126,8266,7883,54229,5782,-14257,5515,6387,59028,60011,39972,59744,60616
34013,NJ,15180,13756,7786,7901,6118,3987,6937,12661,9711.747419,8266,8677,58483,6235,-13476,6232,6840,61665,64718,45007,64715,65323
34015,NJ,13620,13756,7786,7901,6118,3987,6730,12312,7758.235007,8266,8334,54277,5782,-14257,5515,6387,59898,60059,40020,59792,60664
34017,NJ,15492,13756,7786,7901,6118,3987,6978,12267,8288.47409,8266,8874,57174,6235,-13476,6232,6840,62018,63409,43698,63406,64014
34019,NJ,17496,13756,7786,7901,6118,3987,7244,15833,9879.19134,8266,8497,63959,7141,-11723,7666,7746,64288,71100,52236,71625,71705
34021,NJ,14700,13756,7786,7901,6118,3987,6873,12407,8455.918011,8266,8631,56447,5782,-14257,5515,6387,61121,62229,42190,61962,62834
34023,NJ,17496,13756,7786,7901,6118,3987,7244,14414,8065.215529,8266,8566,60795,7141,-11723,7666,7746,64288,67936,49072,68461,68541
34025,NJ,16140,13756,7786,7901,6118,3987,7064,14173,8511.732652,8266,8533,59610,6688,-12599,6949,7293,62752,66298,47011,66559,66903
34027,NJ,15180,13756,7786,7901,6118,3987,6937,13096,8958.249774,8266,8529,58016,6235,-13476,6232,6840,61665,64251,44540,64248,64856
34029,NJ,16140,13756,7786,7901,6118,3987,7064,12318,8204.75213,8266,8512,57428,6235,-13476,6232,6840,62752,63663,43952,63660,64268
34031,NJ,16824,13756,7786,7901,6118,3987,7155,12258,8093.122849,8266,8615,58043,6235,-13476,6232,6840,63527,64278,44567,64275,64883
34033,NJ,13620,13756,7786,7901,6118,3987,6730,18130,9069.879055,8266,8318,61391,7141,-11723,7666,7746,59898,68532,49668,69057,69137
34035,NJ,17496,13756,7786,7901,6118,3987,7244,11915,8846.620494,8266,8532,59043,6235,-13476,6232,6840,64288,65278,45567,65275,65883
34037,NJ,15180,13756,7786,7901,6118,3987,6937,12610,9348.952257,8266,8496,57888,6235,-13476,6232,6840,61665,64123,44412,64120,64728
34039,NJ,15180,13756,7786,7901,6118,3987,6937,12132,7953.586248,8266,8609,56128,5782,-14257,5515,6387,61665,61910,41871,61643,62515
34041,NJ,14052,13756,7786,7901,6118,3987,6787,12783,9125.693695,8266,7955,56169,5782,-14257,5515,6387,60387,61951,41912,61684,62556
35001,NM,9624,5983,8002,8509,5630,4344,6693,7384,7744.012525,4913,8343,42352,4419,-15492,3194,5152,48785,46771,26860,45546,47504
35003,NM,7644,5983,8002,8509,5630,4344,6401,5983,7973.464748,4913,8509,39366,-82,-18973,-1070,650,46513,39284,20393,38296,40016
35005,NM,7740,5983,8002,8509,5630,4344,6415,7025,7571.923358,4913,7817,39411,-82,-18973,-1070,650,46623,39329,20438,38341,40061
35006,NM,7644,5983,8002,8509,5630,4344,6401,6085,7514.560302,4913,7902,38403,-571,-19061,-1478,161,46513,37832,19342,36925,38564
35007,NM,8136,5983,8002,8509,5630,4344,6474,5983,9034.681279,4913,8509,40920,-82,-18973,-1070,650,47078,40838,21947,39850,41570
35009,NM,8028,5983,8002,8509,5630,4344,6458,6460,8260.280027,4913,8016,40021,-82,-18973,-1070,650,46954,39939,21048,38951,40671
35011,NM,7644,5983,8002,8509,5630,4344,6401,5983,7944.78322,4913,8509,39338,-82,-18973,-1070,650,46513,39256,20365,38268,39988
35013,NM,8832,5983,8002,8509,5630,4344,6576,5827,7858.738636,4913,7960,39734,-82,-18973,-1070,650,47876,39652,20761,38664,40384
35015,NM,8844,5983,8002,8509,5630,4344,6578,6886,8432.369194,4913,8483,41903,3931,-15760,2785,4664,47890,45834,26143,44688,46567
35017,NM,7644,5983,8002,8509,5630,4344,6401,7213,8231.598499,4913,7337,39683,-82,-18973,-1070,650,46513,39601,20710,38613,40333
35019,NM,7644,5983,8002,8509,5630,4344,6401,5983,7858.738636,4913,8509,39252,-82,-18973,-1070,650,46513,39170,20279,38182,39902
35021,NM,7644,5983,8002,8509,5630,4344,6401,5983,8776.547528,4913,8509,40170,-82,-18973,-1070,650,46513,40088,21197,39100,40820
35023,NM,7644,5983,8002,8509,5630,4344,6401,5983,8002.146276,4913,8509,39395,-82,-18973,-1070,650,46513,39313,20422,38325,40045
35025,NM,9492,5983,8002,8509,5630,4344,6673,6288,8432.369194,4913,8713,42182,3931,-15760,2785,4664,48633,46113,26422,44967,46846
35027,NM,10668,5983,8002,8509,5630,4344,6846,5983,8145.553915,4913,8509,42563,4419,-15492,3194,5152,49982,46982,27071,45757,47715
35028,NM,13104,5983,8002,8509,5630,4344,7205,6939,8346.32461,4913,10340,47986,6299,-13612,5236,7032,52777,54285,34374,53222,55018
35029,NM,7644,5983,8002,8509,5630,4344,6401,5873,7830.057109,4913,7366,37970,-571,-19061,-1478,161,46513,37399,18909,36492,38131
35031,NM,7644,5983,8002,8509,5630,4344,6401,6727,7543.24183,4913,8236,39408,-82,-18973,-1070,650,46513,39326,20435,38338,40058
35033,NM,8028,5983,8002,8509,5630,4344,6458,5983,8461.050722,4913,8509,40238,-82,-18973,-1070,650,46954,40156,21265,39168,40888
35035,NM,7644,5983,8002,8509,5630,4344,6401,6677,8202.916971,4913,7674,39455,-82,-18973,-1070,650,46513,39373,20482,38385,40105
35037,NM,8112,5983,8002,8509,5630,4344,6470,5983,7887.420164,4913,8509,39748,-82,-18973,-1070,650,47050,39666,20775,38678,40398
35039,NM,8880,5983,8002,8509,5630,4344,6583,6893,7973.464748,4913,8141,41144,3931,-15760,2785,4664,47931,45075,25384,43929,45808
35041,NM,8532,5983,8002,8509,5630,4344,6532,7114,7715.330997,4913,7911,40529,3443,-15848,2377,4176,47532,43972,24681,42906,44705
35043,NM,9624,5983,8002,8509,5630,4344,6693,6012,8403.687666,4913,8367,41664,3931,-15760,2785,4664,48785,45595,25904,44449,46328
35045,NM,8820,5983,8002,8509,5630,4344,6574,6285,7715.330997,4913,8684,40761,3931,-15760,2785,4664,47862,44692,25001,43546,45425
35047,NM,7908,5983,8002,8509,5630,4344,6440,7376,8288.961554,4913,7029,39859,-82,-18973,-1070,650,46816,39777,20886,38789,40509
35049,NM,11484,5983,8002,8509,5630,4344,6967,6115,8260.280027,4913,8186,43302,4908,-15003,3602,5641,50919,48210,28299,46904,48943
35051,NM,8004,5983,8002,8509,5630,4344,6454,5983,7485.878774,4913,8509,39239,-82,-18973,-1070,650,46926,39157,20266,38169,39889
35053,NM,7644,5983,8002,8509,5630,4344,6401,5983,7801.375581,4913,8509,39194,-82,-18973,-1070,650,46513,39112,20221,38124,39844
35055,NM,10824,5983,8002,8509,5630,4344,6869,6458,9780.401004,4913,7345,43664,3931,-15760,2785,4664,50161,47595,27904,46449,48328
35057,NM,9624,5983,8002,8509,5630,4344,6693,6437,7858.738636,4913,8368,41545,3931,-15760,2785,4664,48785,45476,25785,44330,46209
35059,NM,8004,5983,8002,8509,5630,4344,6454,5983,8088.190859,4913,8509,39841,-82,-18973,-1070,650,46926,39759,20868,38771,40491
35061,NM,9624,5983,8002,8509,5630,4344,6693,6011,7686.649469,4913,8368,40947,3931,-15760,2785,4664,48785,44878,25187,43732,45611
36001,NY,11148,10841,7786,7901,5859,3987,9120,11532,8986.157095,9166,8201,53021,6322,-14322,4922,6322,56642,59343,38699,57943,59343
36003,NY,7644,10841,7786,7901,5859,3987,8559,10841,8651.269253,9166,7901,48190,5537,-15107,3741,5537,52577,53727,33083,51931,53727
36005,NY,17280,10841,7786,7901,5859,3987,10103,11686,8734.991213,9166,9007,59861,8414,-11478,8070,8414,63757,68275,48383,67931,68275
36007,NY,8304,10841,7786,7901,5859,3987,8665,11656,7562.883766,9166,7551,48228,5799,-14845,4135,5799,53343,54027,33383,52363,54027
36009,NY,7944,10841,7786,7901,5859,3987,8607,12021,7144.273963,9166,7413,47676,5799,-14845,4135,5799,52925,53475,32831,51811,53475
36011,NY,8952,10841,7786,7901,5859,3987,8768,11322,7367.532525,9166,7690,48485,5799,-14845,4135,5799,54094,54284,33640,52620,54284
36013,NY,7644,10841,7786,7901,5859,3987,8559,11823,7200.088604,9166,7317,47137,5537,-15107,3741,5537,52577,52674,32030,50878,52674
36015,NY,9444,10841,7786,7901,5859,3987,8847,13580,6921.015402,9166,7486,50584,6322,-14322,4922,6322,54665,56906,36262,55506,56906
36017,NY,7644,10841,7786,7901,5859,3987,8559,10841,8344.288731,9166,7901,47883,5537,-15107,3741,5537,52577,53420,32776,51624,53420
36019,NY,9768,10841,7786,7901,5859,3987,8899,12149,7618.698406,9166,7501,50190,6322,-14322,4922,6322,55041,56512,35868,55112,56512
36021,NY,10752,10841,7786,7901,5859,3987,9057,12098,7786.142327,9166,7748,51537,6322,-14322,4922,6322,56183,57859,37215,56459,57859
36023,NY,8988,10841,7786,7901,5859,3987,8774,13615,7395.439845,9166,7699,50851,6322,-14322,4922,6322,54136,57173,36529,55773,57173
36025,NY,8004,10841,7786,7901,5859,3987,8617,10841,9544.303498,9166,7901,49443,5537,-15107,3741,5537,52995,54980,34336,53184,54980
36027,NY,15096,10841,7786,7901,5859,3987,9753,11044,8651.269253,9166,8497,56441,7368,-13276,6496,7368,61223,63809,43165,62937,63809
36029,NY,8520,10841,7786,7901,5859,3987,8699,12756,7702.420367,9166,7602,49733,6060,-14584,4528,6060,53593,55793,35149,54261,55793
36031,NY,9804,10841,7786,7901,5859,3987,8905,10841,7479.161805,9166,7901,49178,6060,-14584,4528,6060,55083,55238,34594,53706,55238
36033,NY,8592,10841,7786,7901,5859,3987,8711,14403,6697.756841,9166,7285,50131,6322,-14322,4922,6322,53677,56453,35809,55053,56453
36035,NY,8496,10841,7786,7901,5859,3987,8695,12704,7395.439845,9166,7394,49142,6060,-14584,4528,6060,53565,55202,34558,53670,55202
36037,NY,9180,10841,7786,7901,5859,3987,8805,12816,7283.810564,9166,7801,50233,6322,-14322,4922,6322,54359,56555,35911,55155,56555
36039,NY,9372,10841,7786,7901,5859,3987,8836,10841,8846.620494,9166,7901,50114,6060,-14584,4528,6060,54582,56174,35530,54642,56174
36041,NY,7800,10841,7786,7901,5859,3987,8584,10841,8121.030169,9166,7901,47816,5537,-15107,3741,5537,52758,53353,32709,51557,53353
36043,NY,9348,10841,7786,7901,5859,3987,8832,12788,7116.366643,9166,7545,49950,6322,-14322,4922,6322,54554,56272,35628,54872,56272
36045,NY,12144,10841,7786,7901,5859,3987,9280,12680,7283.810564,9166,7639,52900,6845,-13799,5709,6845,57798,59745,39101,58609,59745
36047,NY,17280,10841,7786,7901,5859,3987,10103,11544,8734.991213,9166,9091,59803,8414,-11478,8070,8414,63757,68217,48325,67873,68217
36049,NY,7980,10841,7786,7901,5859,3987,8613,10841,7869.864288,9166,7901,47745,5537,-15107,3741,5537,52967,53282,32638,51486,53282
36051,NY,10008,10841,7786,7901,5859,3987,8938,13065,7479.161805,9166,7766,51472,6322,-14322,4922,6322,55320,57794,37150,56394,57794
36053,NY,9612,10841,7786,7901,5859,3987,8874,11458,7674.513047,9166,7778,49675,6060,-14584,4528,6060,54860,55735,35091,54203,55735
36055,NY,10008,10841,7786,7901,5859,3987,8938,10848,7702.420367,9166,7739,49450,6060,-14584,4528,6060,55320,55510,34866,53978,55510
36057,NY,8880,10841,7786,7901,5859,3987,8757,12154,7507.069126,9166,7492,49186,6060,-14584,4528,6060,54011,55246,34602,53714,55246
36059,NY,19356,10841,7786,7901,5859,3987,10435,11004,9265.230296,9166,8574,61352,8414,-11478,8070,8414,66165,69766,49874,69422,69766
36061,NY,17280,10841,7786,7901,5859,3987,10103,11393,12195.49891,9166,9675,63697,8414,-11478,8070,8414,63757,72111,52219,71767,72111
36063,NY,8520,10841,7786,7901,5859,3987,8699,11027,7255.903244,9166,7630,47585,5799,-14845,4135,5799,53593,53384,32740,51720,53384
36065,NY,9348,10841,7786,7901,5859,3987,8832,11626,7618.698406,9166,7521,49267,6060,-14584,4528,6060,54554,55327,34683,53795,55327
36067,NY,9612,10841,7786,7901,5859,3987,8874,11114,7618.698406,9166,7755,49252,6060,-14584,4528,6060,54860,55312,34668,53780,55312
36069,NY,10008,10841,7786,7901,5859,3987,8938,11410,7451.254485,9166,7758,49780,6322,-14322,4922,6322,55320,56102,35458,54702,56102
36071,NY,15096,10841,7786,7901,5859,3987,9753,11443,8232.65945,9166,8501,56425,7368,-13276,6496,7368,61223,63793,43149,62921,63793
36073,NY,10008,10841,7786,7901,5859,3987,8938,11158,6641.9422,9166,7763,48724,6060,-14584,4528,6060,55320,54784,34140,53252,54784
36075,NY,9612,10841,7786,7901,5859,3987,8874,11669,7004.737363,9166,7771,49209,6060,-14584,4528,6060,54860,55269,34625,53737,55269
36077,NY,10128,10841,7786,7901,5859,3987,8957,12323,7841.956968,9166,7530,50976,6322,-14322,4922,6322,55459,57298,36654,55898,57298
36079,NY,17280,10841,7786,7901,5859,3987,10103,11807,10074.54258,9166,8480,60794,8414,-11478,8070,8414,63757,69208,49316,68864,69208
36081,NY,17280,10841,7786,7901,5859,3987,10103,13888,8539.639972,9166,8888,61748,9024,-10445,8944,9024,63757,70772,51303,70692,70772
36083,NY,11148,10841,7786,7901,5859,3987,9120,12488,8734.991213,9166,8195,53719,6845,-13799,5709,6845,56642,60564,39920,59428,60564
36085,NY,17280,10841,7786,7901,5859,3987,10103,12146,8902.435134,9166,8668,60149,8414,-11478,8070,8414,63757,68563,48671,68219,68563
36087,NY,17280,10841,7786,7901,5859,3987,10103,11463,8204.75213,9166,8530,58630,8414,-11478,8070,8414,63757,67044,47152,66700,67044
36089,NY,8688,10841,7786,7901,5859,3987,8726,12112,7200.088604,9166,7325,48478,6060,-14584,4528,6060,53788,54538,33894,53006,54538
36091,NY,11148,10841,7786,7901,5859,3987,9120,11454,8958.249774,9166,8191,52904,6322,-14322,4922,6322,56642,59226,38582,57826,59226
36093,NY,11148,10841,7786,7901,5859,3987,9120,13137,8316.381411,9166,8201,53956,6845,-13799,5709,6845,56642,60801,40157,59665,60801
36095,NY,11148,10841,7786,7901,5859,3987,9120,13557,8288.47409,9166,8201,54348,6845,-13799,5709,6845,56642,61193,40549,60057,61193
36097,NY,7716,10841,7786,7901,5859,3987,8570,10841,7311.717884,9166,7901,46923,5537,-15107,3741,5537,52660,52460,31816,50664,52460
36099,NY,8520,10841,7786,7901,5859,3987,8699,13243,6558.22024,9166,7526,49000,6322,-14322,4922,6322,53593,55322,34678,53922,55322
36101,NY,8124,10841,7786,7901,5859,3987,8636,10201,7088.459323,9166,7469,46036,5276,-15368,3348,5276,53134,51312,30668,49384,51312
36103,NY,19356,10841,7786,7901,5859,3987,10435,12327,8958.249774,9166,8515,62309,9024,-10445,8944,9024,66165,71333,51864,71253,71333
36105,NY,10884,10841,7786,7901,5859,3987,9078,10841,7004.737363,9166,7901,49784,6322,-14322,4922,6322,56336,56106,35462,54706,56106
36107,NY,8304,10841,7786,7901,5859,3987,8665,10715,8679.176573,9166,7580,48432,5537,-15107,3741,5537,53343,53969,33325,52173,53969
36109,NY,13560,10841,7786,7901,5859,3987,9507,10367,8511.732652,9166,7580,53172,6845,-13799,5709,6845,59441,60017,39373,58881,60017
36111,NY,12744,10841,7786,7901,5859,3987,9376,11241,8372.196051,9166,7812,53323,6845,-13799,5709,6845,58494,60168,39524,59032,60168
36113,NY,12180,10841,7786,7901,5859,3987,9286,9457,8232.65945,9166,7681,50704,6322,-14322,4922,6322,57840,57026,36382,55626,57026
36115,NY,12180,10841,7786,7901,5859,3987,9286,12007,9544.303498,9166,7691,54575,6845,-13799,5709,6845,57840,61420,40776,60284,61420
36117,NY,10008,10841,7786,7901,5859,3987,8938,11377,7144.273963,9166,7764,49446,6322,-14322,4922,6322,55320,55768,35124,54368,55768
36119,NY,17388,10841,7786,7901,5859,3987,10120,12914,8958.249774,9166,8588,61001,8414,-11478,8070,8414,63882,69415,49523,69071,69415
36121,NY,8124,10841,7786,7901,5859,3987,8636,10841,8679.176573,9166,7901,48698,5537,-15107,3741,5537,53134,54235,33591,52439,54235
36123,NY,7908,10841,7786,7901,5859,3987,8601,11948,6279.147038,9166,7763,47052,5799,-14845,4135,5799,52883,52851,32207,51187,52851
37001,NC,8208,14881,6704,9859,6322,4284,7810,13262,6704.122548,10030,9378,51866,4668,-15897,3347,4747,58068,56534,35969,55213,56613
37003,NC,7644,14881,6704,9859,6322,4284,7713,13205,6704.122548,10030,9357,51224,4668,-15897,3347,4747,57407,55892,35327,54571,55971
37005,NC,7644,14881,6704,9859,6322,4284,7713,14881,6632.035209,10030,9859,53330,5023,-15542,3966,5102,57407,58353,37788,57296,58432
37007,NC,7644,14881,6704,9859,6322,4284,7713,14881,6511.889644,10030,9859,53210,5023,-15542,3966,5102,57407,58233,37668,57176,58312
37009,NC,7644,14881,6704,9859,6322,4284,7713,14881,6680.093435,10030,9859,53378,5023,-15542,3966,5102,57407,58401,37836,57344,58480
37011,NC,8436,14881,6704,9859,6322,4284,7850,14881,6680.093435,10030,9859,54170,5378,-15187,4585,5457,58336,59548,38983,58755,59627
37013,NC,7644,14881,6704,9859,6322,4284,7713,14063,6800.239001,10030,9135,51956,4668,-15897,3347,4747,57407,56624,36059,55303,56703
37015,NC,7644,14881,6704,9859,6322,4284,7713,14881,6247.5694,10030,9859,52946,5023,-15542,3966,5102,57407,57969,37404,56912,58048
37017,NC,7644,14881,6704,9859,6322,4284,7713,14881,6680.093435,10030,9859,53378,5023,-15542,3966,5102,57407,58401,37836,57344,58480
37019,NC,9816,14881,6704,9859,6322,4284,8089,13879,7449.025054,10030,9246,54703,5023,-15542,3966,5102,59955,59726,39161,58669,59805
37021,NC,8628,14881,6704,9859,6322,4284,7883,13586,6535.918757,10030,9195,52259,5023,-15542,3966,5102,58561,57282,36717,56225,57361
37023,NC,7644,14881,6704,9859,6322,4284,7713,13188,5863.103591,10030,9353,50362,4668,-15897,3347,4747,57407,55030,34465,53709,55109
37025,NC,9756,14881,6704,9859,6322,4284,8078,12706,6535.918757,10030,9842,53154,5023,-15542,3966,5102,59884,58177,37612,57120,58256
37027,NC,7644,14881,6704,9859,6322,4284,7713,13419,6079.365608,10030,9349,50805,4668,-15897,3347,4747,57407,55473,34908,54152,55552
37029,NC,9684,14881,6704,9859,6322,4284,8066,14502,7064.559245,10030,9666,55231,5378,-15187,4585,5457,59800,60609,40044,59816,60688
37031,NC,8292,14881,6704,9859,6322,4284,7825,13244,7737.374411,10030,9243,52830,4668,-15897,3347,4747,58167,57498,36933,56177,57577
37033,NC,7644,14881,6704,9859,6322,4284,7713,14881,5911.161817,10030,9859,52609,5023,-15542,3966,5102,57407,57632,37067,56575,57711
37035,NC,7644,14881,6704,9859,6322,4284,7713,12715,6439.802305,10030,9382,50495,4668,-15897,3347,4747,57407,55163,34598,53842,55242
37037,NC,10116,14881,6704,9859,6322,4284,8141,13683,7449.025054,10030,9667,55228,5378,-15187,4585,5457,60307,60606,40041,59813,60685
37039,NC,7644,14881,6704,9859,6322,4284,7713,14881,6968.442792,10030,9859,53666,5023,-15542,3966,5102,57407,58689,38124,57632,58768
37041,NC,7644,14881,6704,9859,6322,4284,7713,14881,6608.006096,10030,9859,53306,5023,-15542,3966,5102,57407,58329,37764,57272,58408
37043,NC,7644,14881,6704,9859,6322,4284,7713,14881,7064.559245,10030,9859,53763,5023,-15542,3966,5102,57407,58786,38221,57729,58865
37045,NC,7728,14881,6704,9859,6322,4284,7727,13221,5959.220043,10030,8941,50163,4668,-15897,3347,4747,57505,54831,34266,53510,54910
37047,NC,7644,14881,6704,9859,6322,4284,7713,14881,6487.860531,10030,9859,53186,5023,-15542,3966,5102,57407,58209,37644,57152,58288
37049,NC,9480,14881,6704,9859,6322,4284,8031,13172,7112.617471,10030,9404,53482,5023,-15542,3966,5102,59561,58505,37940,57448,58584
37051,NC,9792,14881,6704,9859,6322,4284,8085,13042,6559.94787,10030,9612,53320,5023,-15542,3966,5102,59927,58343,37778,57286,58422
37053,NC,13560,14881,6704,9859,6322,4284,8737,14517,7713.345298,10030,10102,60206,6088,-13725,5823,6167,64347,66294,46481,66029,66373
37055,NC,11208,14881,6704,9859,6322,4284,8330,13753,8362.131351,10030,9705,57342,5378,-15187,4585,5457,61588,62720,42155,61927,62799
37057,NC,7644,14881,6704,9859,6322,4284,7713,12729,6031.307382,10030,9439,50157,4668,-15897,3347,4747,57407,54825,34260,53504,54904
37059,NC,8316,14881,6704,9859,6322,4284,7829,12884,6752.180775,10030,9444,51711,4668,-15897,3347,4747,58195,56379,35814,55058,56458
37061,NC,7644,14881,6704,9859,6322,4284,7713,14881,6608.006096,10030,9859,53306,5023,-15542,3966,5102,57407,58329,37764,57272,58408
37063,NC,10116,14881,6704,9859,6322,4284,8141,13410,6824.268114,10030,9630,54294,5378,-15187,4585,5457,60307,59672,39107,58879,59751
37065,NC,8076,14881,6704,9859,6322,4284,7787,12770,6415.773192,10030,8910,50487,4668,-15897,3347,4747,57913,55155,34590,53834,55234
37067,NC,8316,14881,6704,9859,6322,4284,7829,12727,6608.006096,10030,9422,51387,4668,-15897,3347,4747,58195,56055,35490,54734,56134
37069,NC,10272,14881,6704,9859,6322,4284,8168,13419,6343.685852,10030,10445,54794,5378,-15187,4585,5457,60490,60172,39607,59379,60251
37071,NC,9756,14881,6704,9859,6322,4284,8078,14582,6247.5694,10030,9842,54742,5378,-15187,4585,5457,59884,60120,39555,59327,60199
37073,NC,7644,14881,6704,9859,6322,4284,7713,13812,6848.297227,10030,10099,52717,5023,-15542,3966,5102,57407,57740,37175,56683,57819
37075,NC,7644,14881,6704,9859,6322,4284,7713,14881,7016.501018,10030,9859,53715,5023,-15542,3966,5102,57407,58738,38173,57681,58817
37077,NC,8784,14881,6704,9859,6322,4284,7910,13562,6391.744078,10030,9719,52771,5023,-15542,3966,5102,58744,57794,37229,56737,57873
37079,NC,7644,14881,6704,9859,6322,4284,7713,14881,6151.452948,10030,9859,52849,5023,-15542,3966,5102,57407,57872,37307,56815,57951
37081,NC,8508,14881,6704,9859,6322,4284,7862,13631,6728.151662,10030,9418,52599,5023,-15542,3966,5102,58420,57622,37057,56565,57701
37083,NC,7644,14881,6704,9859,6322,4284,7713,12676,6319.656739,10030,8362,49316,4490,-16075,3037,4569,57407,53806,33241,52353,53885
37085,NC,8508,14881,6704,9859,6322,4284,7862,12847,6776.209888,10030,9725,52170,5023,-15542,3966,5102,58420,57193,36628,56136,57272
37087,NC,8028,14881,6704,9859,6322,4284,7779,14061,7040.530132,10030,9195,52639,5023,-15542,3966,5102,57857,57662,37097,56605,57741
37089,NC,8628,14881,6704,9859,6322,4284,7883,14267,6608.006096,10030,9194,53011,5023,-15542,3966,5102,58561,58034,37469,56977,58113
37091,NC,7644,14881,6704,9859,6322,4284,7713,14881,6247.5694,10030,9859,52946,5023,-15542,3966,5102,57407,57969,37404,56912,58048
37093,NC,7956,14881,6704,9859,6322,4284,7767,15300,6800.239001,10030,9625,53995,5023,-15542,3966,5102,57773,59018,38453,57961,59097
37095,NC,9588,14881,6704,9859,6322,4284,8049,14881,7256.792149,10030,9859,55899,5378,-15187,4585,5457,59687,61277,40712,60484,61356
37097,NC,9288,14881,6704,9859,6322,4284,7997,15225,6728.151662,10030,9840,55395,5378,-15187,4585,5457,59335,60773,40208,59980,60852
37099,NC,8112,14881,6704,9859,6322,4284,7794,14754,6920.384566,10030,8742,52842,5023,-15542,3966,5102,57956,57865,37300,56808,57944
37101,NC,10272,14881,6704,9859,6322,4284,8168,14191,6944.413679,10030,10458,56179,5378,-15187,4585,5457,60490,61557,40992,60764,61636
37103,NC,8208,14881,6704,9859,6322,4284,7810,14498,6848.297227,10030,9446,53315,5023,-15542,3966,5102,58068,58338,37773,57281,58417
37105,NC,8772,14881,6704,9859,6322,4284,7908,14479,6896.355453,10030,9691,54153,5023,-15542,3966,5102,58730,59176,38611,58119,59255
37107,NC,7800,14881,6704,9859,6322,4284,7740,14853,5815.045365,10030,8699,51481,5023,-15542,3966,5102,57590,56504,35939,55447,56583
37109,NC,7644,14881,6704,9859,6322,4284,7713,14945,6223.540287,10030,9840,52967,5023,-15542,3966,5102,57407,57990,37425,56933,58069
37111,NC,7644,14881,6704,9859,6322,4284,7713,15409,6848.297227,10030,8712,52928,5023,-15542,3966,5102,57407,57951,37386,56894,58030
37113,NC,8556,14881,6704,9859,6322,4284,7871,14881,7208.733923,10030,9859,54819,5378,-15187,4585,5457,58477,60197,39632,59404,60276
37115,NC,8628,14881,6704,9859,6322,4284,7883,15180,7040.530132,10030,9236,54398,5378,-15187,4585,5457,58561,59776,39211,58983,59855
37117,NC,7644,14881,6704,9859,6322,4284,7713,14881,6535.918757,10030,9859,53234,5023,-15542,3966,5102,57407,58257,37692,57200,58336
37119,NC,9756,14881,6704,9859,6322,4284,8078,15146,7064.559245,10030,9840,56120,5378,-15187,4585,5457,59884,61498,40933,60705,61577
37121,NC,7644,14881,6704,9859,6322,4284,7713,14881,6992.471905,10030,9859,53690,5023,-15542,3966,5102,57407,58713,38148,57656,58792
37123,NC,7644,14881,6704,9859,6322,4284,7713,14881,6415.773192,10030,9859,53114,5023,-15542,3966,5102,57407,58137,37572,57080,58216
37125,NC,7680,14881,6704,9859,6322,4284,7719,15228,7905.578202,10030,9272,54400,5023,-15542,3966,5102,57449,59423,38858,58366,59502
37127,NC,8076,14881,6704,9859,6322,4284,7787,14133,6103.394722,10030,8908,51535,5023,-15542,3966,5102,57913,56558,35993,55501,56637
37129,NC,9816,14881,6704,9859,6322,4284,8089,15180,7184.70481,10030,9493,55988,5378,-15187,4585,5457,59955,61366,40801,60573,61445
37131,NC,7644,14881,6704,9859,6322,4284,7713,16436,7040.530132,10030,8445,53879,5023,-15542,3966,5102,57407,58902,38337,57845,58981
37133,NC,9084,14881,6704,9859,6322,4284,7962,15806,6704.122548,10030,9900,55808,5378,-15187,4585,5457,59096,61186,40621,60393,61265
37135,NC,10116,14881,6704,9859,6322,4284,8141,16599,8290.044012,10030,9640,58959,5733,-14504,5204,5812,60307,64692,44455,64163,64771
37137,NC,7644,14881,6704,9859,6322,4284,7713,16038,7256.792149,10030,9437,54690,5378,-15187,4585,5457,57407,60068,39503,59275,60147
37139,NC,8892,14881,6704,9859,6322,4284,7929,14848,6728.151662,10030,9641,54423,5378,-15187,4585,5457,58871,59801,39236,59008,59880
37141,NC,7908,14881,6704,9859,6322,4284,7758,16154,7641.257958,10030,9532,55549,5378,-15187,4585,5457,57716,60927,40362,60134,61006
37143,NC,8916,14881,6704,9859,6322,4284,7933,18566,6656.064322,10030,9658,58109,6088,-13725,5823,6167,58899,64197,44384,63932,64276
37145,NC,8100,14881,6704,9859,6322,4284,7792,16665,6391.744078,10030,9661,55132,5378,-15187,4585,5457,57942,60510,39945,59717,60589
37147,NC,8232,14881,6704,9859,6322,4284,7814,16301,6728.151662,10030,9461,55036,5378,-15187,4585,5457,58096,60414,39849,59621,60493
37149,NC,7704,14881,6704,9859,6322,4284,7723,14881,7088.588358,10030,9859,53847,5023,-15542,3966,5102,57477,58870,38305,57813,58949
37151,NC,8508,14881,6704,9859,6322,4284,7862,16248,6247.5694,10030,9432,54749,5378,-15187,4585,5457,58420,60127,39562,59334,60206
37153,NC,7644,14881,6704,9859,6322,4284,7713,15118,5742.958025,10030,8457,51276,5023,-15542,3966,5102,57407,56299,35734,55242,56378
37155,NC,7644,14881,6704,9859,6322,4284,7713,17855,5791.016252,10030,8784,54388,5378,-15187,4585,5457,57407,59766,39201,58973,59845
37157,NC,7644,14881,6704,9859,6322,4284,7713,16087,6608.006096,10030,9428,54081,5378,-15187,4585,5457,57407,59459,38894,58666,59538
37159,NC,7980,14881,6704,9859,6322,4284,7771,18514,6055.336495,10030,9843,56706,5733,-14504,5204,5812,57801,62439,42202,61910,62518
37161,NC,7644,14881,6704,9859,6322,4284,7713,18025,5839.074478,10030,8563,54385,5378,-15187,4585,5457,57407,59763,39198,58970,59842
37163,NC,7644,14881,6704,9859,6322,4284,7713,14881,6247.5694,10030,9859,52946,5023,-15542,3966,5102,57407,57969,37404,56912,58048
37165,NC,7704,14881,6704,9859,6322,4284,7723,17447,6704.122548,10030,8254,54423,5378,-15187,4585,5457,57477,59801,39236,59008,59880
37167,NC,7644,14881,6704,9859,6322,4284,7713,17508,6175.482061,10030,9345,54987,5378,-15187,4585,5457,57407,60365,39800,59572,60444
37169,NC,8316,14881,6704,9859,6322,4284,7829,17685,7064.559245,10030,9440,56820,5733,-14504,5204,5812,58195,62553,42316,62024,62632
37171,NC,7644,14881,6704,9859,6322,4284,7713,18262,6583.976983,10030,8746,55550,5378,-15187,4585,5457,57407,60928,40363,60135,61007
37173,NC,8736,14881,6704,9859,6322,4284,7902,14881,6800.239001,10030,9859,54590,5378,-15187,4585,5457,58688,59968,39403,59175,60047
37175,NC,7764,14881,6704,9859,6322,4284,7733,15987,7256.792149,10030,8953,54275,5023,-15542,3966,5102,57547,59298,38733,58241,59377
37177,NC,7644,14881,6704,9859,6322,4284,7713,17852,7376.937715,10030,9716,56902,5733,-14504,5204,5812,57407,62635,42398,62106,62714
37179,NC,9756,14881,6704,9859,6322,4284,8078,15172,6848.297227,10030,9842,55932,5378,-15187,4585,5457,59884,61310,40745,60517,61389
37181,NC,7944,14881,6704,9859,6322,4284,7765,18532,6247.5694,10030,8849,55886,5733,-14504,5204,5812,57759,61619,41382,61090,61698
37183,NC,10272,14881,6704,9859,6322,4284,8168,16685,7136.646584,10030,10482,58889,6088,-13725,5823,6167,60490,64977,45164,64712,65056
37185,NC,7644,14881,6704,9859,6322,4284,7713,14881,6343.685852,10030,9859,53042,5023,-15542,3966,5102,57407,58065,37500,57008,58144
37187,NC,7644,14881,6704,9859,6322,4284,7713,14881,6656.064322,10030,9859,53354,5023,-15542,3966,5102,57407,58377,37812,57320,58456
37189,NC,9684,14881,6704,9859,6322,4284,8066,17792,8121.84022,10030,8527,58439,5733,-14504,5204,5812,59800,64172,43935,63643,64251
37191,NC,8292,14881,6704,9859,6322,4284,7825,16441,6319.656739,10030,9442,54809,5378,-15187,4585,5457,58167,60187,39622,59394,60266
37193,NC,7644,14881,6704,9859,6322,4284,7713,14567,6776.209888,10030,8587,51888,4668,-15897,3347,4747,57407,56556,35991,55235,56635
37195,NC,9636,14881,6704,9859,6322,4284,8058,13179,6247.5694,10030,8935,52311,5023,-15542,3966,5102,59744,57334,36769,56277,57413
37197,NC,8316,14881,6704,9859,6322,4284,7829,13359,6680.093435,10030,9442,52111,5023,-15542,3966,5102,58195,57134,36569,56077,57213
37199,NC,7644,14881,6704,9859,6322,4284,7713,14881,6680.093435,10030,9859,53378,5023,-15542,3966,5102,57407,58401,37836,57344,58480
38001,ND,7644,12324,6849,9589,5460,4046,5660,12324,7291.004244,7850,9589,48744,5534,-14799,4181,5845,51572,54278,33945,52925,54589
38003,ND,8016,12324,6849,9589,5460,4046,5708,12324,6922.771707,7850,9589,48748,5534,-14799,4181,5845,51992,54282,33949,52929,54593
38005,ND,7644,12324,6849,9589,5460,4046,5660,12324,6971.869378,7850,9589,48425,5534,-14799,4181,5845,51572,53959,33626,52606,54270
38007,ND,7740,12324,6849,9589,5460,4046,5672,12324,7855.627468,7850,9589,49405,5534,-14799,4181,5845,51680,54939,34606,53586,55250
38009,ND,7644,12324,6849,9589,5460,4046,5660,12324,7143.711229,7850,9589,48597,5534,-14799,4181,5845,51572,54131,33798,52778,54442
38011,ND,7644,12324,6849,9589,5460,4046,5660,12324,7291.004244,7850,9589,48744,5534,-14799,4181,5845,51572,54278,33945,52925,54589
38013,ND,7644,12324,6849,9589,5460,4046,5660,12324,7683.785618,7850,9589,49137,5534,-14799,4181,5845,51572,54671,34338,53318,54982
38015,ND,8448,12324,6849,9589,5460,4046,5763,11858,6750.929856,7850,10089,49041,5819,-14514,4598,6130,52479,54860,34527,53639,55171
38017,ND,8208,12324,6849,9589,5460,4046,5732,13951,6898.222871,7850,9621,50574,6105,-14228,5016,6416,52208,56679,36346,55590,56990
38019,ND,7644,12324,6849,9589,5460,4046,5660,12324,7045.515886,7850,9589,48499,5534,-14799,4181,5845,51572,54033,33700,52680,54344
38021,ND,7644,12324,6849,9589,5460,4046,5660,12324,7020.96705,7850,9589,48474,5534,-14799,4181,5845,51572,54008,33675,52655,54319
38023,ND,7644,12324,6849,9589,5460,4046,5660,12324,8125.664663,7850,9589,49579,5534,-14799,4181,5845,51572,55113,34780,53760,55424
38025,ND,7644,12324,6849,9589,5460,4046,5660,12324,7806.529797,7850,9589,49260,5534,-14799,4181,5845,51572,54794,34461,53441,55105
38027,ND,7644,12324,6849,9589,5460,4046,5660,12324,7217.357737,7850,9589,48670,5534,-14799,4181,5845,51572,54204,33871,52851,54515
38029,ND,7644,12324,6849,9589,5460,4046,5660,12324,6800.027527,7850,9589,48253,5534,-14799,4181,5845,51572,53787,33454,52434,54098
38031,ND,7644,12324,6849,9589,5460,4046,5660,12324,7168.260065,7850,9589,48621,5534,-14799,4181,5845,51572,54155,33822,52802,54466
38033,ND,7644,12324,6849,9589,5460,4046,5660,12324,7855.627468,7850,9589,49309,5534,-14799,4181,5845,51572,54843,34510,53490,55154
38035,ND,8700,12324,6849,9589,5460,4046,5795,11994,6824.576363,7850,9386,48801,5534,-14799,4181,5845,52763,54335,34002,52982,54646
38037,ND,7644,12324,6849,9589,5460,4046,5660,12324,6898.222871,7850,9589,48351,5534,-14799,4181,5845,51572,53885,33552,52532,54196
38039,ND,7644,12324,6849,9589,5460,4046,5660,12324,6898.222871,7850,9589,48351,5534,-14799,4181,5845,51572,53885,33552,52532,54196
38041,ND,7644,12324,6849,9589,5460,4046,5660,12324,7241.906572,7850,9589,48695,5534,-14799,4181,5845,51572,54229,33896,52876,54540
38043,ND,7644,12324,6849,9589,5460,4046,5660,12324,6849.125199,7850,9589,48302,5534,-14799,4181,5845,51572,53836,33503,52483,54147
38045,ND,7644,12324,6849,9589,5460,4046,5660,12324,7192.808901,7850,9589,48646,5534,-14799,4181,5845,51572,54180,33847,52827,54491
38047,ND,7644,12324,6849,9589,5460,4046,5660,12324,6849.125199,7850,9589,48302,5534,-14799,4181,5845,51572,53836,33503,52483,54147
38049,ND,7644,12324,6849,9589,5460,4046,5660,12788,7143.711229,7850,9734,49205,5534,-14799,4181,5845,51572,54739,34406,53386,55050
38051,ND,9348,12324,6849,9589,5460,4046,5877,12324,6849.125199,7850,9589,50006,6105,-14228,5016,6416,53493,56111,35778,55022,56422
38053,ND,7644,12324,6849,9589,5460,4046,5660,12324,7904.72514,7850,9589,49358,5534,-14799,4181,5845,51572,54892,34559,53539,55203
38055,ND,7644,12324,6849,9589,5460,4046,5660,12324,6898.222871,7850,9589,48351,5534,-14799,4181,5845,51572,53885,33552,52532,54196
38057,ND,7644,12324,6849,9589,5460,4046,5660,12324,7094.613557,7850,9589,48548,5534,-14799,4181,5845,51572,54082,33749,52729,54393
38059,ND,8448,12324,6849,9589,5460,4046,5763,12256,7315.55308,7850,10057,49973,5819,-14514,4598,6130,52479,55792,35459,54571,56103
38061,ND,12828,12324,6849,9589,5460,4046,6321,12324,7634.687946,7850,9589,54272,6676,-13657,5851,6987,57417,60948,40615,60123,61259
38063,ND,7644,12324,6849,9589,5460,4046,5660,12324,6849.125199,7850,9589,48302,5534,-14799,4181,5845,51572,53836,33503,52483,54147
38065,ND,7644,12324,6849,9589,5460,4046,5660,16336,6800.027527,7850,10054,52730,6676,-13657,5851,6987,51572,59406,39073,58581,59717
38067,ND,7644,12324,6849,9589,5460,4046,5660,12324,6824.576363,7850,9589,48278,5534,-14799,4181,5845,51572,53812,33479,52459,54123
38069,ND,7644,12324,6849,9589,5460,4046,5660,12324,7143.711229,7850,9589,48597,5534,-14799,4181,5845,51572,54131,33798,52778,54442
38071,ND,7848,12324,6849,9589,5460,4046,5686,12324,6873.674035,7850,9589,48531,5534,-14799,4181,5845,51802,54065,33732,52712,54376
38073,ND,8232,12324,6849,9589,5460,4046,5735,12324,6947.320542,7850,9589,48988,5534,-14799,4181,5845,52235,54522,34189,53169,54833
38075,ND,7644,12324,6849,9589,5460,4046,5660,13267,7168.260065,7850,9736,49711,5819,-14514,4598,6130,51572,55530,35197,54309,55841
38077,ND,7644,12324,6849,9589,5460,4046,5660,12042,6898.222871,7850,9403,47883,5248,-15085,3763,5559,51572,53131,32798,51646,53442
38079,ND,7644,12324,6849,9589,5460,4046,5660,12324,6971.869378,7850,9589,48425,5534,-14799,4181,5845,51572,53959,33626,52606,54270
38081,ND,7644,12324,6849,9589,5460,4046,5660,12324,6898.222871,7850,9589,48351,5534,-14799,4181,5845,51572,53885,33552,52532,54196
38083,ND,7644,12324,6849,9589,5460,4046,5660,12324,6922.771707,7850,9589,48376,5534,-14799,4181,5845,51572,53910,33577,52557,54221
38085,ND,7644,12324,6849,9589,5460,4046,5660,12976,6800.027527,7850,10062,49379,5819,-14514,4598,6130,51572,55198,34865,53977,55509
38087,ND,7740,12324,6849,9589,5460,4046,5672,12324,7266.455408,7850,9589,48815,5534,-14799,4181,5845,51680,54349,34016,52996,54660
38089,ND,8904,12324,6849,9589,5460,4046,5821,14163,7241.906572,7850,10189,52394,6676,-13657,5851,6987,52993,59070,38737,58245,59381
38091,ND,7644,12324,6849,9589,5460,4046,5660,12324,6898.222871,7850,9589,48351,5534,-14799,4181,5845,51572,53885,33552,52532,54196
38093,ND,8004,12324,6849,9589,5460,4046,5706,12133,7266.455408,7850,9211,48510,5534,-14799,4181,5845,51978,54044,33711,52691,54355
38095,ND,7644,12324,6849,9589,5460,4046,5660,12324,6947.320542,7850,9589,48400,5534,-14799,4181,5845,51572,53934,33601,52581,54245
38097,ND,7764,12324,6849,9589,5460,4046,5676,12324,6898.222871,7850,9589,48471,5534,-14799,4181,5845,51708,54005,33672,52652,54316
38099,ND,7644,12324,6849,9589,5460,4046,5660,12324,6849.125199,7850,9589,48302,5534,-14799,4181,5845,51572,53836,33503,52483,54147
38101,ND,13392,12324,6849,9589,5460,4046,6393,12601,7168.260065,7850,9776,54834,7247,-13086,6686,7558,58053,62081,41748,61520,62392
38103,ND,7644,12324,6849,9589,5460,4046,5660,12324,6898.222871,7850,9589,48351,5534,-14799,4181,5845,51572,53885,33552,52532,54196
38105,ND,12636,12324,6849,9589,5460,4046,6296,14073,7880.176304,7850,10351,56836,7247,-13086,6686,7558,57200,64083,43750,63522,64394
39001,OH,7368,6648,6849,9589,5244,4046,5473,6648,6161.757796,6566,9589,40379,2436,-16934,1611,3490,45217,42815,23445,41990,43869
39003,OH,7860,6648,6849,9589,5244,4046,5535,6184,6088.111288,6566,9169,39914,1966,-17003,1222,3021,45771,41880,22911,41136,42935
39005,OH,7692,6648,6849,9589,5244,4046,5514,6211,5793.525258,6566,9249,39557,1966,-17003,1222,3021,45582,41523,22554,40779,42578
39007,OH,7416,6648,6849,9589,5244,4046,5479,6151,6309.050811,6566,8971,39459,-1241,-19809,-1906,-186,45271,38218,19650,37553,39273
39009,OH,8412,6648,6849,9589,5244,4046,5604,7183,6529.990333,6566,8410,41148,2436,-16934,1611,3490,46392,43584,24214,42759,44638
39011,OH,7704,6648,6849,9589,5244,4046,5515,6171,5965.367109,6566,9548,40001,1966,-17003,1222,3021,45595,41967,22998,41223,43022
39013,OH,7368,6648,6849,9589,5244,4046,5473,6030,5965.367109,6566,8883,38858,-1241,-19809,-1906,-186,45217,37617,19049,36952,38672
39015,OH,7368,6648,6849,9589,5244,4046,5473,6569,6480.892661,6566,9611,40641,2436,-16934,1611,3490,45217,43077,23707,42252,44131
39017,OH,8820,6648,6849,9589,5244,4046,5656,7053,6677.283348,6566,9611,42774,2905,-16684,2002,3960,46852,45679,26090,44776,46734
39019,OH,7944,6648,6849,9589,5244,4046,5545,6043,7192.808901,6566,9219,41010,1966,-17003,1222,3021,45865,42976,24007,42232,44031
39021,OH,7368,6648,6849,9589,5244,4046,5473,6278,6824.576363,6566,9389,40472,1966,-17003,1222,3021,45217,42438,23469,41694,43493
39023,OH,8556,6648,6849,9589,5244,4046,5622,6397,6186.306631,6566,9011,40762,2436,-16934,1611,3490,46554,43198,23828,42373,44252
39025,OH,8820,6648,6849,9589,5244,4046,5656,7261,6579.088005,6566,9609,42882,3376,-16213,2392,4431,46852,46258,26669,45274,47313
39027,OH,7776,6648,6849,9589,5244,4046,5524,6506,5867.171766,6566,9274,40035,2436,-16934,1611,3490,45676,42471,23101,41646,43525
39029,OH,7368,6648,6849,9589,5244,4046,5473,6159,6112.660124,6566,9016,39267,1966,-17003,1222,3021,45217,41233,22264,40489,42288
39031,OH,7368,6648,6849,9589,5244,4046,5473,6161,5597.134571,6566,9006,38744,-1241,-19809,-1906,-186,45217,37503,18935,36838,38558
39033,OH,7488,6648,6849,9589,5244,4046,5488,5934,6480.892661,6566,8862,39376,-1241,-19809,-1906,-186,45352,38135,19567,37470,39190
39035,OH,9000,6648,6849,9589,5244,4046,5678,7544,6898.222871,6566,9201,43255,3376,-16213,2392,4431,47054,46631,27042,45647,47686
39037,OH,7368,6648,6849,9589,5244,4046,5473,5730,5768.976422,6566,9144,38623,-1241,-19809,-1906,-186,45217,37382,18814,36717,38437
39039,OH,7368,6648,6849,9589,5244,4046,5473,6026,5695.329915,6566,9346,39048,1966,-17003,1222,3021,45217,41014,22045,40270,42069
39041,OH,9672,6648,6849,9589,5244,4046,5763,8109,6947.320542,6566,9607,44947,3846,-15743,2783,4901,47811,48793,29204,47730,49848
39043,OH,9552,6648,6849,9589,5244,4046,5748,6597,5916.269437,6566,9128,41805,2905,-16684,2002,3960,47676,44710,25121,43807,45765
39045,OH,9672,6648,6849,9589,5244,4046,5763,6829,6554.539169,6566,9609,43276,3376,-16213,2392,4431,47811,46652,27063,45668,47707
39047,OH,8412,6648,6849,9589,5244,4046,5604,6050,5695.329915,6566,8631,39400,1966,-17003,1222,3021,46392,41366,22397,40622,42421
39049,OH,9672,6648,6849,9589,5244,4046,5763,7974,6800.027527,6566,9610,44668,3846,-15743,2783,4901,47811,48514,28925,47451,49569
39051,OH,8124,6648,6849,9589,5244,4046,5568,6368,6750.929856,6566,9148,41003,2436,-16934,1611,3490,46068,43439,24069,42614,44493
39053,OH,7368,6648,6849,9589,5244,4046,5473,6775,5670.781079,6566,8599,39024,1966,-17003,1222,3021,45217,40990,22021,40246,42045
39055,OH,9000,6648,6849,9589,5244,4046,5678,7192,7683.785618,6566,9276,43764,2905,-16684,2002,3960,47054,46669,27080,45766,47724
39057,OH,8544,6648,6849,9589,5244,4046,5621,7128,6480.892661,6566,9098,41864,2905,-16684,2002,3960,46541,44769,25180,43866,45824
39059,OH,7368,6648,6849,9589,5244,4046,5473,6039,5744.427586,6566,8704,38468,-1241,-19809,-1906,-186,45217,37227,18659,36562,38282
39061,OH,8820,6648,6849,9589,5244,4046,5656,7726,6505.441497,6566,9610,43274,3376,-16213,2392,4431,46852,46650,27061,45666,47705
39063,OH,7548,6648,6849,9589,5244,4046,5496,6726,6800.027527,6566,9343,41029,2436,-16934,1611,3490,45420,43465,24095,42640,44519
39065,OH,7368,6648,6849,9589,5244,4046,5473,6648,6505.441497,6566,9589,40722,2436,-16934,1611,3490,45217,43158,23788,42333,44212
39067,OH,7368,6648,6849,9589,5244,4046,5473,6648,6259.953139,6566,9589,40477,2436,-16934,1611,3490,45217,42913,23543,42088,43967
39069,OH,7488,6648,6849,9589,5244,4046,5488,6648,6554.539169,6566,9589,40892,2436,-16934,1611,3490,45352,43328,23958,42503,44382
39071,OH,7368,6648,6849,9589,5244,4046,5473,6648,6259.953139,6566,9589,40477,2436,-16934,1611,3490,45217,42913,23543,42088,43967
39073,OH,7368,6648,6849,9589,5244,4046,5473,6406,6652.734512,6566,9610,40648,1966,-17003,1222,3021,45217,42614,23645,41870,43669
39075,OH,7368,6648,6849,9589,5244,4046,5473,6648,6922.771707,6566,9589,41140,2436,-16934,1611,3490,45217,43576,24206,42751,44630
39077,OH,7368,6648,6849,9589,5244,4046,5473,6515,5793.525258,6566,9479,39768,1966,-17003,1222,3021,45217,41734,22765,40990,42789
39079,OH,7368,6648,6849,9589,5244,4046,5473,6315,6382.697318,6566,8464,39142,-1241,-19809,-1906,-186,45217,37901,19333,37236,38956
39081,OH,7368,6648,6849,9589,5244,4046,5473,5679,6137.20896,6566,8834,38630,-1241,-19809,-1906,-186,45217,37389,18821,36724,38444
39083,OH,7740,6648,6849,9589,5244,4046,5520,6269,6161.757796,6566,9376,40159,1966,-17003,1222,3021,45636,42125,23156,41381,43180
39085,OH,9000,6648,6849,9589,5244,4046,5678,7070,6898.222871,6566,9249,42829,2905,-16684,2002,3960,47054,45734,26145,44831,46789
39087,OH,7716,6648,6849,9589,5244,4046,5517,6091,6112.660124,6566,8967,39499,1966,-17003,1222,3021,45609,41465,22496,40721,42520
39089,OH,9672,6648,6849,9589,5244,4046,5763,6795,6505.441497,6566,9611,43196,3376,-16213,2392,4431,47811,46572,26983,45588,47627
39091,OH,7572,6648,6849,9589,5244,4046,5499,6242,5867.171766,6566,9211,39504,1966,-17003,1222,3021,45447,41470,22501,40726,42525
39093,OH,9000,6648,6849,9589,5244,4046,5678,6815,6579.088005,6566,9254,42260,2905,-16684,2002,3960,47054,45165,25576,44262,46220
39095,OH,8124,6648,6849,9589,5244,4046,5568,6822,6382.697318,6566,9118,41059,2436,-16934,1611,3490,46068,43495,24125,42670,44549
39097,OH,9672,6648,6849,9589,5244,4046,5763,6573,6922.771707,6566,9610,43390,3376,-16213,2392,4431,47811,46766,27177,45782,47821
39099,OH,7644,6648,6849,9589,5244,4046,5508,6189,6382.697318,6566,8889,39717,1966,-17003,1222,3021,45528,41683,22714,40939,42738
39101,OH,8400,6648,6849,9589,5244,4046,5603,6191,5965.367109,6566,8914,40082,1966,-17003,1222,3021,46379,42048,23079,41304,43103
39103,OH,9000,6648,6849,9589,5244,4046,5678,7061,6873.674035,6566,9259,42805,2905,-16684,2002,3960,47054,45710,26121,44807,46765
39105,OH,7368,6648,6849,9589,5244,4046,5473,6648,6824.576363,6566,9589,41042,2436,-16934,1611,3490,45217,43478,24108,42653,44532
39107,OH,7368,6648,6849,9589,5244,4046,5473,6112,5572.585735,6566,9626,39291,1966,-17003,1222,3021,45217,41257,22288,40513,42312
39109,OH,8544,6648,6849,9589,5244,4046,5621,6318,6210.855467,6566,9120,40805,2436,-16934,1611,3490,46541,43241,23871,42416,44295
39111,OH,7368,6648,6849,9589,5244,4046,5473,6648,6333.599646,6566,9589,40551,2436,-16934,1611,3490,45217,42987,23617,42162,44041
39113,OH,8544,6648,6849,9589,5244,4046,5621,6930,6284.501975,6566,9065,41436,2905,-16684,2002,3960,46541,44341,24752,43438,45396
39115,OH,7368,6648,6849,9589,5244,4046,5473,6648,6235.404303,6566,9589,40452,2436,-16934,1611,3490,45217,42888,23518,42063,43942
39117,OH,9672,6648,6849,9589,5244,4046,5763,6332,6750.929856,6566,9609,42977,3376,-16213,2392,4431,47811,46353,26764,45369,47408
39119,OH,7632,6648,6849,9589,5244,4046,5506,6366,6063.562452,6566,9046,39720,1966,-17003,1222,3021,45514,41686,22717,40942,42741
39121,OH,7368,6648,6849,9589,5244,4046,5473,6648,6088.111288,6566,9589,40305,2436,-16934,1611,3490,45217,42741,23371,41916,43795
39123,OH,8124,6648,6849,9589,5244,4046,5568,6642,7168.260065,6566,9244,41791,2436,-16934,1611,3490,46068,44227,24857,43402,45281
39125,OH,7368,6648,6849,9589,5244,4046,5473,6648,6284.501975,6566,9589,40502,2436,-16934,1611,3490,45217,42938,23568,42113,43992
39127,OH,7368,6648,6849,9589,5244,4046,5473,6188,6677.283348,6566,9610,40455,1966,-17003,1222,3021,45217,42421,23452,41677,43476
39129,OH,9672,6648,6849,9589,5244,4046,5763,6569,5891.720601,6566,9609,42353,3376,-16213,2392,4431,47811,45729,26140,44745,46784
39131,OH,7368,6648,6849,9589,5244,4046,5473,6648,6382.697318,6566,9589,40600,2436,-16934,1611,3490,45217,43036,23666,42211,44090
39133,OH,9000,6648,6849,9589,5244,4046,5678,7315,6971.869378,6566,9404,43302,3376,-16213,2392,4431,47054,46678,27089,45694,47733
39135,OH,7896,6648,6849,9589,5244,4046,5539,6648,6382.697318,6566,9589,41128,2436,-16934,1611,3490,45811,43564,24194,42739,44618
39137,OH,7512,6648,6849,9589,5244,4046,5491,6648,6333.599646,6566,9589,40695,2436,-16934,1611,3490,45379,43131,23761,42306,44185
39139,OH,7368,6648,6849,9589,5244,4046,5473,6287,6309.050811,6566,8950,39526,1966,-17003,1222,3021,45217,41492,22523,40748,42547
39141,OH,8424,6648,6849,9589,5244,4046,5606,6459,5916.269437,6566,8944,40356,2436,-16934,1611,3490,46406,42792,23422,41967,43846
39143,OH,7368,6648,6849,9589,5244,4046,5473,6202,5916.269437,6566,9283,39380,1966,-17003,1222,3021,45217,41346,22377,40602,42401
39145,OH,7368,6648,6849,9589,5244,4046,5473,6261,6014.464781,6566,8386,38641,-1241,-19809,-1906,-186,45217,37400,18832,36735,38455
39147,OH,7368,6648,6849,9589,5244,4046,5473,5914,6014.464781,6566,9172,39081,-1241,-19809,-1906,-186,45217,37840,19272,37175,38895
39149,OH,7884,6648,6849,9589,5244,4046,5538,6445,5891.720601,6566,9595,40428,2436,-16934,1611,3490,45798,42864,23494,42039,43918
39151,OH,7944,6648,6849,9589,5244,4046,5545,6408,6480.892661,6566,9198,40643,2436,-16934,1611,3490,45865,43079,23709,42254,44133
39153,OH,9000,6648,6849,9589,5244,4046,5678,6977,6750.929856,6566,9390,42731,2905,-16684,2002,3960,47054,45636,26047,44733,46691
39155,OH,7644,6648,6849,9589,5244,4046,5508,6194,6235.404303,6566,8916,39601,1966,-17003,1222,3021,45528,41567,22598,40823,42622
39157,OH,7764,6648,6849,9589,5244,4046,5523,6173,6284.501975,6566,9225,40059,1966,-17003,1222,3021,45663,42025,23056,41281,43080
39159,OH,9600,6648,6849,9589,5244,4046,5754,7129,6137.20896,6566,9610,43088,3376,-16213,2392,4431,47730,46464,26875,45480,47519
39161,OH,7368,6648,6849,9589,5244,4046,5473,5659,6800.027527,6566,9240,39679,-1241,-19809,-1906,-186,45217,38438,19870,37773,39493
39163,OH,7368,6648,6849,9589,5244,4046,5473,6648,6186.306631,6566,9589,40403,2436,-16934,1611,3490,45217,42839,23469,42014,43893
39165,OH,8820,6648,6849,9589,5244,4046,5656,7452,6529.990333,6566,9611,43025,3376,-16213,2392,4431,46852,46401,26812,45417,47456
39167,OH,7368,6648,6849,9589,5244,4046,5473,6370,6358.148482,6566,8939,39648,1966,-17003,1222,3021,45217,41614,22645,40870,42669
39169,OH,7716,6648,6849,9589,5244,4046,5517,6558,6088.111288,6566,9512,40485,2436,-16934,1611,3490,45609,42921,23551,42096,43975
39171,OH,7368,6648,6849,9589,5244,4046,5473,6648,6480.892661,6566,9589,40698,2436,-16934,1611,3490,45217,43134,23764,42309,44188
39173,OH,8124,6648,6849,9589,5244,4046,5568,7173,6309.050811,6566,9137,41355,2436,-16934,1611,3490,46068,43791,24421,42966,44845
39175,OH,7368,6648,6849,9589,5244,4046,5473,6648,6701.832184,6566,9589,40919,2436,-16934,1611,3490,45217,43355,23985,42530,44409
40001,OK,7200,14523,6704,9859,6659,4284,5491,14523,6511.889644,7474,9859,49852,6242,-13890,5354,6754,54720,56094,35962,55206,56606
40003,OK,7200,14523,6704,9859,6659,4284,5491,14523,6415.773192,7474,9859,49756,6242,-13890,5354,6754,54720,55998,35866,55110,56510
40005,OK,7200,14523,6704,9859,6659,4284,5491,14523,6848.297227,7474,9859,50188,6242,-13890,5354,6754,54720,56430,36298,55542,56942
40007,OK,7200,14523,6704,9859,6659,4284,5491,14523,6680.093435,7474,9859,50020,6242,-13890,5354,6754,54720,56262,36130,55374,56774
40009,OK,8196,14523,6704,9859,6659,4284,5616,14379,7136.646584,7474,9749,51218,6242,-13890,5354,6754,55841,57460,37328,56572,57972
40011,OK,7596,14523,6704,9859,6659,4284,5541,14523,6968.442792,7474,9859,50704,6242,-13890,5354,6754,55166,56946,36814,56058,57458
40013,OK,7224,14523,6704,9859,6659,4284,5494,14828,6872.32634,7474,8996,49678,5984,-14149,4963,6495,54747,55662,35529,54641,56173
40015,OK,7200,14523,6704,9859,6659,4284,5491,14523,6656.064322,7474,9859,49996,6242,-13890,5354,6754,54720,56238,36106,55350,56750
40017,OK,8676,14523,6704,9859,6659,4284,5676,17335,7569.170619,7474,9813,55152,7275,-12858,6914,7786,56381,62427,42294,62066,62938
40019,OK,7428,14523,6704,9859,6659,4284,5520,14421,6295.627626,7474,9517,49419,5984,-14149,4963,6495,54977,55403,35270,54382,55914
40021,OK,7200,14523,6704,9859,6659,4284,5491,15684,6535.918757,7474,9006,50184,6242,-13890,5354,6754,54720,56426,36294,55538,56938
40023,OK,7200,14523,6704,9859,6659,4284,5491,14523,6896.355453,7474,9859,50236,6242,-13890,5354,6754,54720,56478,36346,55590,56990
40025,OK,7200,14523,6704,9859,6659,4284,5491,14523,6848.297227,7474,9859,50188,6242,-13890,5354,6754,54720,56430,36298,55542,56942
40027,OK,8676,14523,6704,9859,6659,4284,5676,18258,7088.588358,7474,9811,55591,7275,-12858,6914,7786,56381,62866,42733,62505,63377
40029,OK,7200,14523,6704,9859,6659,4284,5491,14523,6944.413679,7474,9859,50284,6242,-13890,5354,6754,54720,56526,36394,55638,57038
40031,OK,8760,14523,6704,9859,6659,4284,5687,15842,6559.94787,7474,9597,52516,6759,-13374,6134,7270,56476,59275,39142,58650,59786
40033,OK,7260,14523,6704,9859,6659,4284,5499,12774,6535.918757,7474,9637,47965,5726,-14407,4573,6237,54788,53691,33558,52538,54202
40035,OK,7200,14523,6704,9859,6659,4284,5491,14523,6535.918757,7474,9859,49876,6242,-13890,5354,6754,54720,56118,35986,55230,56630
40037,OK,8868,14523,6704,9859,6659,4284,5700,15797,6776.209888,7474,9685,52885,6759,-13374,6134,7270,56597,59644,39511,59019,60155
40039,OK,7200,14523,6704,9859,6659,4284,5491,15333,7136.646584,7474,9667,51094,6242,-13890,5354,6754,54720,57336,37204,56448,57848
40041,OK,7200,14523,6704,9859,6659,4284,5491,14523,6680.093435,7474,9859,50020,6242,-13890,5354,6754,54720,56262,36130,55374,56774
40043,OK,7200,14523,6704,9859,6659,4284,5491,14523,7160.675697,7474,9859,50501,6242,-13890,5354,6754,54720,56743,36611,55855,57255
40045,OK,7200,14523,6704,9859,6659,4284,5491,14523,7064.559245,7474,9859,50405,6242,-13890,5354,6754,54720,56647,36515,55759,57159
40047,OK,7416,14523,6704,9859,6659,4284,5518,13537,6175.482061,7474,9576,48463,5726,-14407,4573,6237,54963,54189,34056,53036,54700
40049,OK,7200,14523,6704,9859,6659,4284,5491,14523,6896.355453,7474,9859,50236,6242,-13890,5354,6754,54720,56478,36346,55590,56990
40051,OK,7200,14523,6704,9859,6659,4284,5491,15633,6848.297227,7474,9811,51250,6242,-13890,5354,6754,54720,57492,37360,56604,58004
40053,OK,7200,14523,6704,9859,6659,4284,5491,14523,6199.511174,7474,9859,49540,6242,-13890,5354,6754,54720,55782,35650,54894,56294
40055,OK,7704,14523,6704,9859,6659,4284,5554,14523,6944.413679,7474,9859,50788,6242,-13890,5354,6754,55287,57030,36898,56142,57542
40057,OK,7200,14523,6704,9859,6659,4284,5491,14523,7016.501018,7474,9859,50357,6242,-13890,5354,6754,54720,56599,36467,55711,57111
40059,OK,7200,14523,6704,9859,6659,4284,5491,14523,7112.617471,7474,9859,50453,6242,-13890,5354,6754,54720,56695,36563,55807,57207
40061,OK,7200,14523,6704,9859,6659,4284,5491,14523,6487.860531,7474,9859,49828,6242,-13890,5354,6754,54720,56070,35938,55182,56582
40063,OK,7200,14523,6704,9859,6659,4284,5491,14523,6848.297227,7474,9859,50188,6242,-13890,5354,6754,54720,56430,36298,55542,56942
40065,OK,7200,14523,6704,9859,6659,4284,5491,13286,6752.180775,7474,9427,48423,5726,-14407,4573,6237,54720,54149,34016,52996,54660
40067,OK,7200,14523,6704,9859,6659,4284,5491,14523,6559.94787,7474,9859,49900,6242,-13890,5354,6754,54720,56142,36010,55254,56654
40069,OK,7200,14523,6704,9859,6659,4284,5491,14523,6632.035209,7474,9859,49972,6242,-13890,5354,6754,54720,56214,36082,55326,56726
40071,OK,7632,14523,6704,9859,6659,4284,5545,12842,5959.220043,7474,9292,47483,5726,-14407,4573,6237,55206,53209,33076,52056,53720
40073,OK,7920,14523,6704,9859,6659,4284,5582,14523,6776.209888,7474,9859,50836,6242,-13890,5354,6754,55531,57078,36946,56190,57590
40075,OK,7200,14523,6704,9859,6659,4284,5491,14523,6704.122548,7474,9859,50044,6242,-13890,5354,6754,54720,56286,36154,55398,56798
40077,OK,7200,14523,6704,9859,6659,4284,5491,14523,6608.006096,7474,9859,49948,6242,-13890,5354,6754,54720,56190,36058,55302,56702
40079,OK,7200,14523,6704,9859,6659,4284,5491,13384,6439.802305,7474,9039,47821,5726,-14407,4573,6237,54720,53547,33414,52394,54058
40081,OK,7200,14523,6704,9859,6659,4284,5491,14977,6800.239001,7474,9813,50548,6242,-13890,5354,6754,54720,56790,36658,55902,57302
40083,OK,8676,14523,6704,9859,6659,4284,5676,17600,7112.617471,7474,9811,54957,7275,-12858,6914,7786,56381,62232,42099,61871,62743
40085,OK,7200,14523,6704,9859,6659,4284,5491,14523,6752.180775,7474,9859,50092,6242,-13890,5354,6754,54720,56334,36202,55446,56846
40087,OK,8676,14523,6704,9859,6659,4284,5676,17221,6968.442792,7474,9813,54437,7275,-12858,6914,7786,56381,61712,41579,61351,62223
40089,OK,7200,14523,6704,9859,6659,4284,5491,14523,6800.239001,7474,9859,50140,6242,-13890,5354,6754,54720,56382,36250,55494,56894
40091,OK,7224,14523,6704,9859,6659,4284,5494,14523,6920.384566,7474,9859,50284,6242,-13890,5354,6754,54747,56526,36394,55638,57038
40093,OK,7200,14523,6704,9859,6659,4284,5491,14523,6511.889644,7474,9859,49852,6242,-13890,5354,6754,54720,56094,35962,55206,56606
40095,OK,7380,14523,6704,9859,6659,4284,5514,14523,6559.94787,7474,9859,50080,6242,-13890,5354,6754,54923,56322,36190,55434,56834
40097,OK,7200,14523,6704,9859,6659,4284,5491,14523,6704.122548,7474,9859,50044,6242,-13890,5354,6754,54720,56286,36154,55398,56798
40099,OK,7428,14523,6704,9859,6659,4284,5520,14523,6656.064322,7474,9859,50224,6242,-13890,5354,6754,54977,56466,36334,55578,56978
40101,OK,7200,14523,6704,9859,6659,4284,5491,14655,6824.268114,7474,8794,49232,5984,-14149,4963,6495,54720,55216,35083,54195,55727
40103,OK,7200,14523,6704,9859,6659,4284,5491,14523,6680.093435,7474,9859,50020,6242,-13890,5354,6754,54720,56262,36130,55374,56774
40105,OK,7248,14523,6704,9859,6659,4284,5497,14523,6680.093435,7474,9859,50068,6242,-13890,5354,6754,54774,56310,36178,55422,56822
40107,OK,7200,14523,6704,9859,6659,4284,5491,14523,6896.355453,7474,9859,50236,6242,-13890,5354,6754,54720,56478,36346,55590,56990
40109,OK,8676,14523,6704,9859,6659,4284,5676,17535,6680.093435,7474,9814,54463,7275,-12858,6914,7786,56381,61738,41605,61377,62249
40111,OK,7260,14523,6704,9859,6659,4284,5499,14389,6632.035209,7474,9680,49719,5984,-14149,4963,6495,54788,55703,35570,54682,56214
40113,OK,8868,14523,6704,9859,6659,4284,5700,15295,6896.355453,7474,9691,52508,6759,-13374,6134,7270,56597,59267,39134,58642,59778
40115,OK,7524,14523,6704,9859,6659,4284,5532,13265,6271.598513,7474,8876,47695,5726,-14407,4573,6237,55085,53421,33288,52268,53932
40117,OK,7200,14523,6704,9859,6659,4284,5491,15566,6776.209888,7474,9684,50984,6242,-13890,5354,6754,54720,57226,37094,56338,57738
40119,OK,8436,14523,6704,9859,6659,4284,5646,17628,7400.966828,7474,8809,54032,6759,-13374,6134,7270,56111,60791,40658,60166,61302
40121,OK,7908,14523,6704,9859,6659,4284,5580,13782,6776.209888,7474,9036,49261,5984,-14149,4963,6495,55517,55245,35112,54224,55756
40123,OK,7200,14523,6704,9859,6659,4284,5491,13724,6992.471905,7474,9454,49128,5726,-14407,4573,6237,54720,54854,34721,53701,55365
40125,OK,8712,14523,6704,9859,6659,4284,5681,14502,7280.821262,7474,9416,51669,6242,-13890,5354,6754,56422,57911,37779,57023,58423
40127,OK,7200,14523,6704,9859,6659,4284,5491,14523,6800.239001,7474,9859,50140,6242,-13890,5354,6754,54720,56382,36250,55494,56894
40129,OK,7200,14523,6704,9859,6659,4284,5491,14523,7160.675697,7474,9859,50501,6242,-13890,5354,6754,54720,56743,36611,55855,57255
40131,OK,8868,14523,6704,9859,6659,4284,5700,16984,6968.442792,7474,9682,54260,6759,-13374,6134,7270,56597,61019,40886,60394,61530
40133,OK,7200,14523,6704,9859,6659,4284,5491,14523,6728.151662,7474,9859,50068,6242,-13890,5354,6754,54720,56310,36178,55422,56822
40135,OK,7200,14523,6704,9859,6659,4284,5491,13668,6463.831418,7474,9046,48136,5726,-14407,4573,6237,54720,53862,33729,52709,54373
40137,OK,7200,14523,6704,9859,6659,4284,5491,13286,7040.530132,7474,9364,48649,5726,-14407,4573,6237,54720,54375,34242,53222,54886
40139,OK,7368,14523,6704,9859,6659,4284,5512,15523,6704.122548,7474,10241,51594,6242,-13890,5354,6754,54909,57836,37704,56948,58348
40141,OK,7200,14523,6704,9859,6659,4284,5491,14523,6535.918757,7474,9859,49876,6242,-13890,5354,6754,54720,56118,35986,55230,56630
40143,OK,8868,14523,6704,9859,6659,4284,5700,17918,6632.035209,7474,9674,54850,7275,-12858,6914,7786,56597,62125,41992,61764,62636
40145,OK,8868,14523,6704,9859,6659,4284,5700,16575,6992.471905,7474,9689,53883,6759,-13374,6134,7270,56597,60642,40509,60017,61153
40147,OK,7872,14523,6704,9859,6659,4284,5576,14663,6295.627626,7474,9409,49997,6242,-13890,5354,6754,55477,56239,36107,55351,56751
40149,OK,7200,14523,6704,9859,6659,4284,5491,14523,7064.559245,7474,9859,50405,6242,-13890,5354,6754,54720,56647,36515,55759,57159
40151,OK,7224,14523,6704,9859,6659,4284,5494,14523,6487.860531,7474,9859,49852,6242,-13890,5354,6754,54747,56094,35962,55206,56606
40153,OK,7200,14523,6704,9859,6659,4284,5491,14846,7040.530132,7474,9939,50783,6242,-13890,5354,6754,54720,57025,36893,56137,57537
41001,OR,7848,11301,8002,8509,5956,4344,8389,11301,8260.280027,6665,8509,46927,7608,-12947,5769,7697,54349,54535,33980,52696,54624
41003,OR,9888,11301,8002,8509,5956,4344,8766,13298,8891.27364,6665,8147,51234,8874,-11681,7563,8963,56766,60108,39553,58797,60197
41005,OR,11064,11301,8002,8509,5956,4344,8984,14011,8661.821417,6665,8549,53295,9507,-11048,8460,9596,58160,62802,42247,61755,62891
41007,OR,9204,11301,8002,8509,5956,4344,8640,11745,8116.872387,6665,8022,48097,7924,-12631,6217,8013,55956,56021,35466,54314,56110
41009,OR,11064,11301,8002,8509,5956,4344,8984,11463,8919.955168,6665,8555,51011,8874,-11681,7563,8963,58160,59885,39330,58574,59974
41011,OR,8292,11301,8002,8509,5956,4344,8471,10561,8518.413777,6665,7494,45874,7291,-13264,5320,7380,54875,53165,32610,51194,53254
41013,OR,8136,11301,8002,8509,5956,4344,8442,11011,14369.44546,6665,7527,52052,7291,-13264,5320,7380,54690,59343,38788,57372,59432
41015,OR,9588,11301,8002,8509,5956,4344,8711,13228,9120.725863,6665,7341,50287,8557,-11998,7114,8646,56411,58844,38289,57401,58933
41017,OR,9636,11301,8002,8509,5956,4344,8720,12116,8604.458361,6665,8168,49533,8241,-12314,6666,8330,56468,57774,37219,56199,57863
41019,OR,7848,11301,8002,8509,5956,4344,8389,11609,7830.057109,6665,7779,46075,7608,-12947,5769,7697,54349,53683,33128,51844,53772
41021,OR,7644,11301,8002,8509,5956,4344,8351,11301,8375.006138,6665,8509,46838,7608,-12947,5769,7697,54107,54446,33891,52607,54535
41023,OR,7644,11301,8002,8509,5956,4344,8351,11301,7944.78322,6665,8509,46408,7608,-12947,5769,7697,54107,54016,33461,52177,54105
41025,OR,7644,11301,8002,8509,5956,4344,8351,11301,8174.235443,6665,8509,46637,7608,-12947,5769,7697,54107,54245,33690,52406,54334
41027,OR,10020,11301,8002,8509,5956,4344,8791,11980,9436.222669,6665,8642,51087,8557,-11998,7114,8646,56923,59644,39089,58201,59733
41029,OR,10008,11301,8002,8509,5956,4344,8789,12831,8002.146276,6665,7923,49773,8557,-11998,7114,8646,56909,58330,37775,56887,58419
41031,OR,7644,11301,8002,8509,5956,4344,8351,11301,8719.184473,6665,8509,47182,7608,-12947,5769,7697,54107,54790,34235,52951,54879
41033,OR,9768,11301,8002,8509,5956,4344,8744,11640,8489.73225,6665,7372,48278,7924,-12631,6217,8013,56624,56202,35647,54495,56291
41035,OR,8304,11301,8002,8509,5956,4344,8473,11007,8719.184473,6665,7568,46607,7291,-13264,5320,7380,54889,53898,33343,51927,53987
41037,OR,7644,11301,8002,8509,5956,4344,8351,11301,8174.235443,6665,8509,46637,7608,-12947,5769,7697,54107,54245,33690,52406,54334
41039,OR,10008,11301,8002,8509,5956,4344,8789,12641,8202.916971,6665,7905,49765,8557,-11998,7114,8646,56909,58322,37767,56879,58411
41041,OR,9012,11301,8002,8509,5956,4344,8604,11900,9321.496558,6665,7819,49061,7924,-12631,6217,8013,55728,56985,36430,55278,57074
41043,OR,9024,11301,8002,8509,5956,4344,8606,11696,7887.420164,6665,8192,47808,7924,-12631,6217,8013,55742,55732,35177,54025,55821
41045,OR,7644,11301,8002,8509,5956,4344,8351,10576,7256.426551,6665,7711,44196,6901,-13654,4872,6990,54107,51097,30542,49068,51186
41047,OR,9360,11301,8002,8509,5956,4344,8669,12741,7801.375581,6665,8335,49246,8557,-11998,7114,8646,56141,57803,37248,56360,57892
41049,OR,7644,11301,8002,8509,5956,4344,8351,11754,7973.464748,6665,8405,46785,7608,-12947,5769,7697,54107,54393,33838,52554,54482
41051,OR,11064,11301,8002,8509,5956,4344,8984,14741,8776.547528,6665,8556,54146,9507,-11048,8460,9596,58160,63653,43098,62606,63742
41053,OR,9360,11301,8002,8509,5956,4344,8669,12045,8518.413777,6665,8347,49280,8241,-12314,6666,8330,56141,57521,36966,55946,57610
41055,OR,7644,11301,8002,8509,5956,4344,8351,11301,8145.553915,6665,8509,46609,7608,-12947,5769,7697,54107,54217,33662,52378,54306
41057,OR,9108,11301,8002,8509,5956,4344,8622,11301,8977.318223,6665,8509,48904,7924,-12631,6217,8013,55842,56828,36273,55121,56917
41059,OR,8424,11301,8002,8509,5956,4344,8495,10875,8317.643082,6665,8417,47043,7608,-12947,5769,7697,55031,54651,34096,52812,54740
41061,OR,7764,11301,8002,8509,5956,4344,8373,11082,8690.502945,6665,7996,46541,7291,-13264,5320,7380,54249,53832,33277,51861,53921
41063,OR,7644,11301,8002,8509,5956,4344,8351,11301,8174.235443,6665,8509,46637,7608,-12947,5769,7697,54107,54245,33690,52406,54334
41065,OR,8760,11301,8002,8509,5956,4344,8557,11834,8891.27364,6665,7886,48381,7924,-12631,6217,8013,55429,56305,35750,54598,56394
41067,OR,11064,11301,8002,8509,5956,4344,8984,14995,8202.916971,6665,8551,53822,9507,-11048,8460,9596,58160,63329,42774,62282,63418
41069,OR,7644,11301,8002,8509,5956,4344,8351,11301,8202.916971,6665,8509,46666,7608,-12947,5769,7697,54107,54274,33719,52435,54363
41071,OR,11064,11301,8002,8509,5956,4344,8984,12880,8317.643082,6665,8546,51817,8874,-11681,7563,8963,58160,60691,40136,59380,60780
42001,PA,9924,5932,7786,7901,5639,3987,6991,6020,9293.137616,7042,8093,44360,4125,-16183,2503,4461,48160,48485,28177,46863,48821
42003,PA,9468,5932,7786,7901,5639,3987,6925,5867,7981.493569,7042,7581,41926,3657,-16432,2113,3992,47638,45583,25494,44039,45918
42005,PA,7644,5932,7786,7901,5639,3987,6659,5224,8093.122849,7042,7633,39623,-666,-19953,-2050,-330,45548,38957,19670,37573,39293
42007,PA,9468,5932,7786,7901,5639,3987,6925,5435,7339.625205,7042,7621,40893,3657,-16432,2113,3992,47638,44550,24461,43006,44885
42009,PA,7644,5932,7786,7901,5639,3987,6659,5932,8707.083893,7042,7901,41213,3188,-16500,1725,3524,45548,44401,24713,42938,44737
42011,PA,10308,5932,7786,7901,5639,3987,7047,6285,7925.678928,7042,7962,43510,4595,-15713,2892,4931,48600,48105,27797,46402,48441
42013,PA,8208,5932,7786,7901,5639,3987,6741,5346,7618.698406,7042,7451,39654,-666,-19953,-2050,-330,46194,38988,19701,37604,39324
42015,PA,7644,5932,7786,7901,5639,3987,6659,5434,7200.088604,7042,7650,38956,-666,-19953,-2050,-330,45548,38290,19003,36906,38626
42017,PA,13620,5932,7786,7901,5639,3987,7530,7201,8623.361932,7042,8342,48816,5909,-14400,4448,6244,52395,54725,34416,53264,55060
42019,PA,9468,5932,7786,7901,5639,3987,6925,5943,7981.493569,7042,7626,42047,3657,-16432,2113,3992,47638,45704,25615,44160,46039
42021,PA,7644,5932,7786,7901,5639,3987,6659,5144,7590.791086,7042,7259,38667,-1136,-20022,-2439,-800,45548,37531,18645,36228,37867
42023,PA,7644,5932,7786,7901,5639,3987,6659,5932,7702.420367,7042,7901,40208,3188,-16500,1725,3524,45548,43396,23708,41933,43732
42025,PA,11688,5932,7786,7901,5639,3987,7249,5872,7116.366643,7042,7955,43661,5064,-15245,3281,5399,50182,48725,28416,46942,49060
42027,PA,10968,5932,7786,7901,5639,3987,7144,6080,8707.083893,7042,7657,44442,4595,-15713,2892,4931,49357,49037,28729,47334,49373
42029,PA,13620,5932,7786,7901,5639,3987,7530,7361,9628.025459,7042,8333,49971,6167,-14142,4838,6502,52395,56138,35829,54809,56473
42031,PA,7644,5932,7786,7901,5639,3987,6659,5932,6669.849521,7042,7901,39176,3188,-16500,1725,3524,45548,42364,22676,40901,42700
42033,PA,7644,5932,7786,7901,5639,3987,6659,5180,7311.717884,7042,7332,38496,-1136,-20022,-2439,-800,45548,37360,18474,36057,37696
42035,PA,8688,5932,7786,7901,5639,3987,6811,5444,7953.586248,7042,7422,40537,3188,-16500,1725,3524,46744,43725,24037,42262,44061
42037,PA,8004,5932,7786,7901,5639,3987,6711,5536,7730.327687,7042,7566,39866,-666,-19953,-2050,-330,45960,39200,19913,37816,39536
42039,PA,7716,5932,7786,7901,5639,3987,6669,5291,7367.532525,7042,7400,38803,-666,-19953,-2050,-330,45630,38137,18850,36753,38473
42041,PA,10140,5932,7786,7901,5639,3987,7023,6181,8288.47409,7042,7859,43498,4125,-16183,2503,4461,48408,47623,27315,46001,47959
42043,PA,10140,5932,7786,7901,5639,3987,7023,6198,7841.956968,7042,7857,43065,4595,-15713,2892,4931,48408,47660,27352,45957,47996
42045,PA,13620,5932,7786,7901,5639,3987,7530,7114,8762.898533,7042,8375,48901,5909,-14400,4448,6244,52395,54810,34501,53349,55145
42047,PA,7644,5932,7786,7901,5639,3987,6659,5932,8065.215529,7042,7901,40571,3188,-16500,1725,3524,45548,43759,24071,42296,44095
42049,PA,7992,5932,7786,7901,5639,3987,6709,5525,7758.235007,7042,7576,39880,-666,-19953,-2050,-330,45946,39214,19927,37830,39550
42051,PA,9468,5932,7786,7901,5639,3987,6925,5182,7423.347165,7042,7633,40735,3657,-16432,2113,3992,47638,44392,24303,42848,44727
42053,PA,8340,5932,7786,7901,5639,3987,6760,5932,7088.459323,7042,7901,40290,3188,-16500,1725,3524,46345,43478,23790,42015,43814
42055,PA,8952,5932,7786,7901,5639,3987,6849,5851,7786.142327,7042,7835,41454,3657,-16432,2113,3992,47046,45111,25022,43567,45446
42057,PA,7644,5932,7786,7901,5639,3987,6659,5932,7869.864288,7042,7901,40376,3188,-16500,1725,3524,45548,43564,23876,42101,43900
42059,PA,7644,5932,7786,7901,5639,3987,6659,5932,6976.830042,7042,7901,39483,3188,-16500,1725,3524,45548,42671,22983,41208,43007
42061,PA,7644,5932,7786,7901,5639,3987,6659,5194,7814.049648,7042,7355,39035,-666,-19953,-2050,-330,45548,38369,19082,36985,38705
42063,PA,8220,5932,7786,7901,5639,3987,6743,5400,8428.010691,7042,7462,40540,-666,-19953,-2050,-330,46208,39874,20587,38490,40210
42065,PA,7644,5932,7786,7901,5639,3987,6659,5932,6530.31292,7042,7901,39036,3188,-16500,1725,3524,45548,42224,22536,40761,42560
42067,PA,7644,5932,7786,7901,5639,3987,6659,5932,8455.918011,7042,7901,40962,3188,-16500,1725,3524,45548,44150,24462,42687,44486
42069,PA,8328,5932,7786,7901,5639,3987,6758,5772,7981.493569,7042,7508,40618,3188,-16500,1725,3524,46331,43806,24118,42343,44142
42071,PA,10776,5932,7786,7901,5639,3987,7116,6264,8176.84481,7042,8030,44276,4595,-15713,2892,4931,49137,48871,28563,47168,49207
42073,PA,8196,5932,7786,7901,5639,3987,6739,5244,7423.347165,7042,7431,39323,-666,-19953,-2050,-330,46180,38657,19370,37273,38993
42075,PA,8556,5932,7786,7901,5639,3987,6792,5988,7674.513047,7042,7908,41155,3657,-16432,2113,3992,46593,44812,24723,43268,45147
42077,PA,11688,5932,7786,7901,5639,3987,7249,6578,8093.122849,7042,7959,45348,5394,-14914,3670,5730,50182,50742,30434,49018,51078
42079,PA,8328,5932,7786,7901,5639,3987,6758,5661,7646.605726,7042,7511,40175,3188,-16500,1725,3524,46331,43363,23675,41900,43699
42081,PA,7860,5932,7786,7901,5639,3987,6690,5497,7534.976446,7042,7564,39484,-666,-19953,-2050,-330,45795,38818,19531,37434,39154
42083,PA,7644,5932,7786,7901,5639,3987,6659,4980,8260.56677,7042,7275,39189,-1136,-20022,-2439,-800,45548,38053,19167,36750,38389
42085,PA,7692,5932,7786,7901,5639,3987,6666,5296,6809.386121,7042,7340,38166,-666,-19953,-2050,-330,45603,37500,18213,36116,37836
42087,PA,7644,5932,7786,7901,5639,3987,6659,5254,6893.108082,7042,7353,38173,-666,-19953,-2050,-330,45548,37507,18220,36123,37843
42089,PA,10452,5932,7786,7901,5639,3987,7068,6247,7758.235007,7042,8098,43584,4595,-15713,2892,4931,48765,48179,27871,46476,48515
42091,PA,13620,5932,7786,7901,5639,3987,7530,7310,8316.381411,7042,8355,48630,6167,-14142,4838,6502,52395,54797,34488,53468,55132
42093,PA,8304,5932,7786,7901,5639,3987,6755,5696,7730.327687,7042,7567,40327,3188,-16500,1725,3524,46304,43515,23827,42052,43851
42095,PA,11688,5932,7786,7901,5639,3987,7249,6546,8176.84481,7042,7956,45397,5394,-14914,3670,5730,50182,50791,30483,49067,51127
42097,PA,7644,5932,7786,7901,5639,3987,6659,5546,8009.400889,7042,7213,39441,-666,-19953,-2050,-330,45548,38775,19488,37391,39111
42099,PA,10140,5932,7786,7901,5639,3987,7023,5758,8232.65945,7042,7868,43027,4125,-16183,2503,4461,48408,47152,26844,45530,47488
42101,PA,13620,5932,7786,7901,5639,3987,7530,6844,8009.400889,7042,8448,47951,5909,-14400,4448,6244,52395,53860,33551,52399,54195
42103,PA,13932,5932,7786,7901,5639,3987,7576,5902,8734.991213,7042,8483,48081,5909,-14400,4448,6244,52753,53990,33681,52529,54325
42105,PA,7644,5932,7786,7901,5639,3987,6659,5932,7339.625205,7042,7901,39846,3188,-16500,1725,3524,45548,43034,23346,41571,43370
42107,PA,7644,5932,7786,7901,5639,3987,6659,5702,7451.254485,7042,7396,39222,-666,-19953,-2050,-330,45548,38556,19269,37172,38892
42109,PA,7740,5932,7786,7901,5639,3987,6673,5401,7255.903244,7042,7740,39166,-666,-19953,-2050,-330,45658,38500,19213,37116,38836
42111,PA,7644,5932,7786,7901,5639,3987,6659,5266,7116.366643,7042,7465,38521,-666,-19953,-2050,-330,45548,37855,18568,36471,38191
42113,PA,7644,5932,7786,7901,5639,3987,6659,5932,7786.142327,7042,7901,40292,3188,-16500,1725,3524,45548,43480,23792,42017,43816
42115,PA,8124,5932,7786,7901,5639,3987,6729,5932,9265.230296,7042,7901,42251,3188,-16500,1725,3524,46098,45439,25751,43976,45775
42117,PA,7764,5932,7786,7901,5639,3987,6676,5932,8009.400889,7042,7901,40635,3188,-16500,1725,3524,45685,43823,24135,42360,44159
42119,PA,8316,5932,7786,7901,5639,3987,6757,5612,8623.361932,7042,7290,40870,3188,-16500,1725,3524,46318,44058,24370,42595,44394
42121,PA,7704,5932,7786,7901,5639,3987,6667,5018,6948.922722,7042,7385,38085,-1136,-20022,-2439,-800,45616,36949,18063,35646,37285
42123,PA,7644,5932,7786,7901,5639,3987,6659,5152,6586.12756,7042,7450,37861,-666,-19953,-2050,-330,45548,37195,17908,35811,37531
42125,PA,9468,5932,7786,7901,5639,3987,6925,5590,8344.288731,7042,7621,42053,3657,-16432,2113,3992,47638,45710,25621,44166,46045
42127,PA,8508,5932,7786,7901,5639,3987,6785,5932,8455.918011,7042,7901,41826,3657,-16432,2113,3992,46538,45483,25394,43939,45818
42129,PA,9468,5932,7786,7901,5639,3987,6925,5484,7814.049648,7042,7625,41420,3657,-16432,2113,3992,47638,45077,24988,43533,45412
42131,PA,8328,5932,7786,7901,5639,3987,6758,5539,8121.030169,7042,7552,40569,3188,-16500,1725,3524,46331,43757,24069,42294,44093
42133,PA,10032,5932,7786,7901,5639,3987,7007,6198,8121.030169,7042,8054,43434,4595,-15713,2892,4931,48284,48029,27721,46326,48365
44001,RI,10956,12784,7786,7901,5872,3987,7823,15419,11023.39147,6766,7901,56052,7122,-13503,6005,7141,57109,63174,42549,62057,63193
44003,RI,10956,12784,7786,7901,5872,3987,7823,13184,8232.65945,6766,7901,51026,6594,-14031,5213,6613,57109,57620,36995,56239,57639
44005,RI,12692,12784,7786,7901,5872,3987,8088,14570,8679.176573,6766,7901,54595,7122,-13503,6005,7141,59110,61717,41092,60600,61736
44007,RI,10956,12784,7786,7901,5872,3987,7823,13666,7814.049648,6766,7901,51090,6594,-14031,5213,6613,57109,57684,37059,56303,57703
44009,RI,11098,12784,7786,7901,5872,3987,7844,13895,9879.19134,6766,7902,53527,6594,-14031,5213,6613,57272,60121,39496,58740,60140
45001,SC,7608,11557,6704,9859,6114,4284,6294,10847,6583.976983,7894,8773,45991,6025,-14619,4097,6025,52420,52016,31372,50088,52016
45003,SC,8760,11557,6704,9859,6114,4284,6473,11862,6439.802305,7894,9606,48845,6914,-13730,5382,6914,53751,55759,35115,54227,55759
45005,SC,7620,11557,6704,9859,6114,4284,6296,11557,6415.773192,7894,9859,47630,6321,-14323,4525,6321,52434,53951,33307,52155,53951
45007,SC,7824,11557,6704,9859,6114,4284,6327,11194,6271.598513,7894,9526,46994,6321,-14323,4525,6321,52669,53315,32671,51519,53315
45009,SC,7608,11557,6704,9859,6114,4284,6294,11557,6511.889644,7894,9859,47714,6321,-14323,4525,6321,52420,54035,33391,52239,54035
45011,SC,7608,11557,6704,9859,6114,4284,6294,11557,6415.773192,7894,9859,47618,6321,-14323,4525,6321,52420,53939,33295,52143,53939
45013,SC,10596,11557,6704,9859,6114,4284,6758,14562,7521.112393,7894,9666,54522,7804,-12840,6668,7804,55872,62326,41682,61190,62326
45015,SC,10752,11557,6704,9859,6114,4284,6782,13103,6824.268114,7894,9834,52690,7804,-12840,6668,7804,56052,60494,39850,59358,60494
45017,SC,9516,11557,6704,9859,6114,4284,6590,11967,6415.773192,7894,9706,49782,7211,-13433,5811,7211,54624,56993,36349,55593,56993
45019,SC,10752,11557,6704,9859,6114,4284,6782,14900,7112.617471,7894,9832,54775,8397,-12247,7525,8397,56052,63172,42528,62300,63172
45021,SC,7608,11557,6704,9859,6114,4284,6294,12077,5670.870686,7894,8763,46297,6321,-14323,4525,6321,52420,52618,31974,50822,52618
45023,SC,7608,11557,6704,9859,6114,4284,6294,10613,6632.035209,7894,9841,46872,6025,-14619,4097,6025,52420,52897,32253,50969,52897
45025,SC,7608,11557,6704,9859,6114,4284,6294,11557,6391.744078,7894,9859,47594,6321,-14323,4525,6321,52420,53915,33271,52119,53915
45027,SC,7608,11557,6704,9859,6114,4284,6294,11557,6367.714965,7894,9859,47570,6321,-14323,4525,6321,52420,53891,33247,52095,53891
45029,SC,8496,11557,6704,9859,6114,4284,6432,11557,6680.093435,7894,9859,48770,6618,-14026,4954,6618,53446,55388,34744,53724,55388
45031,SC,7884,11557,6704,9859,6114,4284,6337,11644,6535.918757,7894,9350,47592,6321,-14323,4525,6321,52739,53913,33269,52117,53913
45033,SC,7608,11557,6704,9859,6114,4284,6294,11557,6439.802305,7894,9859,47642,6321,-14323,4525,6321,52420,53963,33319,52167,53963
45035,SC,10752,11557,6704,9859,6114,4284,6782,12960,6728.151662,7894,9833,52451,7804,-12840,6668,7804,56052,60255,39611,59119,60255
45037,SC,8760,11557,6704,9859,6114,4284,6473,11968,6776.209888,7894,9617,49300,6914,-13730,5382,6914,53751,56214,35570,54682,56214
45039,SC,9516,11557,6704,9859,6114,4284,6590,11268,6319.656739,7894,9701,48983,6914,-13730,5382,6914,54624,55897,35253,54365,55897
45041,SC,7800,11557,6704,9859,6114,4284,6324,11832,6295.627626,7894,9333,47439,6321,-14323,4525,6321,52642,53760,33116,51964,53760
45043,SC,8664,11557,6704,9859,6114,4284,6458,13888,7016.501018,7894,9142,50889,7211,-13433,5811,7211,53640,58100,37456,56700,58100
45045,SC,8820,11557,6704,9859,6114,4284,6482,12088,6391.744078,7894,9514,48992,6914,-13730,5382,6914,53820,55906,35262,54374,55906
45047,SC,7608,11557,6704,9859,6114,4284,6294,11234,6103.394722,7894,8714,45838,6025,-14619,4097,6025,52420,51863,31219,49935,51863
45049,SC,7608,11557,6704,9859,6114,4284,6294,11557,6223.540287,7894,9859,47426,6321,-14323,4525,6321,52420,53747,33103,51951,53747
45051,SC,9660,11557,6704,9859,6114,4284,6612,14398,6848.297227,7894,9232,52316,7804,-12840,6668,7804,54790,60120,39476,58984,60120
45053,SC,8808,11557,6704,9859,6114,4284,6480,12639,7088.588358,7894,9682,50395,7211,-13433,5811,7211,53806,57606,36962,56206,57606
45055,SC,7680,11557,6704,9859,6114,4284,6305,11816,6680.093435,7894,9698,48052,6618,-14026,4954,6618,52503,54670,34026,53006,54670
45057,SC,7788,11557,6704,9859,6114,4284,6322,10565,6295.627626,7894,9841,46667,6321,-14323,4525,6321,52628,52988,32344,51192,52988
45059,SC,7608,11557,6704,9859,6114,4284,6294,11877,5646.841573,7894,9513,46822,6321,-14323,4525,6321,52420,53143,32499,51347,53143
45061,SC,7608,11557,6704,9859,6114,4284,6294,11557,6295.627626,7894,9859,47498,6321,-14323,4525,6321,52420,53819,33175,52023,53819
45063,SC,9516,11557,6704,9859,6114,4284,6590,12247,6415.773192,7894,9696,50053,7211,-13433,5811,7211,54624,57264,36620,55864,57264
45065,SC,7608,11557,6704,9859,6114,4284,6294,11557,6439.802305,7894,9859,47642,6321,-14323,4525,6321,52420,53963,33319,52167,53963
45067,SC,7608,11557,6704,9859,6114,4284,6294,11557,6223.540287,7894,9859,47426,6321,-14323,4525,6321,52420,53747,33103,51951,53747
45069,SC,7608,11557,6704,9859,6114,4284,6294,10675,6199.511174,7894,8448,45108,5728,-14916,3668,5728,52420,50836,30192,48776,50836
45071,SC,8460,11557,6704,9859,6114,4284,6426,11412,6271.598513,7894,9413,47735,6618,-14026,4954,6618,53404,54353,33709,52689,54353
45073,SC,7608,11557,6704,9859,6114,4284,6294,11583,6031.307382,7894,9118,46518,6321,-14323,4525,6321,52420,52839,32195,51043,52839
45075,SC,8088,11557,6704,9859,6114,4284,6368,12354,6487.860531,7894,8687,47795,6618,-14026,4954,6618,52974,54413,33769,52749,54413
45077,SC,8820,11557,6704,9859,6114,4284,6482,11899,6800.239001,7894,9519,49216,6914,-13730,5382,6914,53820,56130,35486,54598,56130
45079,SC,9516,11557,6704,9859,6114,4284,6590,12420,6439.802305,7894,9693,50247,7211,-13433,5811,7211,54624,57458,36814,56058,57458
45081,SC,9516,11557,6704,9859,6114,4284,6590,11607,6415.773192,7894,9703,49420,6914,-13730,5382,6914,54624,56334,35690,54802,56334
45083,SC,8136,11557,6704,9859,6114,4284,6376,11078,6247.5694,7894,9427,47067,6321,-14323,4525,6321,53030,53388,32744,51592,53388
45085,SC,9228,11557,6704,9859,6114,4284,6545,11776,6199.511174,7894,9422,48804,6914,-13730,5382,6914,54291,55718,35074,54186,55718
45087,SC,7692,11557,6704,9859,6114,4284,6307,10490,6535.918757,7894,9413,46309,6025,-14619,4097,6025,52517,52334,31690,50406,52334
45089,SC,7608,11557,6704,9859,6114,4284,6294,11557,6343.685852,7894,9859,47546,6321,-14323,4525,6321,52420,53867,33223,52071,53867
45091,SC,9756,11557,6704,9859,6114,4284,6627,12286,6872.32634,7894,9842,50934,7211,-13433,5811,7211,54901,58145,37501,56745,58145
46003,SD,7776,10176,6849,9589,6547,4046,5041,10176,6971.869378,7958,9589,46517,396,-16069,2647,4575,50024,46913,30448,49164,51092
46005,SD,7128,10176,6849,9589,6547,4046,4966,9737,7143.711229,7958,9154,45167,-131,-16596,1930,4048,49301,45036,28571,47097,49215
46007,SD,7128,10176,6849,9589,6547,4046,4966,10176,7119.162393,7958,9589,46016,169,-16296,2288,4348,49301,46185,29720,48304,50364
46009,SD,7128,10176,6849,9589,6547,4046,4966,10176,7217.357737,7958,9589,46114,169,-16296,2288,4348,49301,46283,29818,48402,50462
46011,SD,7488,10176,6849,9589,6547,4046,5007,11626,7487.394931,7958,9476,48082,622,-15843,3005,4801,49702,48704,32239,51087,52883
46013,SD,7476,10176,6849,9589,6547,4046,5006,10845,7241.906572,7958,9443,47011,396,-16069,2647,4575,49689,47407,30942,49658,51586
46015,SD,7128,10176,6849,9589,6547,4046,4966,10176,6996.418214,7958,9589,45893,169,-16296,2288,4348,49301,46062,29597,48181,50241
46017,SD,8304,10176,6849,9589,6547,4046,5102,10176,7094.613557,7958,9589,47168,396,-16069,2647,4575,50613,47564,31099,49815,51743
46019,SD,7128,10176,6849,9589,6547,4046,4966,10176,7364.650752,7958,9589,46262,169,-16296,2288,4348,49301,46431,29966,48550,50610
46021,SD,7128,10176,6849,9589,6547,4046,4966,10176,6652.734512,7958,9589,45550,169,-16296,2288,4348,49301,45719,29254,47838,49898
46023,SD,7128,10176,6849,9589,6547,4046,4966,10176,6971.869378,7958,9589,45869,169,-16296,2288,4348,49301,46038,29573,48157,50217
46025,SD,7128,10176,6849,9589,6547,4046,4966,10176,7168.260065,7958,9589,46065,169,-16296,2288,4348,49301,46234,29769,48353,50413
46027,SD,7800,10176,6849,9589,6547,4046,5043,11848,6824.576363,7958,8630,47107,622,-15843,3005,4801,50050,47729,31264,50112,51908
46029,SD,7152,10176,6849,9589,6547,4046,4969,10972,7070.064722,7958,9396,46594,396,-16069,2647,4575,49328,46990,30525,49241,51169
46031,SD,7128,10176,6849,9589,6547,4046,4966,10176,6652.734512,7958,9589,45550,169,-16296,2288,4348,49301,45719,29254,47838,49898
46033,SD,8460,10176,6849,9589,6547,4046,5119,11186,7340.101916,7958,9491,48481,622,-15843,3005,4801,50786,49103,32638,51486,53282
46035,SD,7704,10176,6849,9589,6547,4046,5032,10404,6922.771707,7958,9309,46343,396,-16069,2647,4575,49943,46739,30274,48990,50918
46037,SD,7128,10176,6849,9589,6547,4046,4966,10176,7094.613557,7958,9589,45992,169,-16296,2288,4348,49301,46161,29696,48280,50340
46039,SD,7128,10176,6849,9589,6547,4046,4966,10176,7241.906572,7958,9589,46139,169,-16296,2288,4348,49301,46308,29843,48427,50487
46041,SD,7128,10176,6849,9589,6547,4046,4966,10176,7143.711229,7958,9589,46041,169,-16296,2288,4348,49301,46210,29745,48329,50389
46043,SD,7128,10176,6849,9589,6547,4046,4966,10176,7045.515886,7958,9589,45943,169,-16296,2288,4348,49301,46112,29647,48231,50291
46045,SD,7872,10176,6849,9589,6547,4046,5052,9445,7192.808901,7958,9470,45984,169,-16296,2288,4348,50131,46153,29688,48272,50332
46047,SD,8892,10176,6849,9589,6547,4046,5169,10176,7241.906572,7958,9589,47903,622,-15843,3005,4801,51268,48525,32060,50908,52704
46049,SD,7128,10176,6849,9589,6547,4046,4966,10176,7070.064722,7958,9589,45967,169,-16296,2288,4348,49301,46136,29671,48255,50315
46051,SD,7128,10176,6849,9589,6547,4046,4966,10176,7217.357737,7958,9589,46114,169,-16296,2288,4348,49301,46283,29818,48402,50462
46053,SD,7128,10176,6849,9589,6547,4046,4966,10176,6677.283348,7958,9589,45574,169,-16296,2288,4348,49301,45743,29278,47862,49922
46055,SD,7128,10176,6849,9589,6547,4046,4966,10176,7217.357737,7958,9589,46114,169,-16296,2288,4348,49301,46283,29818,48402,50462
46057,SD,7128,10176,6849,9589,6547,4046,4966,10176,7241.906572,7958,9589,46139,169,-16296,2288,4348,49301,46308,29843,48427,50487
46059,SD,7128,10176,6849,9589,6547,4046,4966,10176,7070.064722,7958,9589,45967,169,-16296,2288,4348,49301,46136,29671,48255,50315
46061,SD,7200,10176,6849,9589,6547,4046,4974,9492,6996.418214,7958,9355,45047,-131,-16596,1930,4048,49381,44916,28451,46977,49095
46063,SD,7128,10176,6849,9589,6547,4046,4966,10176,7732.883289,7958,9589,46630,169,-16296,2288,4348,49301,46799,30334,48918,50978
46065,SD,7680,10176,6849,9589,6547,4046,5030,11873,7020.96705,7958,9704,48282,849,-15616,3364,5028,49917,49131,32666,51646,53310
46067,SD,7128,10176,6849,9589,6547,4046,4966,10176,6947.320542,7958,9589,45844,169,-16296,2288,4348,49301,46013,29548,48132,50192
46069,SD,7128,10176,6849,9589,6547,4046,4966,10176,7094.613557,7958,9589,45992,169,-16296,2288,4348,49301,46161,29696,48280,50340
46071,SD,7128,10176,6849,9589,6547,4046,4966,10176,7241.906572,7958,9589,46139,169,-16296,2288,4348,49301,46308,29843,48427,50487
46073,SD,7128,10176,6849,9589,6547,4046,4966,10176,6971.869378,7958,9589,45869,169,-16296,2288,4348,49301,46038,29573,48157,50217
46075,SD,7128,10176,6849,9589,6547,4046,4966,10176,7070.064722,7958,9589,45967,169,-16296,2288,4348,49301,46136,29671,48255,50315
46077,SD,7128,10176,6849,9589,6547,4046,4966,10176,7143.711229,7958,9589,46041,169,-16296,2288,4348,49301,46210,29745,48329,50389
46079,SD,7128,10176,6849,9589,6547,4046,4966,10176,6947.320542,7958,9589,45844,169,-16296,2288,4348,49301,46013,29548,48132,50192
46081,SD,7296,10176,6849,9589,6547,4046,4985,11707,8076.566991,7958,8974,48057,396,-16069,2647,4575,49488,48453,31988,50704,52632
46083,SD,9120,10176,6849,9589,6547,4046,5196,13068,8272.957678,7958,9876,52341,1302,-15163,4081,5481,51523,53643,37178,56422,57822
46085,SD,7128,10176,6849,9589,6547,4046,4966,10176,7070.064722,7958,9589,45967,169,-16296,2288,4348,49301,46136,29671,48255,50315
46087,SD,9120,10176,6849,9589,6547,4046,5196,9286,6971.869378,7958,9850,47232,622,-15843,3005,4801,51523,47854,31389,50237,52033
46089,SD,7128,10176,6849,9589,6547,4046,4966,10176,7315.55308,7958,9589,46213,169,-16296,2288,4348,49301,46382,29917,48501,50561
46091,SD,7128,10176,6849,9589,6547,4046,4966,10176,7217.357737,7958,9589,46114,169,-16296,2288,4348,49301,46283,29818,48402,50462
46093,SD,7860,10176,6849,9589,6547,4046,5050,12068,6137.20896,7958,9483,47552,849,-15616,3364,5028,50117,48401,31936,50916,52580
46095,SD,7128,10176,6849,9589,6547,4046,4966,10176,7340.101916,7958,9589,46237,169,-16296,2288,4348,49301,46406,29941,48525,50585
46097,SD,7128,10176,6849,9589,6547,4046,4966,10176,7168.260065,7958,9589,46065,169,-16296,2288,4348,49301,46234,29769,48353,50413
46099,SD,9120,10176,6849,9589,6547,4046,5196,11619,6898.222871,7958,9904,49545,1075,-15390,3722,5254,51523,50620,34155,53267,54799
46101,SD,7128,10176,6849,9589,6547,4046,4966,10176,6947.320542,7958,9589,45844,169,-16296,2288,4348,49301,46013,29548,48132,50192
46103,SD,9312,10176,6849,9589,6547,4046,5218,12250,7266.455408,7958,9473,50305,1075,-15390,3722,5254,51737,51380,34915,54027,55559
46105,SD,7680,10176,6849,9589,6547,4046,5030,10176,7094.613557,7958,9589,46544,396,-16069,2647,4575,49917,46940,30475,49191,51119
46107,SD,7128,10176,6849,9589,6547,4046,4966,10176,7070.064722,7958,9589,45967,169,-16296,2288,4348,49301,46136,29671,48255,50315
46109,SD,7128,10176,6849,9589,6547,4046,4966,10176,7070.064722,7958,9589,45967,169,-16296,2288,4348,49301,46136,29671,48255,50315
46111,SD,7128,10176,6849,9589,6547,4046,4966,10176,6971.869378,7958,9589,45869,169,-16296,2288,4348,49301,46038,29573,48157,50217
46113,SD,7128,10176,6849,9589,6547,4046,4966,10176,7241.906572,7958,9589,46139,169,-16296,2288,4348,49301,46308,29843,48427,50487
46115,SD,7128,10176,6849,9589,6547,4046,4966,10176,7045.515886,7958,9589,45943,169,-16296,2288,4348,49301,46112,29647,48231,50291
46117,SD,8460,10176,6849,9589,6547,4046,5119,12011,7143.711229,7958,9695,49314,1075,-15390,3722,5254,50786,50389,33924,53036,54568
46119,SD,8184,10176,6849,9589,6547,4046,5088,10604,7070.064722,7958,9685,47547,622,-15843,3005,4801,50479,48169,31704,50552,52348
46121,SD,7128,10176,6849,9589,6547,4046,4966,10176,6947.320542,7958,9589,45844,169,-16296,2288,4348,49301,46013,29548,48132,50192
46123,SD,7128,10176,6849,9589,6547,4046,4966,10176,7020.96705,7958,9589,45918,169,-16296,2288,4348,49301,46087,29622,48206,50266
46125,SD,9120,10176,6849,9589,6547,4046,5196,9641,6947.320542,7958,9851,47563,622,-15843,3005,4801,51523,48185,31720,50568,52364
46127,SD,8352,10176,6849,9589,6547,4046,5107,11321,6800.027527,7958,9639,48115,849,-15616,3364,5028,50666,48964,32499,51479,53143
46129,SD,7128,10176,6849,9589,6547,4046,4966,10176,7094.613557,7958,9589,45992,169,-16296,2288,4348,49301,46161,29696,48280,50340
46135,SD,7128,10176,6849,9589,6547,4046,4966,10990,7020.96705,7958,9390,46533,396,-16069,2647,4575,49301,46929,30464,49180,51108
46137,SD,7128,10176,6849,9589,6547,4046,4966,10176,7217.357737,7958,9589,46114,169,-16296,2288,4348,49301,46283,29818,48402,50462
47001,TN,9288,14523,6704,9859,5990,4284,7494,14203,7449.025054,7138,9344,51706,8296,-12237,7007,8407,58142,60002,39469,58713,60113
47003,TN,7392,14523,6704,9859,5990,4284,7162,13514,6872.32634,7138,9526,48727,7723,-12810,6170,7834,55914,56450,35917,54897,56561
47005,TN,6756,14523,6704,9859,5990,4284,7050,14523,6920.384566,7138,9859,49480,8009,-12524,6588,8120,55166,57489,36956,56068,57600
47007,TN,6756,14523,6704,9859,5990,4284,7050,14523,7040.530132,7138,9859,49601,8009,-12524,6588,8120,55166,57610,37077,56189,57721
47009,TN,9288,14523,6704,9859,5990,4284,7494,14194,7424.995941,7138,9343,51672,8296,-12237,7007,8407,58142,59968,39435,58679,60079
47011,TN,7788,14523,6704,9859,5990,4284,7231,13930,6776.209888,7138,9304,49220,8009,-12524,6588,8120,56379,57229,36696,55808,57340
47013,TN,6756,14523,6704,9859,5990,4284,7050,13112,6992.471905,7138,9357,47640,7436,-13097,5751,7547,55166,55076,34543,53391,55187
47015,TN,10212,14523,6704,9859,5990,4284,7656,13254,6728.151662,7138,9872,51488,8296,-12237,7007,8407,59228,59784,39251,58495,59895
47017,TN,6756,14523,6704,9859,5990,4284,7050,14523,6872.32634,7138,9859,49432,8009,-12524,6588,8120,55166,57441,36908,56020,57552
47019,TN,7752,14523,6704,9859,5990,4284,7225,13703,7136.646584,7138,8745,48759,7723,-12810,6170,7834,56337,56482,35949,54929,56593
47021,TN,10212,14523,6704,9859,5990,4284,7656,13714,7088.588358,7138,9872,52309,8296,-12237,7007,8407,59228,60605,40072,59316,60716
47023,TN,8220,14523,6704,9859,5990,4284,7307,13339,6848.297227,7138,9438,49267,8009,-12524,6588,8120,56887,57276,36743,55855,57387
47025,TN,6756,14523,6704,9859,5990,4284,7050,14523,6583.976983,7138,9859,49144,8009,-12524,6588,8120,55166,57153,36620,55732,57264
47027,TN,6756,14523,6704,9859,5990,4284,7050,14523,6632.035209,7138,9859,49192,8009,-12524,6588,8120,55166,57201,36668,55780,57312
47029,TN,6756,14523,6704,9859,5990,4284,7050,14486,6848.297227,7138,8316,47829,7436,-13097,5751,7547,55166,55265,34732,53580,55376
47031,TN,7380,14523,6704,9859,5990,4284,7160,13971,7064.559245,7138,9153,48991,7723,-12810,6170,7834,55900,56714,36181,55161,56825
47033,TN,6984,14523,6704,9859,5990,4284,7090,12086,6848.297227,7138,9443,46783,7150,-13383,5333,7261,55434,53933,33400,52116,54044
47035,TN,7056,14523,6704,9859,5990,4284,7103,13532,7232.763036,7138,8480,47723,7436,-13097,5751,7547,55519,55159,34626,53474,55270
47037,TN,10212,14523,6704,9859,5990,4284,7656,17417,6992.471905,7138,9876,55920,9442,-11091,8681,9553,59228,65362,44829,64601,65473
47039,TN,6756,14523,6704,9859,5990,4284,7050,14523,6920.384566,7138,9859,49480,8009,-12524,6588,8120,55166,57489,36956,56068,57600
47041,TN,6756,14523,6704,9859,5990,4284,7050,14523,6608.006096,7138,9859,49168,8009,-12524,6588,8120,55166,57177,36644,55756,57288
47043,TN,10212,14523,6704,9859,5990,4284,7656,13988,6343.685852,7138,9872,51838,8869,-11664,7844,8980,59228,60707,40174,59682,60818
47045,TN,6924,14523,6704,9859,5990,4284,7080,12681,6824.268114,7138,8947,46799,7150,-13383,5333,7261,55364,53949,33416,52132,54060
47047,TN,9360,14523,6704,9859,5990,4284,7507,13911,7232.763036,7138,9774,51700,8296,-12237,7007,8407,58227,59996,39463,58707,60107
47049,TN,6756,14523,6704,9859,5990,4284,7050,14523,6752.180775,7138,9859,49312,8009,-12524,6588,8120,55166,57321,36788,55900,57432
47051,TN,6996,14523,6704,9859,5990,4284,7093,12659,6944.413679,7138,9184,47206,7150,-13383,5333,7261,55449,54356,33823,52539,54467
47053,TN,6756,14523,6704,9859,5990,4284,7050,14523,7016.501018,7138,9859,49577,8009,-12524,6588,8120,55166,57586,37053,56165,57697
47055,TN,7428,14523,6704,9859,5990,4284,7168,14523,6896.355453,7138,9859,50128,8009,-12524,6588,8120,55956,58137,37604,56716,58248
47057,TN,7644,14523,6704,9859,5990,4284,7206,14105,7497.08328,7138,9369,50038,8009,-12524,6588,8120,56210,58047,37514,56626,58158
47059,TN,7008,14523,6704,9859,5990,4284,7095,13891,6872.32634,7138,8550,47743,7436,-13097,5751,7547,55463,55179,34646,53494,55290
47061,TN,6756,14523,6704,9859,5990,4284,7050,14523,7064.559245,7138,9859,49625,8009,-12524,6588,8120,55166,57634,37101,56213,57745
47063,TN,7644,14523,6704,9859,5990,4284,7206,13411,6824.268114,7138,8945,48246,7723,-12810,6170,7834,56210,55969,35436,54416,56080
47065,TN,8148,14523,6704,9859,5990,4284,7294,14673,7160.675697,7138,9486,50890,8296,-12237,7007,8407,56802,59186,38653,57897,59297
47067,TN,6756,14523,6704,9859,5990,4284,7050,14523,6824.268114,7138,9859,49384,8009,-12524,6588,8120,55166,57393,36860,55972,57504
47069,TN,6756,14523,6704,9859,5990,4284,7050,14523,6896.355453,7138,9859,49456,8009,-12524,6588,8120,55166,57465,36932,56044,57576
47071,TN,6756,14523,6704,9859,5990,4284,7050,14523,6824.268114,7138,9859,49384,8009,-12524,6588,8120,55166,57393,36860,55972,57504
47073,TN,7404,14523,6704,9859,5990,4284,7164,13783,6872.32634,7138,8774,48255,7723,-12810,6170,7834,55928,55978,35445,54425,56089
47075,TN,7656,14523,6704,9859,5990,4284,7208,14523,6896.355453,7138,9859,50356,8296,-12237,7007,8407,56224,58652,38119,57363,58763
47077,TN,6780,14523,6704,9859,5990,4284,7055,14523,6992.471905,7138,9859,49576,8009,-12524,6588,8120,55195,57585,37052,56164,57696
47079,TN,6948,14523,6704,9859,5990,4284,7084,13841,6776.209888,7138,8598,47586,7436,-13097,5751,7547,55392,55022,34489,53337,55133
47081,TN,7584,14523,6704,9859,5990,4284,7196,14154,7328.879488,7138,9871,50361,8009,-12524,6588,8120,56140,58370,37837,56949,58481
47083,TN,6756,14523,6704,9859,5990,4284,7050,14523,6728.151662,7138,9859,49288,8009,-12524,6588,8120,55166,57297,36764,55876,57408
47085,TN,6756,14523,6704,9859,5990,4284,7050,14523,6583.976983,7138,9859,49144,8009,-12524,6588,8120,55166,57153,36620,55732,57264
47087,TN,6756,14523,6704,9859,5990,4284,7050,13541,6680.093435,7138,8663,47062,7436,-13097,5751,7547,55166,54498,33965,52813,54609
47089,TN,7644,14523,6704,9859,5990,4284,7206,14548,7208.733923,7138,8969,49792,8009,-12524,6588,8120,56210,57801,37268,56380,57912
47091,TN,6756,14523,6704,9859,5990,4284,7050,14523,7184.70481,7138,9859,49745,8009,-12524,6588,8120,55166,57754,37221,56333,57865
47093,TN,9288,14523,6704,9859,5990,4284,7494,15233,7112.617471,7138,9343,52398,8296,-12237,7007,8407,58142,60694,40161,59405,60805
47095,TN,6756,14523,6704,9859,5990,4284,7050,14523,6247.5694,7138,9859,48808,8009,-12524,6588,8120,55166,56817,36284,55396,56928
47097,TN,6756,14523,6704,9859,5990,4284,7050,14523,6680.093435,7138,9859,49240,8009,-12524,6588,8120,55166,57249,36716,55828,57360
47099,TN,6756,14523,6704,9859,5990,4284,7050,13031,6632.035209,7138,8962,46802,7150,-13383,5333,7261,55166,53952,33419,52135,54063
47101,TN,6756,14523,6704,9859,5990,4284,7050,14523,6704.122548,7138,9859,49264,8009,-12524,6588,8120,55166,57273,36740,55852,57384
47103,TN,6756,14523,6704,9859,5990,4284,7050,14523,6992.471905,7138,9859,49552,8009,-12524,6588,8120,55166,57561,37028,56140,57672
47105,TN,9288,14523,6704,9859,5990,4284,7494,14126,7280.821262,7138,9357,51474,8296,-12237,7007,8407,58142,59770,39237,58481,59881
47107,TN,7020,14523,6704,9859,5990,4284,7097,13868,7112.617471,7138,8910,48333,7436,-13097,5751,7547,55477,55769,35236,54084,55880
47109,TN,6756,14523,6704,9859,5990,4284,7050,14523,6704.122548,7138,9859,49264,8009,-12524,6588,8120,55166,57273,36740,55852,57384
47111,TN,6756,14523,6704,9859,5990,4284,7050,13572,6872.32634,7138,9872,48495,7723,-12810,6170,7834,55166,56218,35685,54665,56329
47113,TN,8220,14523,6704,9859,5990,4284,7307,13581,6824.268114,7138,9401,49448,8009,-12524,6588,8120,56887,57457,36924,56036,57568
47115,TN,8148,14523,6704,9859,5990,4284,7294,13393,7016.501018,7138,9508,49487,8009,-12524,6588,8120,56802,57496,36963,56075,57607
47117,TN,7812,14523,6704,9859,5990,4284,7235,13017,6752.180775,7138,9532,48535,7723,-12810,6170,7834,56407,56258,35725,54705,56369
47119,TN,7416,14523,6704,9859,5990,4284,7166,13872,6728.151662,7138,9873,49311,8009,-12524,6588,8120,55942,57320,36787,55899,57431
47121,TN,6756,14523,6704,9859,5990,4284,7050,14523,7064.559245,7138,9859,49625,8009,-12524,6588,8120,55166,57634,37101,56213,57745
47123,TN,6756,14523,6704,9859,5990,4284,7050,14523,7232.763036,7138,9859,49793,8009,-12524,6588,8120,55166,57802,37269,56381,57913
47125,TN,9204,14523,6704,9859,5990,4284,7479,14261,6800.239001,7138,9713,51401,8296,-12237,7007,8407,58043,59697,39164,58408,59808
47127,TN,7212,14523,6704,9859,5990,4284,7130,12225,6944.413679,7138,9214,47017,7150,-13383,5333,7261,55702,54167,33634,52350,54278
47129,TN,6756,14523,6704,9859,5990,4284,7050,14069,7473.054167,7138,9386,49106,7723,-12810,6170,7834,55166,56829,36296,55276,56940
47131,TN,6756,14523,6704,9859,5990,4284,7050,12932,6848.297227,7138,8766,46724,7150,-13383,5333,7261,55166,53874,33341,52057,53985
47133,TN,6756,14523,6704,9859,5990,4284,7050,13295,7521.112393,7138,8644,47639,7150,-13383,5333,7261,55166,54789,34256,52972,54900
47135,TN,6756,14523,6704,9859,5990,4284,7050,14523,6992.471905,7138,9859,49552,8009,-12524,6588,8120,55166,57561,37028,56140,57672
47137,TN,6756,14523,6704,9859,5990,4284,7050,14523,6632.035209,7138,9859,49192,8009,-12524,6588,8120,55166,57201,36668,55780,57312
47139,TN,7788,14523,6704,9859,5990,4284,7231,13393,6824.268114,7138,9355,48782,7723,-12810,6170,7834,56379,56505,35972,54952,56616
47141,TN,7176,14523,6704,9859,5990,4284,7124,14101,6559.94787,7138,8554,47812,7436,-13097,5751,7547,55660,55248,34715,53563,55359
47143,TN,6756,14523,6704,9859,5990,4284,7050,14285,7160.675697,7138,8800,48423,7436,-13097,5751,7547,55166,55859,35326,54174,55970
47145,TN,7296,14523,6704,9859,5990,4284,7145,13939,7136.646584,7138,9353,49146,7723,-12810,6170,7834,55801,56869,36336,55316,56980
47147,TN,10212,14523,6704,9859,5990,4284,7656,13415,6487.860531,7138,9872,51409,8296,-12237,7007,8407,59228,59705,39172,58416,59816
47149,TN,10212,14523,6704,9859,5990,4284,7656,14843,6824.268114,7138,9873,53175,8869,-11664,7844,8980,59228,62044,41511,61019,62155
47151,TN,6756,14523,6704,9859,5990,4284,7050,14523,7040.530132,7138,9859,49601,8009,-12524,6588,8120,55166,57610,37077,56189,57721
47153,TN,8148,14523,6704,9859,5990,4284,7294,13899,6944.413679,7138,9504,49918,8009,-12524,6588,8120,56802,57927,37394,56506,58038
47155,TN,8676,14523,6704,9859,5990,4284,7387,14723,7473.054167,7138,9503,51797,8296,-12237,7007,8407,57423,60093,39560,58804,60204
47157,TN,9360,14523,6704,9859,5990,4284,7507,15429,6704.122548,7138,9778,52693,8869,-11664,7844,8980,58227,61562,41029,60537,61673
47159,TN,6876,14523,6704,9859,5990,4284,7071,13805,6583.976983,7138,9872,48559,7723,-12810,6170,7834,55307,56282,35749,54729,56393
47161,TN,6756,14523,6704,9859,5990,4284,7050,14523,6752.180775,7138,9859,49312,8009,-12524,6588,8120,55166,57321,36788,55900,57432
47163,TN,7404,14523,6704,9859,5990,4284,7164,13742,7304.850375,7138,8764,48637,7723,-12810,6170,7834,55928,56360,35827,54807,56471
47165,TN,10212,14523,6704,9859,5990,4284,7656,14654,6583.976983,7138,9874,52746,8869,-11664,7844,8980,59228,61615,41082,60590,61726
47167,TN,9360,14523,6704,9859,5990,4284,7507,13665,6968.442792,7138,9773,51189,8296,-12237,7007,8407,58227,59485,38952,58196,59596
47169,TN,10212,14523,6704,9859,5990,4284,7656,13841,6559.94787,7138,9872,51907,8869,-11664,7844,8980,59228,60776,40243,59751,60887
47171,TN,7752,14523,6704,9859,5990,4284,7225,12856,7040.530132,7138,8751,47821,7436,-13097,5751,7547,56337,55257,34724,53572,55368
47173,TN,9288,14523,6704,9859,5990,4284,7494,14423,7136.646584,7138,9367,51637,8296,-12237,7007,8407,58142,59933,39400,58644,60044
47175,TN,6756,14523,6704,9859,5990,4284,7050,14523,6824.268114,7138,9859,49384,8009,-12524,6588,8120,55166,57393,36860,55972,57504
47177,TN,6756,14523,6704,9859,5990,4284,7050,12946,6800.239001,7138,8771,46696,7150,-13383,5333,7261,55166,53846,33313,52029,53957
47179,TN,7752,14523,6704,9859,5990,4284,7225,14942,7064.559245,7138,8733,49914,8009,-12524,6588,8120,56337,57923,37390,56502,58034
47181,TN,6756,14523,6704,9859,5990,4284,7050,14523,6680.093435,7138,9859,49240,8009,-12524,6588,8120,55166,57249,36716,55828,57360
47183,TN,6756,14523,6704,9859,5990,4284,7050,13237,7208.733923,7138,8645,47269,7150,-13383,5333,7261,55166,54419,33886,52602,54530
47185,TN,7128,14523,6704,9859,5990,4284,7116,14523,6704.122548,7138,9859,49636,8009,-12524,6588,8120,55604,57645,37112,56224,57756
47187,TN,10212,14523,6704,9859,5990,4284,7656,16859,7160.675697,7138,9874,55528,9442,-11091,8681,9553,59228,64970,44437,64209,65081
47189,TN,10212,14523,6704,9859,5990,4284,7656,14327,6487.860531,7138,9873,52323,8869,-11664,7844,8980,59228,61192,40659,60167,61303
48001,TX,8040,9153,6704,9859,6534,4284,5000,9670,6343.685852,6574,9364,44275,3783,-16596,1930,4048,49574,48058,27679,46205,48323
48003,TX,7644,9153,6704,9859,6534,4284,4954,9232,6223.540287,6574,10368,44325,3783,-16596,1930,4048,49132,48108,27729,46255,48373
48005,TX,8556,9153,6704,9859,6534,4284,5059,9549,6151.452948,6574,9546,44660,4083,-16296,2288,4348,50149,48743,28364,46948,49008
48007,TX,8424,9153,6704,9859,6534,4284,5044,10518,6007.278269,6574,9823,45630,4310,-16069,2647,4575,50002,49940,29561,48277,50205
48009,TX,8544,9153,6704,9859,6534,4284,5058,8916,6151.452948,6574,9586,44055,3783,-16596,1930,4048,50136,47838,27459,45985,48103
48011,TX,8832,9153,6704,9859,6534,4284,5091,8124,6583.976983,6574,9830,44228,3783,-16596,1930,4048,50457,48011,27632,46158,48276
48013,TX,8268,9153,6704,9859,6534,4284,5026,10066,6031.307382,6574,10072,45295,4083,-16296,2288,4348,49828,49378,28999,47583,49643
48015,TX,8400,9153,6704,9859,6534,4284,5041,10122,6776.209888,6574,10313,46470,4310,-16069,2647,4575,49975,50780,30401,49117,51045
48017,TX,7848,9153,6704,9859,6534,4284,4977,9153,6728.151662,6574,9859,44446,3783,-16596,1930,4048,49359,48229,27850,46376,48494
48019,TX,10284,9153,6704,9859,6534,4284,5258,10257,6848.297227,6574,10070,48318,4763,-15616,3364,5028,52076,53081,32702,51682,53346
48021,TX,12888,9153,6704,9859,6534,4284,5558,10499,5694.899799,6574,10484,50424,5216,-15163,4081,5481,54980,55640,35261,54505,55905
48023,TX,7644,9153,6704,9859,6534,4284,4954,9153,6103.394722,6574,9859,43617,3783,-16596,1930,4048,49132,47400,27021,45547,47665
48025,TX,7932,9153,6704,9859,6534,4284,4987,9075,5358.492216,6574,9296,42520,3345,-17034,1571,3610,49453,45865,25486,44091,46130
48027,TX,8808,9153,6704,9859,6534,4284,5088,10142,5694.899799,6574,10180,45683,4310,-16069,2647,4575,50430,49993,29614,48330,50258
48029,TX,10284,9153,6704,9859,6534,4284,5258,10159,5911.161817,6574,10114,47327,4763,-15616,3364,5028,52076,52090,31711,50691,52355
48031,TX,9660,9153,6704,9859,6534,4284,5186,9153,6223.540287,6574,9859,45754,4310,-16069,2647,4575,51380,50064,29685,48401,50329
48033,TX,7836,9153,6704,9859,6534,4284,4976,9153,5887.132704,6574,9859,43593,3783,-16596,1930,4048,49346,47376,26997,45523,47641
48035,TX,7644,9153,6704,9859,6534,4284,4954,9153,5791.016252,6574,9859,43305,3783,-16596,1930,4048,49132,47088,26709,45235,47353
48037,TX,8448,9153,6704,9859,6534,4284,5047,9559,6055.336495,6574,9369,44289,3783,-16596,1930,4048,50029,48072,27693,46219,48337
48039,TX,9936,9153,6704,9859,6534,4284,5218,10608,6391.744078,6574,10353,48147,4763,-15616,3364,5028,51688,52910,32531,51511,53175
48041,TX,10416,9153,6704,9859,6534,4284,5273,11023,6175.482061,6574,9238,47710,4763,-15616,3364,5028,52223,52473,32094,51074,52738
48043,TX,8916,9153,6704,9859,6534,4284,5100,9153,6800.239001,6574,9859,45586,4083,-16296,2288,4348,50550,49669,29290,47874,49934
48045,TX,7644,9153,6704,9859,6534,4284,4954,9153,6487.860531,6574,9859,44002,3783,-16596,1930,4048,49132,47785,27406,45932,48050
48047,TX,7644,9153,6704,9859,6534,4284,4954,9153,5310.43399,6574,9859,42824,3783,-16596,1930,4048,49132,46607,26228,44754,46872
48049,TX,8028,9153,6704,9859,6534,4284,4998,9332,6415.773192,6574,9105,43740,3783,-16596,1930,4048,49560,47523,27144,45670,47788
48051,TX,10416,9153,6704,9859,6534,4284,5273,9677,6199.511174,6574,9254,46404,4310,-16069,2647,4575,52223,50714,30335,49051,50979
48053,TX,8184,9153,6704,9859,6534,4284,5016,9153,5935.19093,6574,9859,43989,3783,-16596,1930,4048,49734,47772,27393,45919,48037
48055,TX,12888,9153,6704,9859,6534,4284,5558,10255,5310.43399,6574,10508,49820,5216,-15163,4081,5481,54980,55036,34657,53901,55301
48057,TX,8520,9153,6704,9859,6534,4284,5055,9506,5574.754234,6574,9640,44099,4083,-16296,2288,4348,50109,48182,27803,46387,48447
48059,TX,9480,9153,6704,9859,6534,4284,5165,9349,6031.307382,6574,9549,45268,4083,-16296,2288,4348,51179,49351,28972,47556,49616
48061,TX,8112,9153,6704,9859,6534,4284,5008,9481,5070.142859,6574,9481,43003,3783,-16596,1930,4048,49654,46786,26407,44933,47051
48063,TX,7644,9153,6704,9859,6534,4284,4954,9153,6391.744078,6574,9859,43906,3783,-16596,1930,4048,49132,47689,27310,45836,47954
48065,TX,8832,9153,6704,9859,6534,4284,5091,8698,6583.976983,6574,9831,44803,3783,-16596,1930,4048,50457,48586,28207,46733,48851
48067,TX,7644,9153,6704,9859,6534,4284,4954,9153,6415.773192,6574,9859,43930,3783,-16596,1930,4048,49132,47713,27334,45860,47978
48069,TX,7644,9153,6704,9859,6534,4284,4954,9153,6848.297227,6574,9859,44362,3783,-16596,1930,4048,49132,48145,27766,46292,48410
48071,TX,11112,9153,6704,9859,6534,4284,5353,10360,7424.995941,6574,10318,50072,4989,-15390,3722,5254,52999,55061,34682,53794,55326
48073,TX,7644,9153,6704,9859,6534,4284,4954,9429,6319.656739,6574,9086,43336,3345,-17034,1571,3610,49132,46681,26302,44907,46946
48075,TX,7968,9153,6704,9859,6534,4284,4991,9153,6535.918757,6574,9859,44374,3783,-16596,1930,4048,49493,48157,27778,46304,48422
48077,TX,8544,9153,6704,9859,6534,4284,5058,8879,6055.336495,6574,9583,43919,3783,-16596,1930,4048,50136,47702,27323,45849,47967
48079,TX,7644,9153,6704,9859,6534,4284,4954,9153,6487.860531,6574,9859,44002,3783,-16596,1930,4048,49132,47785,27406,45932,48050
48081,TX,7644,9153,6704,9859,6534,4284,4954,9153,5887.132704,6574,9859,43401,3783,-16596,1930,4048,49132,47184,26805,45331,47449
48083,TX,7644,9153,6704,9859,6534,4284,4954,9153,6007.278269,6574,9859,43521,3783,-16596,1930,4048,49132,47304,26925,45451,47569
48085,TX,10956,9153,6704,9859,6534,4284,5335,11442,6920.384566,6574,10277,50454,5216,-15163,4081,5481,52825,55670,35291,54535,55935
48087,TX,7644,9153,6704,9859,6534,4284,4954,9153,6608.006096,6574,9859,44122,3783,-16596,1930,4048,49132,47905,27526,46052,48170
48089,TX,7644,9153,6704,9859,6534,4284,4954,9153,5718.928912,6574,9859,43233,3783,-16596,1930,4048,49132,47016,26637,45163,47281
48091,TX,10284,9153,6704,9859,6534,4284,5258,10592,6535.918757,6574,10081,48350,4763,-15616,3364,5028,52076,53113,32734,51714,53378
48093,TX,7644,9153,6704,9859,6534,4284,4954,9153,6295.627626,6574,9859,43810,3783,-16596,1930,4048,49132,47593,27214,45740,47858
48095,TX,12204,9153,6704,9859,6534,4284,5479,9153,5935.19093,6574,9859,48009,4763,-15616,3364,5028,54217,52772,32393,51373,53037
48097,TX,9756,9153,6704,9859,6534,4284,5197,9531,7040.530132,6574,9760,46946,4310,-16069,2647,4575,51487,51256,30877,49593,51521
48099,TX,8808,9153,6704,9859,6534,4284,5088,9764,5911.161817,6574,10158,45499,4310,-16069,2647,4575,50430,49809,29430,48146,50074
48101,TX,7644,9153,6704,9859,6534,4284,4954,9153,6535.918757,6574,9859,44050,3783,-16596,1930,4048,49132,47833,27454,45980,48098
48103,TX,8952,9153,6704,9859,6534,4284,5105,9153,6127.423835,6574,9859,44949,4083,-16296,2288,4348,50591,49032,28653,47237,49297
48105,TX,7644,9153,6704,9859,6534,4284,4954,9153,5574.754234,6574,9859,43089,3783,-16596,1930,4048,49132,46872,26493,45019,47137
48107,TX,9288,9153,6704,9859,6534,4284,5143,8031,6367.714965,6574,9690,44234,3783,-16596,1930,4048,50965,48017,27638,46164,48282
48109,TX,7644,9153,6704,9859,6534,4284,4954,9153,6271.598513,6574,9859,43786,3783,-16596,1930,4048,49132,47569,27190,45716,47834
48111,TX,7644,9153,6704,9859,6534,4284,4954,9153,6535.918757,6574,9859,44050,3783,-16596,1930,4048,49132,47833,27454,45980,48098
48113,TX,10956,9153,6704,9859,6534,4284,5335,11110,6559.94787,6574,10311,49795,4989,-15390,3722,5254,52825,54784,34405,53517,55049
48115,TX,7644,9153,6704,9859,6534,4284,4954,8135,6247.5694,6574,8775,41659,2906,-17473,1213,3171,49132,44565,24186,42872,44830
48117,TX,7656,9153,6704,9859,6534,4284,4955,8912,6583.976983,6574,9892,43901,3783,-16596,1930,4048,49145,47684,27305,45831,47949
48119,TX,10956,9153,6704,9859,6534,4284,5335,9153,6511.889644,6574,9859,47338,4536,-15843,3005,4801,52825,51874,31495,50343,52139
48121,TX,10956,9153,6704,9859,6534,4284,5335,11238,6896.355453,6574,10285,50234,5216,-15163,4081,5481,52825,55450,35071,54315,55715
48123,TX,7644,9153,6704,9859,6534,4284,4954,9153,5118.201085,6574,9859,42632,3783,-16596,1930,4048,49132,46415,26036,44562,46680
48125,TX,7644,9153,6704,9859,6534,4284,4954,9153,6367.714965,6574,9859,43882,3783,-16596,1930,4048,49132,47665,27286,45812,47930
48127,TX,7644,9153,6704,9859,6534,4284,4954,9153,5022.084633,6574,9859,42536,3783,-16596,1930,4048,49132,46319,25940,44466,46584
48129,TX,7644,9153,6704,9859,6534,4284,4954,9153,6776.209888,6574,9859,44290,3783,-16596,1930,4048,49132,48073,27694,46220,48338
48131,TX,8496,9153,6704,9859,6534,4284,5052,9153,5382.521329,6574,9859,43749,4083,-16296,2288,4348,50082,47832,27453,46037,48097
48133,TX,7644,9153,6704,9859,6534,4284,4954,9153,6319.656739,6574,9859,43834,3783,-16596,1930,4048,49132,47617,27238,45764,47882
48135,TX,11904,9153,6704,9859,6534,4284,5445,10150,5983.249156,6574,10104,48999,4989,-15390,3722,5254,53883,53988,33609,52721,54253
48137,TX,7644,9153,6704,9859,6534,4284,4954,9153,5574.754234,6574,9859,43089,3783,-16596,1930,4048,49132,46872,26493,45019,47137
48139,TX,10956,9153,6704,9859,6534,4284,5335,10063,6223.540287,6574,10244,48345,4763,-15616,3364,5028,52825,53108,32729,51709,53373
48141,TX,8964,9153,6704,9859,6534,4284,5106,9632,6103.394722,6574,9953,45510,4310,-16069,2647,4575,50604,49820,29441,48157,50085
48143,TX,8328,9153,6704,9859,6534,4284,5033,9998,6127.423835,6574,9221,44533,4083,-16296,2288,4348,49895,48616,28237,46821,48881
48145,TX,7812,9153,6704,9859,6534,4284,4973,8836,5670.870686,6574,9603,42780,3345,-17034,1571,3610,49319,46125,25746,44351,46390
48147,TX,7824,9153,6704,9859,6534,4284,4975,9153,6415.773192,6574,9859,44110,3783,-16596,1930,4048,49333,47893,27514,46040,48158
48149,TX,7920,9153,6704,9859,6534,4284,4986,9153,5622.81246,6574,9859,43413,3783,-16596,1930,4048,49440,47196,26817,45343,47461
48151,TX,7644,9153,6704,9859,6534,4284,4954,9153,5959.220043,6574,9859,43473,3783,-16596,1930,4048,49132,47256,26877,45403,47521
48153,TX,7644,9153,6704,9859,6534,4284,4954,9153,6367.714965,6574,9859,43882,3783,-16596,1930,4048,49132,47665,27286,45812,47930
48155,TX,7644,9153,6704,9859,6534,4284,4954,9153,6704.122548,6574,9859,44218,3783,-16596,1930,4048,49132,48001,27622,46148,48266
48157,TX,11112,9153,6704,9859,6534,4284,5353,10759,6463.831418,6574,10345,49538,4989,-15390,3722,5254,52999,54527,34148,53260,54792
48159,TX,7644,9153,6704,9859,6534,4284,4954,9153,6439.802305,6574,9859,43954,3783,-16596,1930,4048,49132,47737,27358,45884,48002
48161,TX,9420,9153,6704,9859,6534,4284,5159,9153,6127.423835,6574,9859,45417,4083,-16296,2288,4348,51113,49500,29121,47705,49765
48163,TX,7644,9153,6704,9859,6534,4284,4954,9153,5911.161817,6574,9859,43425,3783,-16596,1930,4048,49132,47208,26829,45355,47473
48165,TX,7668,9153,6704,9859,6534,4284,4957,9153,6223.540287,6574,9859,43762,3783,-16596,1930,4048,49159,47545,27166,45692,47810
48167,TX,11112,9153,6704,9859,6534,4284,5353,10501,6752.180775,6574,10363,49586,4989,-15390,3722,5254,52999,54575,34196,53308,54840
48169,TX,7644,9153,6704,9859,6534,4284,4954,9153,6367.714965,6574,9859,43882,3783,-16596,1930,4048,49132,47665,27286,45812,47930
48171,TX,10500,9153,6704,9859,6534,4284,5283,10106,6079.365608,6574,9482,47026,4536,-15843,3005,4801,52317,51562,31183,50031,51827
48173,TX,7836,9153,6704,9859,6534,4284,4976,9612,6079.365608,6574,9503,43889,3783,-16596,1930,4048,49346,47672,27293,45819,47937
48175,TX,8772,9153,6704,9859,6534,4284,5084,9437,5622.81246,6574,9884,44573,4083,-16296,2288,4348,50390,48656,28277,46861,48921
48177,TX,7644,9153,6704,9859,6534,4284,4954,9153,6031.307382,6574,9859,43545,3783,-16596,1930,4048,49132,47328,26949,45475,47593
48179,TX,7644,9153,6704,9859,6534,4284,4954,8637,6824.268114,6574,9262,43226,3345,-17034,1571,3610,49132,46571,26192,44797,46836
48181,TX,9672,9153,6704,9859,6534,4284,5188,9568,6247.5694,6574,9509,45855,4310,-16069,2647,4575,51394,50165,29786,48502,50430
48183,TX,9576,9153,6704,9859,6534,4284,5177,9807,6319.656739,6574,9650,46211,4310,-16069,2647,4575,51287,50521,30142,48858,50786
48185,TX,7644,9153,6704,9859,6534,4284,4954,9153,6800.239001,6574,9859,44314,3783,-16596,1930,4048,49132,48097,27718,46244,48362
48187,TX,10284,9153,6704,9859,6534,4284,5258,9959,6127.423835,6574,10083,47311,4536,-15843,3005,4801,52076,51847,31468,50316,52112
48189,TX,7644,9153,6704,9859,6534,4284,4954,8575,6439.802305,6574,9575,43092,3345,-17034,1571,3610,49132,46437,26058,44663,46702
48191,TX,7644,9153,6704,9859,6534,4284,4954,9153,6535.918757,6574,9859,44050,3783,-16596,1930,4048,49132,47833,27454,45980,48098
48193,TX,7644,9153,6704,9859,6534,4284,4954,9153,5839.074478,6574,9859,43353,3783,-16596,1930,4048,49132,47136,26757,45283,47401
48195,TX,7644,9153,6704,9859,6534,4284,4954,9153,6535.918757,6574,9859,44050,3783,-16596,1930,4048,49132,47833,27454,45980,48098
48197,TX,7740,9153,6704,9859,6534,4284,4965,9153,6463.831418,6574,9859,44074,3783,-16596,1930,4048,49239,47857,27478,46004,48122
48199,TX,9672,9153,6704,9859,6534,4284,5188,9930,6223.540287,6574,9469,46152,4310,-16069,2647,4575,51394,50462,30083,48799,50727
48201,TX,11112,9153,6704,9859,6534,4284,5353,11073,6391.744078,6574,10404,49839,5216,-15163,4081,5481,52999,55055,34676,53920,55320
48203,TX,7644,9153,6704,9859,6534,4284,4954,9793,6343.685852,6574,9736,44374,3783,-16596,1930,4048,49132,48157,27778,46304,48422
48205,TX,7644,9153,6704,9859,6534,4284,4954,9153,6511.889644,6574,9859,44026,3783,-16596,1930,4048,49132,47809,27430,45956,48074
48207,TX,7644,9153,6704,9859,6534,4284,4954,9153,6704.122548,6574,9859,44218,3783,-16596,1930,4048,49132,48001,27622,46148,48266
48209,TX,12888,9153,6704,9859,6534,4284,5558,11016,6175.482061,6574,10514,51452,5216,-15163,4081,5481,54980,56668,36289,55533,56933
48211,TX,8412,9153,6704,9859,6534,4284,5042,9153,6728.151662,6574,9859,45010,3783,-16596,1930,4048,49988,48793,28414,46940,49058
48213,TX,8232,9153,6704,9859,6534,4284,5022,10087,6367.714965,6574,9234,44779,4083,-16296,2288,4348,49788,48862,28483,47067,49127
48215,TX,7860,9153,6704,9859,6534,4284,4979,9512,5142.230198,6574,9695,43067,3783,-16596,1930,4048,49373,46850,26471,44997,47115
48217,TX,8400,9153,6704,9859,6534,4284,5041,9153,6583.976983,6574,9859,44854,3783,-16596,1930,4048,49975,48637,28258,46784,48902
48219,TX,8532,9153,6704,9859,6534,4284,5056,9066,6415.773192,6574,9995,44866,4083,-16296,2288,4348,50122,48949,28570,47154,49214
48221,TX,10248,9153,6704,9859,6534,4284,5254,10613,6824.268114,6574,10250,48793,4763,-15616,3364,5028,52036,53556,33177,52157,53821
48223,TX,8460,9153,6704,9859,6534,4284,5048,9330,6439.802305,6574,9436,44524,3783,-16596,1930,4048,50042,48307,27928,46454,48572
48225,TX,7860,9153,6704,9859,6534,4284,4979,9153,5622.81246,6574,9859,43353,3783,-16596,1930,4048,49373,47136,26757,45283,47401
48227,TX,7848,9153,6704,9859,6534,4284,4977,8881,5839.074478,6574,9425,42851,3345,-17034,1571,3610,49359,46196,25817,44422,46461
48229,TX,7644,9153,6704,9859,6534,4284,4954,9568,6247.5694,6574,9887,44205,3783,-16596,1930,4048,49132,47988,27609,46135,48253
48231,TX,10956,9153,6704,9859,6534,4284,5335,10015,6511.889644,6574,10249,48591,4763,-15616,3364,5028,52825,53354,32975,51955,53619
48233,TX,8520,9153,6704,9859,6534,4284,5055,8747,6920.384566,6574,9501,44546,3783,-16596,1930,4048,50109,48329,27950,46476,48594
48235,TX,8760,9153,6704,9859,6534,4284,5083,8660,5815.045365,6574,9628,43721,3783,-16596,1930,4048,50377,47504,27125,45651,47769
48237,TX,7992,9153,6704,9859,6534,4284,4994,9153,6920.384566,6574,9859,44782,3783,-16596,1930,4048,49520,48565,28186,46712,48830
48239,TX,9024,9153,6704,9859,6534,4284,5113,9153,5598.783347,6574,9859,44493,4083,-16296,2288,4348,50671,48576,28197,46781,48841
48241,TX,8724,9153,6704,9859,6534,4284,5078,9153,6127.423835,6574,9859,44721,4083,-16296,2288,4348,50336,48804,28425,47009,49069
48243,TX,7644,9153,6704,9859,6534,4284,4954,9153,6872.32634,6574,9859,44386,3783,-16596,1930,4048,49132,48169,27790,46316,48434
48245,TX,9672,9153,6704,9859,6534,4284,5188,9560,5863.103591,6574,9441,45395,4310,-16069,2647,4575,51394,49705,29326,48042,49970
48247,TX,7644,9153,6704,9859,6534,4284,4954,9153,5142.230198,6574,9859,42656,3783,-16596,1930,4048,49132,46439,26060,44586,46704
48249,TX,9120,9153,6704,9859,6534,4284,5124,9466,5358.492216,6574,9722,44524,4083,-16296,2288,4348,50778,48607,28228,46812,48872
48251,TX,11256,9153,6704,9859,6534,4284,5370,10155,5670.870686,6574,10249,48189,4989,-15390,3722,5254,53160,53178,32799,51911,53443
48253,TX,9480,9153,6704,9859,6534,4284,5165,8548,7016.501018,6574,9556,45458,4083,-16296,2288,4348,51179,49541,29162,47746,49806
48255,TX,7644,9153,6704,9859,6534,4284,4954,9153,5959.220043,6574,9859,43473,3783,-16596,1930,4048,49132,47256,26877,45403,47521
48257,TX,10956,9153,6704,9859,6534,4284,5335,10120,6800.239001,6574,10240,48974,4763,-15616,3364,5028,52825,53737,33358,52338,54002
48259,TX,10128,9153,6704,9859,6534,4284,5240,11123,6511.889644,6574,10072,48694,4763,-15616,3364,5028,51902,53457,33078,52058,53722
48261,TX,8964,9153,6704,9859,6534,4284,5106,7687,5310.43399,6574,9600,42419,3345,-17034,1571,3610,50604,45764,25385,43990,46029
48263,TX,9084,9153,6704,9859,6534,4284,5120,9153,6511.889644,6574,9859,45466,4083,-16296,2288,4348,50738,49549,29170,47754,49814
48265,TX,9456,9153,6704,9859,6534,4284,5163,10076,6079.365608,6574,9103,45572,4310,-16069,2647,4575,51153,49882,29503,48219,50147
48267,TX,8088,9153,6704,9859,6534,4284,5005,9153,6079.365608,6574,9859,44037,3783,-16596,1930,4048,49627,47820,27441,45967,48085
48269,TX,7836,9153,6704,9859,6534,4284,4976,9153,6632.035209,6574,9859,44338,3783,-16596,1930,4048,49346,48121,27742,46268,48386
48271,TX,7644,9153,6704,9859,6534,4284,4954,9153,4974.026407,6574,9859,42488,3783,-16596,1930,4048,49132,46271,25892,44418,46536
48273,TX,8448,9153,6704,9859,6534,4284,5047,9505,5766.987138,6574,9559,44138,4083,-16296,2288,4348,50029,48221,27842,46426,48486
48275,TX,7644,9153,6704,9859,6534,4284,4954,9153,6632.035209,6574,9859,44146,3783,-16596,1930,4048,49132,47929,27550,46076,48194
48277,TX,7644,9153,6704,9859,6534,4284,4954,8865,6535.918757,6574,9286,43190,3345,-17034,1571,3610,49132,46535,26156,44761,46800
48279,TX,7644,9153,6704,9859,6534,4284,4954,9153,6367.714965,6574,9859,43882,3783,-16596,1930,4048,49132,47665,27286,45812,47930
48281,TX,7644,9153,6704,9859,6534,4284,4954,9658,6127.423835,6574,10134,44421,3783,-16596,1930,4048,49132,48204,27825,46351,48469
48283,TX,7644,9153,6704,9859,6534,4284,4954,9153,5238.346651,6574,9859,42752,3783,-16596,1930,4048,49132,46535,26156,44682,46800
48285,TX,7644,9153,6704,9859,6534,4284,4954,9153,5622.81246,6574,9859,43137,3783,-16596,1930,4048,49132,46920,26541,45067,47185
48287,TX,7644,9153,6704,9859,6534,4284,4954,9153,6439.802305,6574,9859,43954,3783,-16596,1930,4048,49132,47737,27358,45884,48002
48289,TX,7824,9153,6704,9859,6534,4284,4975,9153,6127.423835,6574,9859,43821,3783,-16596,1930,4048,49333,47604,27225,45751,47869
48291,TX,11112,9153,6704,9859,6534,4284,5353,10395,6031.307382,6574,10306,48702,4989,-15390,3722,5254,52999,53691,33312,52424,53956
48293,TX,9036,9153,6704,9859,6534,4284,5114,9153,5742.958025,6574,9859,44649,4083,-16296,2288,4348,50684,48732,28353,46937,48997
48295,TX,7644,9153,6704,9859,6534,4284,4954,9153,6632.035209,6574,9859,44146,3783,-16596,1930,4048,49132,47929,27550,46076,48194
48297,TX,7644,9153,6704,9859,6534,4284,4954,9153,5670.870686,6574,9859,43185,3783,-16596,1930,4048,49132,46968,26589,45115,47233
48299,TX,7644,9153,6704,9859,6534,4284,4954,9153,5887.132704,6574,9859,43401,3783,-16596,1930,4048,49132,47184,26805,45331,47449
48301,TX,7836,9153,6704,9859,6534,4284,4976,9153,7040.530132,6574,9859,44747,3783,-16596,1930,4048,49346,48530,28151,46677,48795
48303,TX,9288,9153,6704,9859,6534,4284,5143,9910,6367.714965,6574,9689,46113,4310,-16069,2647,4575,50965,50423,30044,48760,50688
48305,TX,7644,9153,6704,9859,6534,4284,4954,8760,6367.714965,6574,9692,43322,3345,-17034,1571,3610,49132,46667,26288,44893,46932
48307,TX,7644,9153,6704,9859,6534,4284,4954,9153,6391.744078,6574,9859,43906,3783,-16596,1930,4048,49132,47689,27310,45836,47954
48309,TX,9060,9153,6704,9859,6534,4284,5117,9789,5646.841573,6574,9622,44975,4310,-16069,2647,4575,50711,49285,28906,47622,49550
48311,TX,7836,9153,6704,9859,6534,4284,4976,9153,5766.987138,6574,9859,43473,3783,-16596,1930,4048,49346,47256,26877,45403,47521
48313,TX,7644,9153,6704,9859,6534,4284,4954,9153,6199.511174,6574,9859,43714,3783,-16596,1930,4048,49132,47497,27118,45644,47762
48315,TX,7644,9153,6704,9859,6534,4284,4954,9153,6511.889644,6574,9859,44026,3783,-16596,1930,4048,49132,47809,27430,45956,48074
48317,TX,7644,9153,6704,9859,6534,4284,4954,8848,6103.394722,6574,10645,44099,3783,-16596,1930,4048,49132,47882,27503,46029,48147
48319,TX,7644,9153,6704,9859,6534,4284,4954,9153,6007.278269,6574,9859,43521,3783,-16596,1930,4048,49132,47304,26925,45451,47569
48321,TX,8604,9153,6704,9859,6534,4284,5065,9488,5526.696008,6574,9625,44102,4083,-16296,2288,4348,50203,48185,27806,46390,48450
48323,TX,7644,9153,6704,9859,6534,4284,4954,9171,4733.735276,6574,9384,41791,3345,-17034,1571,3610,49132,45136,24757,43362,45401
48325,TX,8316,9153,6704,9859,6534,4284,5031,10432,5382.521329,6574,10074,45063,4310,-16069,2647,4575,49881,49373,28994,47710,49638
48327,TX,7644,9153,6704,9859,6534,4284,4954,9153,5839.074478,6574,9859,43353,3783,-16596,1930,4048,49132,47136,26757,45283,47401
48329,TX,11220,9153,6704,9859,6534,4284,5366,10468,6271.598513,6574,10757,49574,5216,-15163,4081,5481,53120,54790,34411,53655,55055
48331,TX,7644,9153,6704,9859,6534,4284,4954,9153,6247.5694,6574,9859,43762,3783,-16596,1930,4048,49132,47545,27166,45692,47810
48333,TX,7644,9153,6704,9859,6534,4284,4954,9153,6007.278269,6574,9859,43521,3783,-16596,1930,4048,49132,47304,26925,45451,47569
48335,TX,7644,9153,6704,9859,6534,4284,4954,9153,6055.336495,6574,9859,43569,3783,-16596,1930,4048,49132,47352,26973,45499,47617
48337,TX,7944,9153,6704,9859,6534,4284,4988,9153,6271.598513,6574,9859,44086,3783,-16596,1930,4048,49466,47869,27490,46016,48134
48339,TX,11112,9153,6704,9859,6534,4284,5353,10977,6728.151662,6574,10344,50019,4989,-15390,3722,5254,52999,55008,34629,53741,55273
48341,TX,8196,9153,6704,9859,6534,4284,5018,9313,6535.918757,6574,10644,45547,4083,-16296,2288,4348,49748,49630,29251,47835,49895
48343,TX,7644,9153,6704,9859,6534,4284,4954,9153,6271.598513,6574,9859,43786,3783,-16596,1930,4048,49132,47569,27190,45716,47834
48345,TX,7644,9153,6704,9859,6534,4284,4954,9153,6487.860531,6574,9859,44002,3783,-16596,1930,4048,49132,47785,27406,45932,48050
48347,TX,8592,9153,6704,9859,6534,4284,5063,9923,6608.006096,6574,8921,44902,3783,-16596,1930,4048,50189,48685,28306,46832,48950
48349,TX,8784,9153,6704,9859,6534,4284,5085,9473,5670.870686,6574,9459,44245,4083,-16296,2288,4348,50403,48328,27949,46533,48593
48351,TX,7644,9153,6704,9859,6534,4284,4954,9340,6151.452948,6574,9496,43489,3783,-16596,1930,4048,49132,47272,26893,45419,47537
48353,TX,7644,9153,6704,9859,6534,4284,4954,8347,5959.220043,6574,9058,41867,2906,-17473,1213,3171,49132,44773,24394,43080,45038
48355,TX,10068,9153,6704,9859,6534,4284,5233,10088,5742.958025,6574,9832,46589,4536,-15843,3005,4801,51835,51125,30746,49594,51390
48357,TX,7728,9153,6704,9859,6534,4284,4964,9153,6367.714965,6574,9859,43966,3783,-16596,1930,4048,49226,47749,27370,45896,48014
48359,TX,8196,9153,6704,9859,6534,4284,5018,8996,6535.918757,6574,9831,44417,3783,-16596,1930,4048,49748,48200,27821,46347,48465
48361,TX,9672,9153,6704,9859,6534,4284,5188,9524,6151.452948,6574,9459,45664,4310,-16069,2647,4575,51394,49974,29595,48311,50239
48363,TX,8628,9153,6704,9859,6534,4284,5067,9822,6367.714965,6574,9431,45106,4083,-16296,2288,4348,50229,49189,28810,47394,49454
48365,TX,7644,9153,6704,9859,6534,4284,4954,9153,5983.249156,6574,9859,43497,3783,-16596,1930,4048,49132,47280,26901,45427,47545
48367,TX,11256,9153,6704,9859,6534,4284,5370,10538,7208.733923,6574,10242,50102,4989,-15390,3722,5254,53160,55091,34712,53824,55356
48369,TX,7644,9153,6704,9859,6534,4284,4954,9153,6776.209888,6574,9859,44290,3783,-16596,1930,4048,49132,48073,27694,46220,48338
48371,TX,7752,9153,6704,9859,6534,4284,4966,9153,6151.452948,6574,9859,43773,3783,-16596,1930,4048,49252,47556,27177,45703,47821
48373,TX,7644,9153,6704,9859,6534,4284,4954,9153,5983.249156,6574,9859,43497,3783,-16596,1930,4048,49132,47280,26901,45427,47545
48375,TX,8832,9153,6704,9859,6534,4284,5091,9466,6247.5694,6574,9840,45243,4083,-16296,2288,4348,50457,49326,28947,47531,49591
48377,TX,7644,9153,6704,9859,6534,4284,4954,9153,7136.646584,6574,9859,44651,3783,-16596,1930,4048,49132,48434,28055,46581,48699
48379,TX,7644,9153,6704,9859,6534,4284,4954,9153,6632.035209,6574,9859,44146,3783,-16596,1930,4048,49132,47929,27550,46076,48194
48381,TX,8832,9153,6704,9859,6534,4284,5091,10012,7088.588358,6574,9837,46627,4310,-16069,2647,4575,50457,50937,30558,49274,51202
48383,TX,7644,9153,6704,9859,6534,4284,4954,9153,6007.278269,6574,9859,43521,3783,-16596,1930,4048,49132,47304,26925,45451,47569
48385,TX,7644,9153,6704,9859,6534,4284,4954,9153,5911.161817,6574,9859,43425,3783,-16596,1930,4048,49132,47208,26829,45355,47473
48387,TX,7644,9153,6704,9859,6534,4284,4954,9153,6247.5694,6574,9859,43762,3783,-16596,1930,4048,49132,47545,27166,45692,47810
48389,TX,7644,9153,6704,9859,6534,4284,4954,8707,6223.540287,6574,9755,43188,3345,-17034,1571,3610,49132,46533,26154,44759,46798
48391,TX,7800,9153,6704,9859,6534,4284,4972,9153,5670.870686,6574,9859,43341,3783,-16596,1930,4048,49306,47124,26745,45271,47389
48393,TX,7836,9153,6704,9859,6534,4284,4976,9153,6776.209888,6574,9859,44482,3783,-16596,1930,4048,49346,48265,27886,46412,48530
48395,TX,10416,9153,6704,9859,6534,4284,5273,9662,5911.161817,6574,9254,46101,4310,-16069,2647,4575,52223,50411,30032,48748,50676
48397,TX,10956,9153,6704,9859,6534,4284,5335,10819,6752.180775,6574,10239,49624,4989,-15390,3722,5254,52825,54613,34234,53346,54878
48399,TX,7644,9153,6704,9859,6534,4284,4954,9153,5887.132704,6574,9859,43401,3783,-16596,1930,4048,49132,47184,26805,45331,47449
48401,TX,8184,9153,6704,9859,6534,4284,5016,9311,6367.714965,6574,9650,44370,3783,-16596,1930,4048,49734,48153,27774,46300,48418
48403,TX,7644,9153,6704,9859,6534,4284,4954,9153,6319.656739,6574,9859,43834,3783,-16596,1930,4048,49132,47617,27238,45764,47882
48405,TX,7644,9153,6704,9859,6534,4284,4954,9153,6319.656739,6574,9859,43834,3783,-16596,1930,4048,49132,47617,27238,45764,47882
48407,TX,11112,9153,6704,9859,6534,4284,5353,9153,6992.471905,6574,9859,47974,4536,-15843,3005,4801,52999,52510,32131,50979,52775
48409,TX,10068,9153,6704,9859,6534,4284,5233,9678,5550.725121,6574,9829,45984,4536,-15843,3005,4801,51835,50520,30141,48989,50785
48411,TX,7644,9153,6704,9859,6534,4284,4954,9153,5983.249156,6574,9859,43497,3783,-16596,1930,4048,49132,47280,26901,45427,47545
48413,TX,7644,9153,6704,9859,6534,4284,4954,9153,5815.045365,6574,9859,43329,3783,-16596,1930,4048,49132,47112,26733,45259,47377
48415,TX,7644,9153,6704,9859,6534,4284,4954,8847,6031.307382,6574,9630,43011,3345,-17034,1571,3610,49132,46356,25977,44582,46621
48417,TX,7644,9153,6704,9859,6534,4284,4954,9153,5959.220043,6574,9859,43473,3783,-16596,1930,4048,49132,47256,26877,45403,47521
48419,TX,7644,9153,6704,9859,6534,4284,4954,9153,6415.773192,6574,9859,43930,3783,-16596,1930,4048,49132,47713,27334,45860,47978
48421,TX,7644,9153,6704,9859,6534,4284,4954,9153,6439.802305,6574,9859,43954,3783,-16596,1930,4048,49132,47737,27358,45884,48002
48423,TX,10500,9153,6704,9859,6534,4284,5283,10150,6608.006096,6574,9703,47819,4536,-15843,3005,4801,52317,52355,31976,50824,52620
48425,TX,7644,9153,6704,9859,6534,4284,4954,9996,5983.249156,6574,10233,44714,4083,-16296,2288,4348,49132,48797,28418,47002,49062
48427,TX,7644,9153,6704,9859,6534,4284,4954,8147,5574.754234,6574,9272,41495,2906,-17473,1213,3171,49132,44401,24022,42708,44666
48429,TX,7944,9153,6704,9859,6534,4284,4988,9153,6487.860531,6574,9859,44302,3783,-16596,1930,4048,49466,48085,27706,46232,48350
48431,TX,8328,9153,6704,9859,6534,4284,5033,9153,6055.336495,6574,9859,44253,3783,-16596,1930,4048,49895,48036,27657,46183,48301
48433,TX,7644,9153,6704,9859,6534,4284,4954,9153,6535.918757,6574,9859,44050,3783,-16596,1930,4048,49132,47833,27454,45980,48098
48435,TX,7644,9153,6704,9859,6534,4284,4954,9153,5502.666895,6574,9859,43017,3783,-16596,1930,4048,49132,46800,26421,44947,47065
48437,TX,7644,9153,6704,9859,6534,4284,4954,9153,6511.889644,6574,9859,44026,3783,-16596,1930,4048,49132,47809,27430,45956,48074
48439,TX,11256,9153,6704,9859,6534,4284,5370,10592,6535.918757,6574,10281,49523,4989,-15390,3722,5254,53160,54512,34133,53245,54777
48441,TX,9480,9153,6704,9859,6534,4284,5165,9437,5887.132704,6574,9504,45166,4083,-16296,2288,4348,51179,49249,28870,47454,49514
48443,TX,7644,9153,6704,9859,6534,4284,4954,9153,5358.492216,6574,9859,42872,3783,-16596,1930,4048,49132,46655,26276,44802,46920
48445,TX,7644,9153,6704,9859,6534,4284,4954,9153,6367.714965,6574,9859,43882,3783,-16596,1930,4048,49132,47665,27286,45812,47930
48447,TX,7644,9153,6704,9859,6534,4284,4954,9153,6656.064322,6574,9859,44170,3783,-16596,1930,4048,49132,47953,27574,46100,48218
48449,TX,7644,9153,6704,9859,6534,4284,4954,9368,6151.452948,6574,9854,43876,3783,-16596,1930,4048,49132,47659,27280,45806,47924
48451,TX,8760,9153,6704,9859,6534,4284,5083,9421,5815.045365,6574,9584,44438,4083,-16296,2288,4348,50377,48521,28142,46726,48786
48453,TX,12888,9153,6704,9859,6534,4284,5558,11826,6583.976983,6574,10553,52710,5669,-14710,4798,5934,54980,58379,38000,57508,58644
48455,TX,7644,9153,6704,9859,6534,4284,4954,9819,6103.394722,6574,8418,42842,3345,-17034,1571,3610,49132,46187,25808,44413,46452
48457,TX,7644,9153,6704,9859,6534,4284,4954,9153,6247.5694,6574,9859,43762,3783,-16596,1930,4048,49132,47545,27166,45692,47810
48459,TX,9576,9153,6704,9859,6534,4284,5177,9678,6247.5694,6574,9653,46012,4310,-16069,2647,4575,51287,50322,29943,48659,50587
48461,TX,7644,9153,6704,9859,6534,4284,4954,9153,6151.452948,6574,9859,43665,3783,-16596,1930,4048,49132,47448,27069,45595,47713
48463,TX,7644,9153,6704,9859,6534,4284,4954,9135,5454.608668,6574,9161,42252,3345,-17034,1571,3610,49132,45597,25218,43823,45862
48465,TX,7644,9153,6704,9859,6534,4284,4954,9460,5070.142859,6574,9929,42961,3783,-16596,1930,4048,49132,46744,26365,44891,47009
48467,TX,8688,9153,6704,9859,6534,4284,5074,9153,6511.889644,6574,9859,45070,4083,-16296,2288,4348,50296,49153,28774,47358,49418
48469,TX,8772,9153,6704,9859,6534,4284,5084,9826,5766.987138,6574,9888,45110,4310,-16069,2647,4575,50390,49420,29041,47757,49685
48471,TX,8568,9153,6704,9859,6534,4284,5060,10803,6319.656739,6574,8297,44846,4083,-16296,2288,4348,50162,48929,28550,47134,49194
48473,TX,11112,9153,6704,9859,6534,4284,5353,10725,7184.70481,6574,10325,50205,4989,-15390,3722,5254,52999,55194,34815,53927,55459
48475,TX,7644,9153,6704,9859,6534,4284,4954,9153,6031.307382,6574,9859,43545,3783,-16596,1930,4048,49132,47328,26949,45475,47593
48477,TX,8784,9153,6704,9859,6534,4284,5085,9848,6151.452948,6574,9539,45180,4083,-16296,2288,4348,50403,49263,28884,47468,49528
48479,TX,9324,9153,6704,9859,6534,4284,5147,9959,4998.05552,6574,10081,45220,4310,-16069,2647,4575,51005,49530,29151,47867,49795
48481,TX,8448,9153,6704,9859,6534,4284,5047,9426,5646.841573,6574,9669,44048,4083,-16296,2288,4348,50029,48131,27752,46336,48396
48483,TX,7644,9153,6704,9859,6534,4284,4954,9153,6728.151662,6574,9859,44242,3783,-16596,1930,4048,49132,48025,27646,46172,48290
48485,TX,8544,9153,6704,9859,6534,4284,5058,9435,6007.278269,6574,9543,44388,4083,-16296,2288,4348,50136,48471,28092,46676,48736
48487,TX,8052,9153,6704,9859,6534,4284,5001,8306,6103.394722,6574,9290,42610,3345,-17034,1571,3610,49587,45955,25576,44181,46220
48489,TX,7716,9153,6704,9859,6534,4284,4962,8722,4805.822615,6574,8811,40912,2906,-17473,1213,3171,49212,43818,23439,42125,44083
48491,TX,12888,9153,6704,9859,6534,4284,5558,10627,6463.831418,6574,10517,51354,5216,-15163,4081,5481,54980,56570,36191,55435,56835
48493,TX,10284,9153,6704,9859,6534,4284,5258,10357,6079.365608,6574,10067,47646,4763,-15616,3364,5028,52076,52409,32030,51010,52674
48495,TX,7644,9153,6704,9859,6534,4284,4954,9153,6223.540287,6574,9859,43738,3783,-16596,1930,4048,49132,47521,27142,45668,47786
48497,TX,9540,9153,6704,9859,6534,4284,5172,10535,6824.268114,6574,10238,47996,4536,-15843,3005,4801,51246,52532,32153,51001,52797
48499,TX,7956,9153,6704,9859,6534,4284,4990,9153,6583.976983,6574,9859,44410,3783,-16596,1930,4048,49480,48193,27814,46340,48458
48501,TX,7836,9153,6704,9859,6534,4284,4976,9153,6920.384566,6574,9859,44626,3783,-16596,1930,4048,49346,48409,28030,46556,48674
48503,TX,8796,9153,6704,9859,6534,4284,5087,9153,6103.394722,6574,9859,44769,4083,-16296,2288,4348,50417,48852,28473,47057,49117
48505,TX,7644,9153,6704,9859,6534,4284,4954,9720,5118.201085,6574,9137,42478,3783,-16596,1930,4048,49132,46261,25882,44408,46526
48507,TX,7644,9153,6704,9859,6534,4284,4954,9153,5118.201085,6574,9859,42632,3783,-16596,1930,4048,49132,46415,26036,44562,46680
49001,UT,7488,6648,8002,8509,5221,4344,6930,6648,7916.101692,6293,8509,41198,1199,-16090,2455,4334,47142,42397,25108,43653,45532
49003,UT,7476,6648,8002,8509,5221,4344,6928,6399,8346.32461,6293,9381,42240,1199,-16090,2455,4334,47128,43439,26150,44695,46574
49005,UT,7644,6648,8002,8509,5221,4344,6956,7008,7858.738636,6293,8936,42083,1687,-15822,2864,4822,47324,43770,26261,44947,46905
49007,UT,7476,6648,8002,8509,5221,4344,6928,6457,8145.553915,6293,8261,40977,711,-16178,2047,3846,47128,41688,24799,43024,44823
49009,UT,9264,6648,8002,8509,5221,4344,7224,6648,8891.27364,6293,8509,43949,2176,-15333,3272,5311,49212,46125,28616,47221,49260
49011,UT,9264,6648,8002,8509,5221,4344,7224,7338,7830.057109,6293,9467,44537,2664,-14845,3681,5799,49212,47201,29692,48218,50336
49013,UT,8064,6648,8002,8509,5221,4344,7025,6648,7744.012525,6293,8509,41602,1199,-16090,2455,4334,47813,42801,25512,44057,45936
49015,UT,7476,6648,8002,8509,5221,4344,6928,6648,7801.375581,6293,8509,41071,1199,-16090,2455,4334,47128,42270,24981,43526,45405
49017,UT,7860,6648,8002,8509,5221,4344,6992,6648,7916.101692,6293,8509,41570,1199,-16090,2455,4334,47576,42769,25480,44025,45904
49019,UT,8400,6648,8002,8509,5221,4344,7081,6648,8805.229056,6293,8509,42999,1687,-15822,2864,4822,48205,44686,27177,45863,47821
49021,UT,7476,6648,8002,8509,5221,4344,6928,7296,8059.509332,6293,8403,41871,1199,-16090,2455,4334,47128,43070,25781,44326,46205
49023,UT,8748,6648,8002,8509,5221,4344,7138,6138,7744.012525,6293,9318,42585,1687,-15822,2864,4822,48610,44272,26763,45449,47407
49025,UT,9480,6648,8002,8509,5221,4344,7259,6648,8403.687666,6293,8509,43678,2176,-15333,3272,5311,49463,45854,28345,46950,48989
49027,UT,7476,6648,8002,8509,5221,4344,6928,6648,7715.330997,6293,8509,40985,1199,-16090,2455,4334,47128,42184,24895,43440,45319
49029,UT,9264,6648,8002,8509,5221,4344,7224,6853,7715.330997,6293,9335,43805,2664,-14845,3681,5799,49212,46469,28960,47486,49604
49031,UT,9348,6648,8002,8509,5221,4344,7237,6648,7858.738636,6293,8509,43001,2176,-15333,3272,5311,49309,45177,27668,46273,48312
49033,UT,9444,6648,8002,8509,5221,4344,7253,6648,7772.694053,6293,8509,43011,2176,-15333,3272,5311,49421,45187,27678,46283,48322
49035,UT,10512,6648,8002,8509,5221,4344,7430,7941,7686.649469,6293,9521,46298,3291,-14218,4498,6426,50666,49589,32080,50796,52724
49037,UT,7476,6648,8002,8509,5221,4344,6928,6648,8633.139889,6293,8509,41903,1199,-16090,2455,4334,47128,43102,25813,44358,46237
49039,UT,7644,6648,8002,8509,5221,4344,6956,6648,7887.420164,6293,8509,41325,1199,-16090,2455,4334,47324,42524,25235,43780,45659
49041,UT,7476,6648,8002,8509,5221,4344,6928,6648,7801.375581,6293,8509,41071,1199,-16090,2455,4334,47128,42270,24981,43526,45405
49043,UT,10968,6648,8002,8509,5221,4344,7505,8892,10153.26087,6293,9419,50069,3567,-13942,4906,6702,51197,53636,36127,54975,56771
49045,UT,9204,6648,8002,8509,5221,4344,7214,6686,8002.146276,6293,9387,43916,2176,-15333,3272,5311,49142,46092,28583,47188,49227
49047,UT,10896,6648,8002,8509,5221,4344,7493,7088,8375.006138,6293,9243,46239,3014,-14495,4089,6149,51113,49253,31744,50328,52388
49049,UT,8748,6648,8002,8509,5221,4344,7138,7772,7600.604886,6293,9470,44227,2664,-14845,3681,5799,48610,46891,29382,47908,50026
49051,UT,10092,6648,8002,8509,5221,4344,7360,7405,8919.955168,6293,9477,46531,3014,-14495,4089,6149,50176,49545,32036,50620,52680
49053,UT,9036,6648,8002,8509,5221,4344,7186,7236,7887.420164,6293,8498,43294,2176,-15333,3272,5311,48946,45470,27961,46566,48605
49055,UT,7476,6648,8002,8509,5221,4344,6928,6648,8375.006138,6293,8509,41645,1199,-16090,2455,4334,47128,42844,25555,44100,45979
49057,UT,9264,6648,8002,8509,5221,4344,7224,7164,7457.197246,6293,9471,43993,2664,-14845,3681,5799,49212,46657,29148,47674,49792
50001,VT,10440,12682,7786,7901,5969,3987,7279,12682,10493.15238,11386,7901,56889,8436,-11976,7796,8668,56044,65325,44913,64685,65557
50003,VT,10032,12682,7786,7901,5969,3987,7218,14676,8372.196051,11386,7550,56004,8436,-11976,7796,8668,55575,64440,44028,63800,64672
50005,VT,8136,12682,7786,7901,5969,3987,6932,12682,9655.932779,11386,7901,53748,7330,-13082,6162,7562,53393,61078,40666,59910,61310
50007,VT,15708,12682,7786,7901,5969,3987,8073,11657,9125.693695,11386,8272,60135,9542,-10118,9430,9774,62106,69677,50017,69565,69909
50009,VT,8088,12682,7786,7901,5969,3987,6925,12038,9348.952257,11386,7249,52097,7330,-13082,6162,7562,53338,59427,39015,58259,59659
50011,VT,15708,12682,7786,7901,5969,3987,8073,11395,9767.562059,11386,8250,60494,9542,-10118,9430,9774,62106,70036,50376,69924,70268
50013,VT,15708,12682,7786,7901,5969,3987,8073,14139,8651.269253,11386,8261,62132,10095,-9142,10247,10327,62106,72227,52990,72379,72459
50015,VT,11304,12682,7786,7901,5969,3987,7410,12682,10381.5231,11386,7901,57642,8436,-11976,7796,8668,57039,66078,45666,65438,66310
50017,VT,9768,12682,7786,7901,5969,3987,7178,16920,10102.4499,11386,7747,59910,8989,-11095,8613,9221,55271,68899,48815,68523,69131
50019,VT,8484,12682,7786,7901,5969,3987,6985,12682,9181.508336,11386,7901,53622,7883,-12529,6979,8115,53794,61505,41093,60601,61737
50021,VT,9900,12682,7786,7901,5969,3987,7198,11433,8372.196051,11386,7577,52655,7883,-12529,6979,8115,55423,60538,40126,59634,60770
50023,VT,10800,12682,7786,7901,5969,3987,7334,15345,10269.89382,11386,7817,59605,8989,-11095,8613,9221,56459,68594,48510,68218,68826
50025,VT,9984,12682,7786,7901,5969,3987,7211,12682,9879.19134,11386,7901,55819,7883,-12529,6979,8115,55520,63702,43290,62798,63934
50027,VT,10620,12682,7786,7901,5969,3987,7307,14414,10521.0597,11386,7739,58667,8436,-11976,7796,8668,56252,67103,46691,66463,67335
51001,VA,8808,14625,6704,9859,6530,4284,6858,14625,6608.006096,7030,9859,51214,2707,-17683,1561,2961,57668,53921,33531,52775,54175
51003,VA,12096,14625,6704,9859,6530,4284,7336,14790,7473.054167,7030,9708,55381,3755,-16635,3137,4009,61434,59136,38746,58518,59390
51005,VA,7404,14625,6704,9859,6530,4284,6654,14625,6968.442792,7030,9859,50170,2444,-17946,1166,2698,56060,52614,32224,51336,52868
51007,VA,11808,14625,6704,9859,6530,4284,7294,16193,6992.471905,7030,9999,56307,4279,-15783,3925,4533,61104,60586,40524,60232,60840
51009,VA,7884,14625,6704,9859,6530,4284,6724,13318,6656.064322,7030,9522,48695,2183,-18207,773,2437,56610,50878,30488,49468,51132
51011,VA,7884,14625,6704,9859,6530,4284,6724,14681,6776.209888,7030,9517,50172,2707,-17683,1561,2961,56610,52879,32489,51733,53133
51013,VA,17628,14625,6704,9859,6530,4284,8139,14919,8842.713612,7030,11831,64535,9058,-9733,9496,9312,67769,73593,54802,74031,73847
51015,VA,8628,14625,6704,9859,6530,4284,6832,14215,6872.32634,7030,9494,50524,2707,-17683,1561,2961,57462,53231,32841,52085,53485
51017,VA,7404,14625,6704,9859,6530,4284,6654,14625,6920.384566,7030,9859,50122,2444,-17946,1166,2698,56060,52566,32176,51288,52820
51019,VA,7884,14625,6704,9859,6530,4284,6724,14621,7280.821262,7030,9515,50615,2707,-17683,1561,2961,56610,53322,32932,52176,53576
51021,VA,7404,14625,6704,9859,6530,4284,6654,14625,6656.064322,7030,9859,49858,2444,-17946,1166,2698,56060,52302,31912,51024,52556
51023,VA,8640,14625,6704,9859,6530,4284,6834,15038,7304.850375,7030,9510,51806,2707,-17683,1561,2961,57476,54513,34123,53367,54767
51025,VA,7404,14625,6704,9859,6530,4284,6654,14625,6367.714965,7030,9859,49570,2444,-17946,1166,2698,56060,52014,31624,50736,52268
51027,VA,7404,14625,6704,9859,6530,4284,6654,14625,6463.831418,7030,9859,49666,2444,-17946,1166,2698,56060,52110,31720,50832,52364
51029,VA,7764,14625,6704,9859,6530,4284,6707,14987,7088.588358,7030,9732,50885,2707,-17683,1561,2961,56473,53592,33202,52446,53846
51031,VA,7884,14625,6704,9859,6530,4284,6724,15846,6583.976983,7030,9510,51138,2707,-17683,1561,2961,56610,53845,33455,52699,54099
51033,VA,11808,14625,6704,9859,6530,4284,7294,14099,6800.239001,7030,9985,54006,3231,-17159,2349,3485,61104,57237,36847,56355,57491
51035,VA,7404,14625,6704,9859,6530,4284,6654,14625,6463.831418,7030,9859,49666,2444,-17946,1166,2698,56060,52110,31720,50832,52364
51036,VA,11808,14625,6704,9859,6530,4284,7294,13477,7208.733923,7030,9993,53801,3231,-17159,2349,3485,61104,57032,36642,56150,57286
51037,VA,7404,14625,6704,9859,6530,4284,6654,14625,6608.006096,7030,9859,49810,2444,-17946,1166,2698,56060,52254,31864,50976,52508
51041,VA,11808,14625,6704,9859,6530,4284,7294,13440,7112.617471,7030,10000,53675,3231,-17159,2349,3485,61104,56906,36516,56024,57160
51043,VA,17628,14625,6704,9859,6530,4284,8139,18988,7424.995941,7030,11182,66537,9582,-8786,10284,9836,67769,76119,57751,76821,76373
51045,VA,8640,14625,6704,9859,6530,4284,6834,13872,7040.530132,7030,9525,50392,2707,-17683,1561,2961,57476,53099,32709,51953,53353
51047,VA,9888,14625,6704,9859,6530,4284,7015,14104,6559.94787,7030,11214,53080,3231,-17159,2349,3485,58905,56311,35921,55429,56565
51049,VA,11808,14625,6704,9859,6530,4284,7294,14625,6752.180775,7030,9859,54358,3755,-16635,3137,4009,61104,58113,37723,57495,58367
51051,VA,7404,14625,6704,9859,6530,4284,6654,14082,6608.006096,7030,8543,47951,2183,-18207,773,2437,56060,50134,29744,48724,50388
51053,VA,11808,14625,6704,9859,6530,4284,7294,13788,6559.94787,7030,9992,53462,3231,-17159,2349,3485,61104,56693,36303,55811,56947
51057,VA,9984,14625,6704,9859,6530,4284,7029,14625,6872.32634,7030,9859,52654,3231,-17159,2349,3485,59015,55885,35495,55003,56139
51059,VA,17628,14625,6704,9859,6530,4284,8139,13888,8241.985785,7030,11469,62541,8534,-10681,8708,8788,67769,71075,51860,71249,71329
51061,VA,17628,14625,6704,9859,6530,4284,8139,14009,8266.014898,7030,11194,62411,8534,-10681,8708,8788,67769,70945,51730,71119,71199
51063,VA,7404,14625,6704,9859,6530,4284,6654,13606,6896.355453,7030,9406,48626,2183,-18207,773,2437,56060,50809,30419,49399,51063
51065,VA,12096,14625,6704,9859,6530,4284,7336,14919,7473.054167,7030,9729,55531,3755,-16635,3137,4009,61434,59286,38896,58668,59540
51067,VA,7404,14625,6704,9859,6530,4284,6654,15015,6824.268114,7030,9507,50064,2444,-17946,1166,2698,56060,52508,32118,51230,52762
51069,VA,9648,14625,6704,9859,6530,4284,6980,13650,6680.093435,7030,9775,51067,2707,-17683,1561,2961,58630,53774,33384,52628,54028
51071,VA,7404,14625,6704,9859,6530,4284,6654,15078,7136.646584,7030,9391,50324,2444,-17946,1166,2698,56060,52768,32378,51490,53022
51073,VA,13560,14625,6704,9859,6530,4284,7548,13822,7088.588358,7030,10109,55893,3755,-16635,3137,4009,63110,59648,39258,59030,59902
51075,VA,11808,14625,6704,9859,6530,4284,7294,13894,7256.792149,7030,9994,54267,3231,-17159,2349,3485,61104,57498,37108,56616,57752
51077,VA,7404,14625,6704,9859,6530,4284,6654,14625,6752.180775,7030,9859,49954,2444,-17946,1166,2698,56060,52398,32008,51120,52652
51079,VA,12096,14625,6704,9859,6530,4284,7336,18540,7352.908602,7030,9729,59032,4803,-14835,4713,5057,61434,63835,44197,63745,64089
51081,VA,7404,14625,6704,9859,6530,4284,6654,14625,6391.744078,7030,9859,49594,2444,-17946,1166,2698,56060,52038,31648,50760,52292
51083,VA,7404,14625,6704,9859,6530,4284,6654,14625,6439.802305,7030,9859,49642,2444,-17946,1166,2698,56060,52086,31696,50808,52340
51085,VA,11808,14625,6704,9859,6530,4284,7294,16008,7112.617471,7030,9996,56239,3755,-16635,3137,4009,61104,59994,39604,59376,60248
51087,VA,11808,14625,6704,9859,6530,4284,7294,13372,7112.617471,7030,10010,53617,3231,-17159,2349,3485,61104,56848,36458,55966,57102
51089,VA,7404,14625,6704,9859,6530,4284,6654,13885,6535.918757,7030,8455,47594,1920,-18470,378,2174,56060,49514,29124,47972,49768
51091,VA,7404,14625,6704,9859,6530,4284,6654,14625,6824.268114,7030,9859,50026,2444,-17946,1166,2698,56060,52470,32080,51192,52724
51093,VA,13560,14625,6704,9859,6530,4284,7548,13992,7184.70481,7030,10100,56150,3755,-16635,3137,4009,63110,59905,39515,59287,60159
51095,VA,13560,14625,6704,9859,6530,4284,7548,14948,8746.59716,7030,10112,58681,4279,-15783,3925,4533,63110,62960,42898,62606,63214
51097,VA,11808,14625,6704,9859,6530,4284,7294,14625,7328.879488,7030,9859,54935,3755,-16635,3137,4009,61104,58690,38300,58072,58944
51099,VA,11568,14625,6704,9859,6530,4284,7259,14625,7112.617471,7030,9859,54479,3755,-16635,3137,4009,60829,58234,37844,57616,58488
51101,VA,11808,14625,6704,9859,6530,4284,7294,13252,7256.792149,7030,10001,53631,3231,-17159,2349,3485,61104,56862,36472,55980,57116
51103,VA,9624,14625,6704,9859,6530,4284,6977,14625,7112.617471,7030,9859,52535,3231,-17159,2349,3485,58603,55766,35376,54884,56020
51105,VA,7404,14625,6704,9859,6530,4284,6654,14625,6415.773192,7030,9859,49618,2444,-17946,1166,2698,56060,52062,31672,50784,52316
51107,VA,17628,14625,6704,9859,6530,4284,8139,14489,8025.723768,7030,11341,62797,8534,-10681,8708,8788,67769,71331,52116,71505,71585
51109,VA,8604,14625,6704,9859,6530,4284,6828,14625,6944.413679,7030,9859,51346,2707,-17683,1561,2961,57434,54053,33663,52907,54307
51111,VA,7404,14625,6704,9859,6530,4284,6654,14625,6367.714965,7030,9859,49570,2444,-17946,1166,2698,56060,52014,31624,50736,52268
51113,VA,8208,14625,6704,9859,6530,4284,6771,14625,6728.151662,7030,9859,50734,2707,-17683,1561,2961,56981,53441,33051,52295,53695
51115,VA,13560,14625,6704,9859,6530,4284,7548,15489,7352.908602,7030,10109,57825,4279,-15783,3925,4533,63110,62104,42042,61750,62358
51117,VA,7404,14625,6704,9859,6530,4284,6654,14625,6391.744078,7030,9859,49594,2444,-17946,1166,2698,56060,52038,31648,50760,52292
51119,VA,7548,14625,6704,9859,6530,4284,6675,14625,7521.112393,7030,9859,50867,2707,-17683,1561,2961,56225,53574,33184,52428,53828
51121,VA,8592,14625,6704,9859,6530,4284,6827,14100,7665.287072,7030,9359,51030,2707,-17683,1561,2961,57421,53737,33347,52591,53991
51125,VA,12096,14625,6704,9859,6530,4284,7336,14800,7184.70481,7030,9728,55123,3755,-16635,3137,4009,61434,58878,38488,58260,59132
51127,VA,11808,14625,6704,9859,6530,4284,7294,15310,7256.792149,7030,9992,55681,3755,-16635,3137,4009,61104,59436,39046,58818,59690
51131,VA,8496,14625,6704,9859,6530,4284,6813,14625,7016.501018,7030,9859,51311,2707,-17683,1561,2961,57311,54018,33628,52872,54272
51133,VA,7896,14625,6704,9859,6530,4284,6726,14625,7160.675697,7030,9859,50855,2707,-17683,1561,2961,56624,53562,33172,52416,53816
51135,VA,8592,14625,6704,9859,6530,4284,6827,14625,6391.744078,7030,9859,50782,2707,-17683,1561,2961,57421,53489,33099,52343,53743
51137,VA,9924,14625,6704,9859,6530,4284,7020,14625,7040.530132,7030,9859,52763,3231,-17159,2349,3485,58946,55994,35604,55112,56248
51139,VA,7824,14625,6704,9859,6530,4284,6715,14625,6656.064322,7030,9859,50278,2707,-17683,1561,2961,56541,52985,32595,51839,53239
51141,VA,7404,14625,6704,9859,6530,4284,6654,14625,6776.209888,7030,9859,49978,2444,-17946,1166,2698,56060,52422,32032,51144,52676
51143,VA,7404,14625,6704,9859,6530,4284,6654,13329,6752.180775,7030,8667,47467,1920,-18470,378,2174,56060,49387,28997,47845,49641
51145,VA,11808,14625,6704,9859,6530,4284,7294,15098,6968.442792,7030,9999,55187,3755,-16635,3137,4009,61104,58942,38552,58324,59196
51147,VA,8460,14625,6704,9859,6530,4284,6808,14625,6439.802305,7030,9859,50698,2707,-17683,1561,2961,57270,53405,33015,52259,53659
51149,VA,11808,14625,6704,9859,6530,4284,7294,16044,6391.744078,7030,9990,55548,3755,-16635,3137,4009,61104,59303,38913,58685,59557
51153,VA,17628,14625,6704,9859,6530,4284,8139,14189,7184.70481,7030,11342,61658,8534,-10681,8708,8788,67769,70192,50977,70366,70446
51155,VA,7404,14625,6704,9859,6530,4284,6654,18924,6824.268114,7030,9358,53824,3231,-17159,2349,3485,56060,57055,36665,56173,57309
51157,VA,11880,14625,6704,9859,6530,4284,7304,14008,7184.70481,7030,11124,55511,3755,-16635,3137,4009,61186,59266,38876,58648,59520
51159,VA,8628,14625,6704,9859,6530,4284,6832,14625,6848.297227,7030,9859,51274,2707,-17683,1561,2961,57462,53981,33591,52835,54235
51161,VA,8640,14625,6704,9859,6530,4284,6834,15220,7328.879488,7030,9472,51975,2707,-17683,1561,2961,57476,54682,34292,53536,54936
51163,VA,7656,14625,6704,9859,6530,4284,6691,14625,6800.239001,7030,9859,50254,2707,-17683,1561,2961,56349,52961,32571,51815,53215
51165,VA,8880,14625,6704,9859,6530,4284,6869,14165,6559.94787,7030,9745,50664,2707,-17683,1561,2961,57751,53371,32981,52225,53625
51167,VA,7404,14625,6704,9859,6530,4284,6654,14625,6656.064322,7030,9859,49858,2444,-17946,1166,2698,56060,52302,31912,51024,52556
51169,VA,7404,14625,6704,9859,6530,4284,6654,14699,6800.239001,7030,8823,49040,2183,-18207,773,2437,56060,51223,30833,49813,51477
51171,VA,8568,14625,6704,9859,6530,4284,6823,14625,6848.297227,7030,9859,51214,2707,-17683,1561,2961,57393,53921,33531,52775,54175
51173,VA,7404,14625,6704,9859,6530,4284,6654,14625,6463.831418,7030,9859,49666,2444,-17946,1166,2698,56060,52110,31720,50832,52364
51175,VA,8976,14625,6704,9859,6530,4284,6882,14625,6872.32634,7030,9859,51646,2707,-17683,1561,2961,57860,54353,33963,53207,54607
51177,VA,17628,14625,6704,9859,6530,4284,8139,13598,6487.860531,7030,11203,60230,8534,-10681,8708,8788,67769,68764,49549,68938,69018
51179,VA,17628,14625,6704,9859,6530,4284,8139,14404,6872.32634,7030,11221,61440,8534,-10681,8708,8788,67769,69974,50759,70148,70228
51181,VA,13560,14625,6704,9859,6530,4284,7548,14625,6920.384566,7030,9859,56278,4279,-15783,3925,4533,63110,60557,40495,60203,60811
51183,VA,11808,14625,6704,9859,6530,4284,7294,14562,7016.501018,7030,10000,54700,3755,-16635,3137,4009,61104,58455,38065,57837,58709
51185,VA,7404,14625,6704,9859,6530,4284,6654,17494,6463.831418,7030,8512,51188,2707,-17683,1561,2961,56060,53895,33505,52749,54149
51187,VA,10968,14625,6704,9859,6530,4284,7172,13615,7424.995941,7030,11236,54558,3231,-17159,2349,3485,60142,57789,37399,56907,58043
51191,VA,7404,14625,6704,9859,6530,4284,6654,14591,6535.918757,7030,8767,48612,2183,-18207,773,2437,56060,50795,30405,49385,51049
51193,VA,8508,14625,6704,9859,6530,4284,6815,14625,7136.646584,7030,9859,51443,2707,-17683,1561,2961,57325,54150,33760,53004,54404
51195,VA,7404,14625,6704,9859,6530,4284,6654,14293,6704.122548,7030,8520,48235,2183,-18207,773,2437,56060,50418,30028,49008,50672
51197,VA,7404,14625,6704,9859,6530,4284,6654,14625,7016.501018,7030,9859,50219,2444,-17946,1166,2698,56060,52663,32273,51385,52917
51199,VA,13560,14625,6704,9859,6530,4284,7548,14174,7328.879488,7030,10116,56494,3755,-16635,3137,4009,63110,60249,39859,59631,60503
51510,VA,17628,14625,6704,9859,6530,4284,8139,13204,9034.946517,7030,11792,62973,8534,-10681,8708,8788,67769,71507,52292,71681,71761
51515,VA,7884,14625,6704,9859,6530,4284,6724,15408,6992.471905,7030,9463,51061,2707,-17683,1561,2961,56610,53768,33378,52622,54022
51520,VA,7404,14625,6704,9859,6530,4284,6654,16430,6776.209888,7030,8707,50632,2707,-17683,1561,2961,56060,53339,32949,52193,53593
51530,VA,7656,14625,6704,9859,6530,4284,6691,14625,6872.32634,7030,9859,50326,2707,-17683,1561,2961,56349,53033,32643,51887,53287
51540,VA,12096,14625,6704,9859,6530,4284,7336,13678,8602.422482,7030,9675,55366,3231,-17159,2349,3485,61434,58597,38207,57715,58851
51550,VA,13560,14625,6704,9859,6530,4284,7548,13539,6920.384566,7030,10131,55464,3755,-16635,3137,4009,63110,59219,38829,58601,59473
51560,VA,7404,14625,6704,9859,6530,4284,6654,14625,6704,7030,9859,49906,2444,-17946,1166,2698,56060,52350,31960,51072,52604
51570,VA,11808,14625,6704,9859,6530,4284,7294,14563,6920.384566,7030,10003,54609,3755,-16635,3137,4009,61104,58364,37974,57746,58618
51580,VA,7404,14625,6704,9859,6530,4284,6654,14625,6487.860531,7030,9859,49690,2444,-17946,1166,2698,56060,52134,31744,50856,52388
51590,VA,7404,14625,6704,9859,6530,4284,6654,13804,6007.278269,7030,8546,47075,1920,-18470,378,2174,56060,48995,28605,47453,49249
51595,VA,7404,14625,6704,9859,6530,4284,6654,14625,6319.656739,7030,9859,49522,2444,-17946,1166,2698,56060,51966,31576,50688,52220
51600,VA,17628,14625,6704,9859,6530,4284,8139,13397,9299.266761,7030,11466,63104,8534,-10681,8708,8788,67769,71638,52423,71812,71892
51610,VA,17628,14625,6704,9859,6530,4284,8139,15985,8386.160464,7030,11618,64931,9058,-9733,9496,9312,67769,73989,55198,74427,74243
51620,VA,8976,14625,6704,9859,6530,4284,6882,14625,6824.268114,7030,9859,51598,2707,-17683,1561,2961,57860,54305,33915,53159,54559
51630,VA,17628,14625,6704,9859,6530,4284,8139,19150,7977.665542,7030,11407,67477,10106,-7838,11072,10360,67769,77583,59639,78549,77837
51640,VA,7404,14625,6704,9859,6530,4284,6654,14625,6656.064322,7030,9859,49858,2444,-17946,1166,2698,56060,52302,31912,51024,52556
51650,VA,13560,14625,6704,9859,6530,4284,7548,13866,6848.297227,7030,10144,55732,3755,-16635,3137,4009,63110,59487,39097,58869,59741
51660,VA,8880,14625,6704,9859,6530,4284,6869,13467,6824.268114,7030,9726,50210,2707,-17683,1561,2961,57751,52917,32527,51771,53171
51670,VA,11808,14625,6704,9859,6530,4284,7294,15698,6920.384566,7030,10008,55749,3755,-16635,3137,4009,61104,59504,39114,58886,59758
51678,VA,7656,14625,6704,9859,6530,4284,6691,14625,6920.384566,7030,9859,50374,2707,-17683,1561,2961,56349,53081,32691,51935,53335
51680,VA,7884,14625,6704,9859,6530,4284,6724,15775,6872.32634,7030,9467,51312,2707,-17683,1561,2961,56610,54019,33629,52873,54273
51683,VA,17628,14625,6704,9859,6530,4284,8139,14021,6535.918757,7030,11441,60940,8534,-10681,8708,8788,67769,69474,50259,69648,69728
51685,VA,17628,14625,6704,9859,6530,4284,8139,13352,7208.733923,7030,11417,60919,8534,-10681,8708,8788,67769,69453,50238,69627,69707
51690,VA,7404,14625,6704,9859,6530,4284,6654,17799,6415.773192,7030,8357,51290,2707,-17683,1561,2961,56060,53997,33607,52851,54251
51700,VA,13560,14625,6704,9859,6530,4284,7548,19177,6632.035209,7030,10148,60832,8534,-10681,8708,8788,63110,69366,50151,69540,69620
51710,VA,13560,14625,6704,9859,6530,4284,7548,16000,6896.355453,7030,10177,57948,4279,-15783,3925,4533,63110,62227,42165,61873,62481
51720,VA,7404,14625,6704,9859,6530,4284,6654,14857,6680.093435,7030,8417,48672,2183,-18207,773,2437,56060,50855,30465,49445,51109
51730,VA,11808,14625,6704,9859,6530,4284,7294,15580,6704.122548,7030,10011,55417,3755,-16635,3137,4009,61104,59172,38782,58554,59426
51735,VA,13560,14625,6704,9859,6530,4284,7548,13812,6824.268114,7030,10106,55617,3755,-16635,3137,4009,63110,59372,38982,58754,59626
51740,VA,13560,14625,6704,9859,6530,4284,7548,14508,7016.501018,7030,10150,56548,4279,-15783,3925,4533,63110,60827,40765,60473,61081
51750,VA,8592,14625,6704,9859,6530,4284,6827,17001,7328.879488,7030,9310,53546,3231,-17159,2349,3485,57421,56777,36387,55895,57031
51760,VA,11808,14625,6704,9859,6530,4284,7294,16804,8121.84022,7030,10036,58084,4279,-15783,3925,4533,61104,62363,42301,62009,62617
51770,VA,8640,14625,6704,9859,6530,4284,6834,13060,6632.035209,7030,9426,49072,2444,-17946,1166,2698,57476,51516,31126,50238,51770
51775,VA,8640,14625,6704,9859,6530,4284,6834,15342,7064.559245,7030,9453,51814,2707,-17683,1561,2961,57476,54521,34131,53375,54775
51790,VA,8628,14625,6704,9859,6530,4284,6832,15634,7160.675697,7030,9440,52176,2707,-17683,1561,2961,57462,54883,34493,53737,55137
51800,VA,13560,14625,6704,9859,6530,4284,7548,13924,7136.646584,7030,10121,56055,3755,-16635,3137,4009,63110,59810,39420,59192,60064
51810,VA,13560,14625,6704,9859,6530,4284,7548,13976,7328.879488,7030,10148,56327,3755,-16635,3137,4009,63110,60082,39692,59464,60336
51820,VA,8628,14625,6704,9859,6530,4284,6832,15668,7088.588358,7030,9436,52135,2707,-17683,1561,2961,57462,54842,34452,53696,55096
51830,VA,13560,14625,6704,9859,6530,4284,7548,14933,7737.374411,7030,10144,57689,4279,-15783,3925,4533,63110,61968,41906,61614,62222
51840,VA,9648,14625,6704,9859,6530,4284,6980,14289,7112.617471,7030,9761,52125,2707,-17683,1561,2961,58630,54832,34442,53686,55086
53001,WA,7644,9307,8002,8509,5550,4344,5265,8862,8088.190859,5921,8648,43508,2883,-17034,1571,3610,48621,46391,26474,45079,47118
53003,WA,7908,9307,8002,8509,5550,4344,5296,8791,7514.560302,5921,8056,42535,2883,-17034,1571,3610,48916,45418,25501,44106,46145
53005,WA,9048,9307,8002,8509,5550,4344,5427,9656,7715.330997,5921,8843,45527,3621,-16296,2288,4348,50187,49148,29231,47815,49875
53007,WA,9708,9307,8002,8509,5550,4344,5503,9356,9292.81503,5921,8494,47116,3621,-16296,2288,4348,50923,50737,30820,49404,51464
53009,WA,9060,9307,8002,8509,5550,4344,5429,8864,8260.280027,5921,7761,44210,2883,-17034,1571,3610,50201,47093,27176,45781,47820
53011,WA,11064,9307,8002,8509,5550,4344,5659,10241,8059.509332,5921,8550,48180,4301,-15616,3364,5028,52435,52481,32564,51544,53208
53013,WA,7644,9307,8002,8509,5550,4344,5265,7765,7944.78322,5921,8141,41760,2006,-17691,854,2733,48621,43766,24069,42614,44493
53015,WA,8196,9307,8002,8509,5550,4344,5329,9217,8260.280027,5921,8071,44009,2883,-17034,1571,3610,49237,46892,26975,45580,47619
53017,WA,9708,9307,8002,8509,5550,4344,5503,9500,7801.375581,5921,8494,45768,3621,-16296,2288,4348,50923,49389,29472,48056,50116
53019,WA,7644,9307,8002,8509,5550,4344,5265,9307,8202.916971,5921,8509,43928,2883,-17034,1571,3610,48621,46811,26894,45499,47538
53021,WA,9048,9307,8002,8509,5550,4344,5427,8854,7916.101692,5921,8832,44915,3621,-16296,2288,4348,50187,48536,28619,47203,49263
53023,WA,7644,9307,8002,8509,5550,4344,5265,9307,8088.190859,5921,8509,43813,2883,-17034,1571,3610,48621,46696,26779,45384,47423
53025,WA,7920,9307,8002,8509,5550,4344,5297,9447,8518.413777,5921,8476,44626,3321,-16596,1930,4048,48929,47947,28030,46556,48674
53027,WA,8232,9307,8002,8509,5550,4344,5333,8341,9235.451974,5921,7851,43925,2444,-17473,1213,3171,49277,46369,26452,45138,47096
53029,WA,10752,9307,8002,8509,5550,4344,5624,9568,9378.859614,5921,8238,48201,3848,-16069,2647,4575,52088,52049,32132,50848,52776
53031,WA,10860,9307,8002,8509,5550,4344,5636,9307,10640.84684,5921,8509,49582,3848,-16069,2647,4575,52208,53430,33513,52229,54157
53033,WA,13476,9307,8002,8509,5550,4344,5937,12641,9235.451974,5921,9075,54692,5207,-14710,4798,5934,55125,59899,39982,59490,60626
53035,WA,11412,9307,8002,8509,5550,4344,5700,10286,8489.73225,5921,8803,49255,4301,-15616,3364,5028,52824,53556,33639,52619,54283
53037,WA,9540,9307,8002,8509,5550,4344,5484,9671,10009.85323,5921,8001,47487,3621,-16296,2288,4348,50736,51108,31191,49775,51835
53039,WA,7932,9307,8002,8509,5550,4344,5299,9307,8317.643082,5921,8509,44331,3321,-16596,1930,4048,48943,47652,27735,46261,48379
53041,WA,8796,9307,8002,8509,5550,4344,5398,8970,8575.776833,5921,7929,44536,2883,-17034,1571,3610,49906,47419,27502,46107,48146
53043,WA,7788,9307,8002,8509,5550,4344,5282,9307,8088.190859,5921,8509,43957,2883,-17034,1571,3610,48782,46840,26923,45528,47567
53045,WA,9888,9307,8002,8509,5550,4344,5524,8978,8604.458361,5921,8028,45764,3621,-16296,2288,4348,51124,49385,29468,48052,50112
53047,WA,7644,9307,8002,8509,5550,4344,5265,9307,7944.78322,5921,8509,43670,2883,-17034,1571,3610,48621,46553,26636,45241,47280
53049,WA,8340,9307,8002,8509,5550,4344,5346,9307,8288.961554,5921,8509,44710,3321,-16596,1930,4048,49398,48031,28114,46640,48758
53051,WA,7644,9307,8002,8509,5550,4344,5265,7929,8002.146276,5921,8168,42009,2444,-17473,1213,3171,48621,44453,24536,43222,45180
53053,WA,11988,9307,8002,8509,5550,4344,5766,10673,8432.369194,5921,9038,50397,4527,-15390,3722,5254,53466,54924,35007,54119,55651
53055,WA,10236,9307,8002,8509,5550,4344,5564,9307,8260.280027,5921,8509,46577,3848,-16069,2647,4575,51512,50425,30508,49224,51152
53057,WA,10896,9307,8002,8509,5550,4344,5640,10056,8202.916971,5921,8413,47833,4074,-15843,3005,4801,52248,51907,31990,50838,52634
53059,WA,11064,9307,8002,8509,5550,4344,5659,8848,8260.280027,5921,8549,46986,3848,-16069,2647,4575,52435,50834,30917,49633,51561
53061,WA,13476,9307,8002,8509,5550,4344,5937,11472,8633.139889,5921,9040,52886,5207,-14710,4798,5934,55125,58093,38176,57684,58820
53063,WA,8868,9307,8002,8509,5550,4344,5407,9175,8002.146276,5921,8110,44421,3321,-16596,1930,4048,49987,47742,27825,46351,48469
53065,WA,7644,9307,8002,8509,5550,4344,5265,8390,8145.553915,5921,8167,42611,2444,-17473,1213,3171,48621,45055,25138,43824,45782
53067,WA,11316,9307,8002,8509,5550,4344,5689,10208,8317.643082,5921,8818,48924,4301,-15616,3364,5028,52717,53225,33308,52288,53952
53069,WA,7644,9307,8002,8509,5550,4344,5265,9307,8260.280027,5921,8509,43985,2883,-17034,1571,3610,48621,46868,26951,45556,47595
53071,WA,8556,9307,8002,8509,5550,4344,5371,9043,9034.681279,5921,8114,45013,2883,-17034,1571,3610,49639,47896,27979,46584,48623
53073,WA,10620,9307,8002,8509,5550,4344,5608,10300,7944.78322,5921,8378,47507,4074,-15843,3005,4801,51940,51581,31664,50512,52308
53075,WA,8460,9307,8002,8509,5550,4344,5359,9976,9464.904197,5921,7516,45681,3321,-16596,1930,4048,49531,49002,29085,47611,49729
53077,WA,8784,9307,8002,8509,5550,4344,5397,8799,7973.464748,5921,8510,44331,3321,-16596,1930,4048,49893,47652,27735,46261,48379
54001,WV,7632,8949,6704,9859,4528,4284,6774,8949,6343.685852,8518,9859,45586,3435,-14548,4036,6096,48730,49021,31038,49622,51682
54003,WV,8892,8949,6704,9859,4528,4284,6969,8575,6415.773192,8518,9800,46485,3724,-14258,4458,6386,50185,50209,32227,50943,52871
54005,WV,6876,8949,6704,9859,4528,4284,6656,9391,6367.714965,8518,9277,44714,3435,-14548,4036,6096,47856,48149,30166,48750,50810
54007,WV,6876,8949,6704,9859,4528,4284,6656,8949,6391.744078,8518,9859,44878,3435,-14548,4036,6096,47856,48313,30330,48914,50974
54009,WV,7368,8949,6704,9859,4528,4284,6733,9350,6632.035209,8518,9086,45238,3435,-14548,4036,6096,48425,48673,30690,49274,51334
54011,WV,7716,8949,6704,9859,4528,4284,6787,9978,6415.773192,8518,9166,46077,3724,-14258,4458,6386,48827,49801,31819,50535,52463
54013,WV,6876,8949,6704,9859,4528,4284,6656,8949,6247.5694,8518,9859,44734,3435,-14548,4036,6096,47856,48169,30186,48770,50830
54015,WV,8652,8949,6704,9859,4528,4284,6932,10322,6415.773192,8518,9299,47491,4013,-13969,4879,6675,49908,51504,33522,52370,54166
54017,WV,7020,8949,6704,9859,4528,4284,6679,8572,6175.482061,8518,9315,43884,3072,-14910,3616,5734,48023,46956,28974,47500,49618
54019,WV,6876,8949,6704,9859,4528,4284,6656,9931,6415.773192,8518,8677,44702,3072,-14910,3616,5734,47856,47774,29792,48318,50436
54021,WV,7032,8949,6704,9859,4528,4284,6680,8949,6439.802305,8518,9859,45082,3435,-14548,4036,6096,48036,48517,30534,49118,51178
54023,WV,8316,8949,6704,9859,4528,4284,6880,8949,6487.860531,8518,9859,46414,3724,-14258,4458,6386,49520,50138,32156,50872,52800
54025,WV,7380,8949,6704,9859,4528,4284,6735,8949,6535.918757,8518,9859,45526,3435,-14548,4036,6096,48439,48961,30978,49562,51622
54027,WV,9648,8949,6704,9859,4528,4284,7087,8469,6415.773192,8518,9781,47116,4013,-13969,4879,6675,51059,51129,33147,51995,53791
54029,WV,7368,8949,6704,9859,4528,4284,6733,8814,6920.384566,8518,9069,44973,3072,-14910,3616,5734,48425,48045,30063,48589,50707
54031,WV,7272,8949,6704,9859,4528,4284,6718,8949,6656.064322,8518,9859,45538,3435,-14548,4036,6096,48314,48973,30990,49574,51634
54033,WV,8952,8949,6704,9859,4528,4284,6978,8999,6079.365608,8518,9287,46119,3724,-14258,4458,6386,50254,49843,31861,50577,52505
54035,WV,6876,8949,6704,9859,4528,4284,6656,8949,6367.714965,8518,9859,44854,3435,-14548,4036,6096,47856,48289,30306,48890,50950
54037,WV,10728,8949,6704,9859,4528,4284,7254,8361,6535.918757,8518,11174,49600,4591,-13391,5721,7253,52306,54191,36209,55321,56853
54039,WV,8652,8949,6704,9859,4528,4284,6932,7183,6439.802305,8518,9229,44305,3072,-14910,3616,5734,49908,47377,29395,47921,50039
54041,WV,7644,8949,6704,9859,4528,4284,6775,8949,6319.656739,8518,9859,45574,3435,-14548,4036,6096,48743,49009,31026,49610,51670
54043,WV,8652,8949,6704,9859,4528,4284,6932,11056,7473.054167,8518,9224,49207,4303,-13680,5300,6964,49908,53510,35527,54507,56171
54045,WV,6876,8949,6704,9859,4528,4284,6656,8600,6271.598513,8518,8424,42974,2571,-15411,3194,5233,47856,45545,27563,46168,48207
54047,WV,6876,8949,6704,9859,4528,4284,6656,8949,6199.511174,8518,9859,44686,3435,-14548,4036,6096,47856,48121,30138,48722,50782
54049,WV,7788,8949,6704,9859,4528,4284,6798,9459,7040.530132,8518,9408,46497,3724,-14258,4458,6386,48910,50221,32239,50955,52883
54051,WV,7368,8949,6704,9859,4528,4284,6733,11111,6680.093435,8518,9151,47112,4013,-13969,4879,6675,48425,51125,33143,51991,53787
54053,WV,6876,8949,6704,9859,4528,4284,6656,10053,6319.656739,8518,8837,44887,3435,-14548,4036,6096,47856,48322,30339,48923,50983
54055,WV,6876,8949,6704,9859,4528,4284,6656,9198,6415.773192,8518,8466,43758,3072,-14910,3616,5734,47856,46830,28848,47374,49492
54057,WV,7644,8949,6704,9859,4528,4284,6775,9929,6463.831418,8518,8734,45574,3435,-14548,4036,6096,48743,49009,31026,49610,51670
54059,WV,6876,8949,6704,9859,4528,4284,6656,8949,7184.70481,8518,9859,45671,3435,-14548,4036,6096,47856,49106,31123,49707,51767
54061,WV,9024,8949,6704,9859,4528,4284,6990,9067,6728.151662,8518,9530,47151,4013,-13969,4879,6675,50338,51164,33182,52030,53826
54063,WV,6876,8949,6704,9859,4528,4284,6656,8949,6728.151662,8518,9859,45214,3435,-14548,4036,6096,47856,48649,30666,49250,51310
54065,WV,8892,8949,6704,9859,4528,4284,6969,8949,6632.035209,8518,9859,47134,4013,-13969,4879,6675,50185,51147,33165,52013,53809
54067,WV,6876,8949,6704,9859,4528,4284,6656,8949,6391.744078,8518,9859,44878,3435,-14548,4036,6096,47856,48313,30330,48914,50974
54069,WV,7368,8949,6704,9859,4528,4284,6733,10538,7160.675697,8518,9090,46959,3724,-14258,4458,6386,48425,50683,32701,51417,53345
54071,WV,6876,8949,6704,9859,4528,4284,6656,8949,6632.035209,8518,9859,45118,3435,-14548,4036,6096,47856,48553,30570,49154,51214
54073,WV,7368,8949,6704,9859,4528,4284,6733,8949,6151.452948,8518,9859,45129,3435,-14548,4036,6096,48425,48564,30581,49165,51225
54075,WV,6876,8949,6704,9859,4528,4284,6656,8949,6415.773192,8518,9859,44902,3435,-14548,4036,6096,47856,48337,30354,48938,50998
54077,WV,9024,8949,6704,9859,4528,4284,6990,9605,6535.918757,8518,9579,47546,4013,-13969,4879,6675,50338,51559,33577,52425,54221
54079,WV,8652,8949,6704,9859,4528,4284,6932,8582,7088.588358,8518,9212,46336,3435,-14548,4036,6096,49908,49771,31788,50372,52432
54081,WV,7992,8949,6704,9859,4528,4284,6829,9597,6175.482061,8518,8615,45182,3435,-14548,4036,6096,49145,48617,30634,49218,51278
54083,WV,7632,8949,6704,9859,4528,4284,6774,10164,6439.802305,8518,8739,45776,3724,-14258,4458,6386,48730,49500,31518,50234,52162
54085,WV,6876,8949,6704,9859,4528,4284,6656,8949,6103.394722,8518,9859,44589,3435,-14548,4036,6096,47856,48024,30041,48625,50685
54087,WV,6876,8949,6704,9859,4528,4284,6656,8949,6415.773192,8518,9859,44902,3435,-14548,4036,6096,47856,48337,30354,48938,50998
54089,WV,6924,8949,6704,9859,4528,4284,6664,8949,6319.656739,8518,9859,44854,3435,-14548,4036,6096,47912,48289,30306,48890,50950
54091,WV,6876,8949,6704,9859,4528,4284,6656,10699,6511.889644,8518,9301,46190,3724,-14258,4458,6386,47856,49914,31932,50648,52576
54093,WV,6876,8949,6704,9859,4528,4284,6656,8949,6559.94787,8518,9859,45046,3435,-14548,4036,6096,47856,48481,30498,49082,51142
54095,WV,6876,8949,6704,9859,4528,4284,6656,8949,6391.744078,8518,9859,44878,3435,-14548,4036,6096,47856,48313,30330,48914,50974
54097,WV,6876,8949,6704,9859,4528,4284,6656,8949,6367.714965,8518,9859,44854,3435,-14548,4036,6096,47856,48289,30306,48890,50950
54099,WV,7716,8949,6704,9859,4528,4284,6787,11050,6175.482061,8518,9214,46957,4013,-13969,4879,6675,48827,50970,32988,51836,53632
54101,WV,6876,8949,6704,9859,4528,4284,6656,8949,6439.802305,8518,9859,44926,3435,-14548,4036,6096,47856,48361,30378,48962,51022
54103,WV,6972,8949,6704,9859,4528,4284,6671,8949,6367.714965,8518,9859,44950,3435,-14548,4036,6096,47967,48385,30402,48986,51046
54105,WV,7368,8949,6704,9859,4528,4284,6733,9451,6127.423835,8518,9257,45005,3435,-14548,4036,6096,48425,48440,30457,49041,51101
54107,WV,7368,8949,6704,9859,4528,4284,6733,8389,6007.278269,8518,9230,43796,3072,-14910,3616,5734,48425,46868,28886,47412,49530
54109,WV,6876,8949,6704,9859,4528,4284,6656,8949,7400.966828,8518,9859,45887,3435,-14548,4036,6096,47856,49322,31339,49923,51983
55001,WI,7644,7824,6849,9589,5516,4046,8637,7824,6358.148482,8342,9589,43803,4836,-15461,3065,5183,50105,48639,28342,46868,48986
55003,WI,7644,7824,6849,9589,5516,4046,8637,7824,6898.222871,8342,9589,44343,4836,-15461,3065,5183,50105,49179,28882,47408,49526
55005,WI,8052,7824,6849,9589,5516,4046,8708,7824,5793.525258,8342,9589,43647,4836,-15461,3065,5183,50584,48483,28186,46712,48830
55007,WI,7764,7824,6849,9589,5516,4046,8658,7824,6898.222871,8342,9589,44463,4836,-15461,3065,5183,50246,49299,29002,47528,49646
55009,WI,8172,7824,6849,9589,5516,4046,8729,9048,6382.697318,8342,9557,45548,5459,-14838,3878,5806,50725,51007,30710,49426,51354
55011,WI,8568,7824,6849,9589,5516,4046,8797,7824,6529.990333,8342,9589,44899,5181,-15116,3468,5528,51189,50080,29783,48367,50427
55013,WI,7644,7824,6849,9589,5516,4046,8637,7824,6652.734512,8342,9589,44098,4836,-15461,3065,5183,50105,48934,28637,47163,49281
55015,WI,8040,7824,6849,9589,5516,4046,8706,8234,6112.660124,8342,9901,44675,5181,-15116,3468,5528,50570,49856,29559,48143,50203
55017,WI,8880,7824,6849,9589,5516,4046,8852,6773,5842.62293,8342,9464,43348,4836,-15461,3065,5183,51556,48184,27887,46413,48531
55019,WI,7644,7824,6849,9589,5516,4046,8637,7824,6750.929856,8342,9589,44196,4836,-15461,3065,5183,50105,49032,28735,47261,49379
55021,WI,8736,7824,6849,9589,5516,4046,8827,7912,6947.320542,8342,10048,46031,5181,-15116,3468,5528,51387,51212,30915,49499,51559
55023,WI,7644,7824,6849,9589,5516,4046,8637,7824,6161.757796,8342,9589,43607,4836,-15461,3065,5183,50105,48443,28146,46672,48790
55025,WI,10776,7824,6849,9589,5516,4046,9181,7798,6922.771707,8342,10062,47947,5745,-14552,4296,6092,53781,53692,33395,52243,54039
55027,WI,8856,7824,6849,9589,5516,4046,8847,6982,6259.953139,8342,9560,44046,4836,-15461,3065,5183,51527,48882,28585,47111,49229
55029,WI,8256,7824,6849,9589,5516,4046,8743,7824,7953.822812,8342,9589,46011,4836,-15461,3065,5183,50823,50847,30550,49076,51194
55031,WI,8304,7824,6849,9589,5516,4046,8752,6905,7045.515886,8342,9100,43743,4353,-15944,2661,4700,50880,48096,27799,46404,48443
55033,WI,8040,7824,6849,9589,5516,4046,8706,7053,5818.074094,8342,9484,42783,4353,-15944,2661,4700,50570,47136,26839,45444,47483
55035,WI,8880,7824,6849,9589,5516,4046,8852,7070,6137.20896,8342,9456,43931,4836,-15461,3065,5183,51556,48767,28470,46996,49114
55037,WI,7644,7824,6849,9589,5516,4046,8637,7299,6112.660124,8342,9007,42451,4353,-15944,2661,4700,50105,46804,26507,45112,47151
55039,WI,8148,7824,6849,9589,5516,4046,8724,9342,6431.79499,8342,9543,45853,5459,-14838,3878,5806,50696,51312,31015,49731,51659
55041,WI,7644,7824,6849,9589,5516,4046,8637,7824,6161.757796,8342,9589,43607,4836,-15461,3065,5183,50105,48443,28146,46672,48790
55043,WI,7644,7824,6849,9589,5516,4046,8637,7911,6039.013616,8342,9357,43338,4836,-15461,3065,5183,50105,48174,27877,46403,48521
55045,WI,7920,7824,6849,9589,5516,4046,8685,7394,6088.111288,8342,10053,43842,4836,-15461,3065,5183,50429,48678,28381,46907,49025
55047,WI,7644,7824,6849,9589,5516,4046,8637,7824,6554.539169,8342,9589,44000,4836,-15461,3065,5183,50105,48836,28539,47065,49183
55049,WI,9084,7824,6849,9589,5516,4046,8887,7499,7192.808901,8342,10041,46204,5181,-15116,3468,5528,51795,51385,31088,49672,51732
55051,WI,7644,7824,6849,9589,5516,4046,8637,7824,6922.771707,8342,9589,44368,4836,-15461,3065,5183,50105,49204,28907,47433,49551
55053,WI,8124,7824,6849,9589,5516,4046,8720,7824,6726.38102,8342,9589,44651,4836,-15461,3065,5183,50668,49487,29190,47716,49834
55055,WI,9528,7824,6849,9589,5516,4046,8964,7299,6382.697318,8342,9677,45275,5181,-15116,3468,5528,52316,50456,30159,48743,50803
55057,WI,7824,7824,6849,9589,5516,4046,8668,7824,7364.650752,8342,9589,44990,4836,-15461,3065,5183,50316,49826,29529,48055,50173
55059,WI,11640,7824,6849,9589,5516,4046,9331,6855,6529.990333,8342,10243,47656,5745,-14552,4296,6092,54795,53401,33104,51952,53748
55061,WI,8172,7824,6849,9589,5516,4046,8729,7213,6849.125199,8342,9562,44184,4836,-15461,3065,5183,50725,49020,28723,47249,49367
55063,WI,8388,7824,6849,9589,5516,4046,8766,7828,6186.306631,8342,9551,44341,5181,-15116,3468,5528,50978,49522,29225,47809,49869
55065,WI,7644,7824,6849,9589,5516,4046,8637,7824,6382.697318,8342,9589,43828,4836,-15461,3065,5183,50105,48664,28367,46893,49011
55067,WI,7644,7824,6849,9589,5516,4046,8637,7824,6235.404303,8342,9589,43680,4836,-15461,3065,5183,50105,48516,28219,46745,48863
55069,WI,7644,7824,6849,9589,5516,4046,8637,7162,6750.929856,8342,9165,43110,4353,-15944,2661,4700,50105,47463,27166,45771,47810
55071,WI,7644,7824,6849,9589,5516,4046,8637,9487,6309.050811,8342,9343,45171,5181,-15116,3468,5528,50105,50352,30055,48639,50699
55073,WI,7752,7824,6849,9589,5516,4046,8656,7692,6259.953139,8342,9656,43748,4836,-15461,3065,5183,50232,48584,28287,46813,48931
55075,WI,7644,7824,6849,9589,5516,4046,8637,7331,5842.62293,8342,8729,41934,3869,-16428,2258,4216,50105,45803,25506,44192,46150
55077,WI,8268,7824,6849,9589,5516,4046,8745,7824,6554.539169,8342,9589,44624,4836,-15461,3065,5183,50837,49460,29163,47689,49807
55078,WI,8004,7824,6849,9589,5516,4046,8699,8177,6088.111288,8342,9231,43888,4836,-15461,3065,5183,50527,48724,28427,46953,49071
55079,WI,9744,7824,6849,9589,5516,4046,9002,7384,6382.697318,8342,9517,45416,5181,-15116,3468,5528,52570,50597,30300,48884,50944
55081,WI,8604,7824,6849,9589,5516,4046,8804,7824,5891.720601,8342,9589,44297,5181,-15116,3468,5528,51232,49478,29181,47765,49825
55083,WI,7644,7824,6849,9589,5516,4046,8637,7297,6579.088005,8342,9562,43471,4353,-15944,2661,4700,50105,47824,27527,46132,48171
55085,WI,8376,7824,6849,9589,5516,4046,8764,7824,6137.20896,8342,9589,44314,5181,-15116,3468,5528,50964,49495,29198,47782,49842
55087,WI,8040,7824,6849,9589,5516,4046,8706,7028,6579.088005,8342,9912,43947,4836,-15461,3065,5183,50570,48783,28486,47012,49130
55089,WI,9744,7824,6849,9589,5516,4046,9002,7346,6701.832184,8342,9534,45714,5181,-15116,3468,5528,52570,50895,30598,49182,51242
55091,WI,7644,7824,6849,9589,5516,4046,8637,7824,6431.79499,8342,9589,43877,4836,-15461,3065,5183,50105,48713,28416,46942,49060
55093,WI,11352,7824,6849,9589,5516,4046,9281,7221,8420.250693,8342,10284,49665,6032,-14265,4715,6379,54457,55697,35400,54380,56044
55095,WI,9084,7824,6849,9589,5516,4046,8887,7824,6971.869378,8342,9589,45857,5181,-15116,3468,5528,51795,51038,30741,49325,51385
55097,WI,8316,7824,6849,9589,5516,4046,8754,7324,6554.539169,8342,9441,44023,4836,-15461,3065,5183,50894,48859,28562,47088,49206
55099,WI,7644,7824,6849,9589,5516,4046,8637,7824,6259.953139,8342,9589,43705,4836,-15461,3065,5183,50105,48541,28244,46770,48888
55101,WI,8820,7824,6849,9589,5516,4046,8841,9194,6456.343826,8342,9534,46393,5459,-14838,3878,5806,51485,51852,31555,50271,52199
55103,WI,7728,7824,6849,9589,5516,4046,8652,7824,6677.283348,8342,9589,44206,4836,-15461,3065,5183,50204,49042,28745,47271,49389
55105,WI,9252,7824,6849,9589,5516,4046,8916,8598,6039.013616,8342,9363,45639,5459,-14838,3878,5806,51992,51098,30801,49517,51445
55107,WI,7644,7824,6849,9589,5516,4046,8637,7824,6063.562452,8342,9589,43509,4836,-15461,3065,5183,50105,48345,28048,46574,48692
55109,WI,11352,7824,6849,9589,5516,4046,9281,8297,6505.441497,8342,10285,48827,6318,-13979,5133,6665,54457,55145,34848,53960,55492
55111,WI,9252,7824,6849,9589,5516,4046,8916,9046,6259.953139,8342,9578,46524,5745,-14552,4296,6092,51992,52269,31972,50820,52616
55113,WI,7716,7824,6849,9589,5516,4046,8649,7824,6382.697318,8342,9589,43900,4836,-15461,3065,5183,50189,48736,28439,46965,49083
55115,WI,7644,7824,6849,9589,5516,4046,8637,10846,5744.427586,8342,9219,45841,5459,-14838,3878,5806,50105,51300,31003,49719,51647
55117,WI,8628,7824,6849,9589,5516,4046,8808,8977,6750.929856,8342,9540,46284,5459,-14838,3878,5806,51260,51743,31446,50162,52090
55119,WI,7644,7824,6849,9589,5516,4046,8637,7824,6800.027527,8342,9589,44245,4836,-15461,3065,5183,50105,49081,28784,47310,49428
55121,WI,7644,7824,6849,9589,5516,4046,8637,7824,6898.222871,8342,9589,44343,4836,-15461,3065,5183,50105,49179,28882,47408,49526
55123,WI,7644,7824,6849,9589,5516,4046,8637,7824,6800.027527,8342,9589,44245,4836,-15461,3065,5183,50105,49081,28784,47310,49428
55125,WI,8532,7824,6849,9589,5516,4046,8791,7824,7168.260065,8342,9589,45501,5181,-15116,3468,5528,51147,50682,30385,48969,51029
55127,WI,9432,7824,6849,9589,5516,4046,8947,8330,6750.929856,8342,9635,46536,5459,-14838,3878,5806,52203,51995,31698,50414,52342
55129,WI,8628,7824,6849,9589,5516,4046,8808,7824,6480.892661,8342,9589,44910,5181,-15116,3468,5528,51260,50091,29794,48378,50438
55131,WI,9744,7824,6849,9589,5516,4046,9002,8891,6628.185677,8342,9534,47185,5745,-14552,4296,6092,52570,52930,32633,51481,53277
55133,WI,9744,7824,6849,9589,5516,4046,9002,8888,6898.222871,8342,9532,47450,5745,-14552,4296,6092,52570,53195,32898,51746,53542
55135,WI,7824,7824,6849,9589,5516,4046,8668,7824,5916.269437,8342,9589,43541,4836,-15461,3065,5183,50316,48377,28080,46606,48724
55137,WI,7740,7824,6849,9589,5516,4046,8654,7824,6824.576363,8342,9589,44366,4836,-15461,3065,5183,50218,49202,28905,47431,49549
55139,WI,7836,7824,6849,9589,5516,4046,8670,7935,6849.125199,8342,9352,44360,4836,-15461,3065,5183,50330,49196,28899,47425,49543
55141,WI,7644,7824,6849,9589,5516,4046,8637,8812,6259.953139,8342,9171,44276,4836,-15461,3065,5183,50105,49112,28815,47341,49459
56001,WY,8952,4142,8002,8509,5429,4344,5732,4495,9522.267253,10385,8068,45766,-3641,-18831,-305,1813,45110,42125,26935,45461,47579
56003,WY,7644,4142,8002,8509,5429,4344,5581,4142,8059.509332,10385,8509,43084,-4079,-19269,-664,1375,43651,39005,23815,42420,44459
56005,WY,10692,4142,8002,8509,5429,4344,5933,4800,8661.821417,10385,9684,48567,-2888,-18078,770,2566,47051,45679,30489,49337,51133
56007,WY,8184,4142,8002,8509,5429,4344,5644,4142,9005.999751,10385,8509,44570,-4079,-19269,-664,1375,44254,40491,25301,43906,45945
56009,WY,7656,4142,8002,8509,5429,4344,5583,4142,8403.687666,10385,8509,43440,-4079,-19269,-664,1375,43665,39361,24171,42776,44815
56011,WY,7644,4142,8002,8509,5429,4344,5581,4142,8661.821417,10385,8509,43686,-4079,-19269,-664,1375,43651,39607,24417,43022,45061
56013,WY,8664,4142,8002,8509,5429,4344,5699,3475,8891.27364,10385,8395,44154,-4079,-19269,-664,1375,44789,40075,24885,43490,45529
56015,WY,7644,4142,8002,8509,5429,4344,5581,4142,8145.553915,10385,8509,43170,-4079,-19269,-664,1375,43651,39091,23901,42506,44545
56017,WY,7644,4142,8002,8509,5429,4344,5581,4142,8776.547528,10385,8509,43801,-4079,-19269,-664,1375,43651,39722,24532,43137,45176
56019,WY,7644,4142,8002,8509,5429,4344,5581,4142,8575.776833,10385,8509,43600,-4079,-19269,-664,1375,43651,39521,24331,42936,44975
56021,WY,9468,4142,8002,8509,5429,4344,5792,4031,8088.190859,10385,8599,44916,-3641,-18831,-305,1813,45686,41275,26085,44611,46729
56023,WY,9144,4142,8002,8509,5429,4344,5754,4142,7629.286413,10385,8509,44153,-3641,-18831,-305,1813,45324,40512,25322,43848,45966
56025,WY,9144,4142,8002,8509,5429,4344,5754,3592,8317.643082,10385,8634,44417,-3641,-18831,-305,1813,45324,40776,25586,44112,46230
56027,WY,7656,4142,8002,8509,5429,4344,5583,4142,8346.32461,10385,8509,43382,-4079,-19269,-664,1375,43665,39303,24113,42718,44757
56029,WY,7944,4142,8002,8509,5429,4344,5616,4142,8633.139889,10385,8509,43957,-4079,-19269,-664,1375,43986,39878,24688,43293,45332
56031,WY,7644,4142,8002,8509,5429,4344,5581,4142,8432.369194,10385,8509,43456,-4079,-19269,-664,1375,43651,39377,24187,42792,44831
56033,WY,9624,4142,8002,8509,5429,4344,5810,3697,9063.362807,10385,8222,45336,-3641,-18831,-305,1813,45860,41695,26505,45031,47149
56035,WY,11532,4142,8002,8509,5429,4344,6029,4142,9235.451974,10385,8509,48147,-3114,-18304,412,2340,47987,45033,29843,48559,50487
56037,WY,10908,4142,8002,8509,5429,4344,5957,4491,8747.866,10385,9331,48207,-2888,-18078,770,2566,47291,45319,30129,48977,50773
56039,WY,11916,4142,8002,8509,5429,4344,6074,5269,11357.88504,10385,9452,52724,-2435,-17625,1487,3019,48416,50289,35099,54211,55743
56041,WY,7812,4142,8002,8509,5429,4344,5601,4095,8174.235443,10385,8910,43721,-4079,-19269,-664,1375,43839,39642,24452,43057,45096
56043,WY,7644,4142,8002,8509,5429,4344,5581,4142,8575.776833,10385,8509,43600,-4079,-19269,-664,1375,43651,39521,24331,42936,44975
56045,WY,7644,4142,8002,8509,5429,4344,5581,4142,8375.006138,10385,8509,43399,-4079,-19269,-664,1375,43651,39320,24130,42735,44774
