FIPS,State,Housing,ChildCare,Food,Transportation,Medical,Other,Taxes,MIDS ChildCare,MIDS Food,MIDS Medical,MIDS Transportation,MIDS Net,MIDS Taxes All,3x EITC Tax,Basic Income Tax,Mids Taxes Universal,MIT LWC,MIDS LWC,3x EITC,Basic Income,MIDS LWC 2
1001,AL,8520,5062,4457,8554,5619,3916,5607,4639,4888.411939,5356,8305,35625,4937,-7080,-236,4997,41735,40562,28545,35389,40622
1003,AL,9924,5062,4457,8554,5619,3916,5825,5085,5048.163963,5356,8359,37688,5871,-6146,581,5931,43357,43559,31542,38269,43619
1005,AL,6996,5062,4457,8554,5619,3916,5371,5062,4824.511129,5356,8554,34709,4470,-7547,-644,4530,39975,39179,27162,34065,39239
1007,AL,8916,5062,4457,8554,5619,3916,5669,4913,4840.486331,5356,8350,36292,5404,-6613,173,5464,42193,41696,29679,36465,41756
1009,AL,8916,5062,4457,8554,5619,3916,5669,4484,4536.957486,5356,8352,35561,4937,-7080,-236,4997,42193,40498,28481,35325,40558
1011,AL,6792,5062,4457,8554,5619,3916,5339,5062,4648.783903,5356,8554,34329,4470,-7547,-644,4530,39739,38799,26782,33685,38859
1013,AL,6792,5062,4457,8554,5619,3916,5339,5062,4664.759105,5356,8554,34345,4470,-7547,-644,4530,39739,38815,26798,33701,38875
1015,AL,8148,5062,4457,8554,5619,3916,5549,4992,4824.511129,5356,7747,34983,4470,-7547,-644,4530,41305,39453,27436,34339,39513
1017,AL,7392,5062,4457,8554,5619,3916,5432,4721,4425.131069,5356,7391,33201,4003,-8014,-1053,4063,40432,37204,25187,32148,37264
1019,AL,6792,5062,4457,8554,5619,3916,5339,5062,4648.783903,5356,8554,34329,4470,-7547,-644,4530,39739,38799,26782,33685,38859
1021,AL,6792,5062,4457,8554,5619,3916,5339,4976,4457.081474,5356,8349,33847,4003,-8014,-1053,4063,39739,37850,25833,32794,37910
1023,AL,8304,5062,4457,8554,5619,3916,5574,5062,4568.90789,5356,8554,35761,4937,-7080,-236,4997,41486,40698,28681,35525,40758
1025,AL,6792,5062,4457,8554,5619,3916,5339,5062,4680.734307,5356,8554,34361,4470,-7547,-644,4530,39739,38831,26814,33717,38891
1027,AL,6792,5062,4457,8554,5619,3916,5339,5062,4744.635117,5356,8554,34425,4470,-7547,-644,4530,39739,38895,26878,33781,38955
1029,AL,7164,5062,4457,8554,5619,3916,5397,5062,4616.833498,5356,8554,34669,4470,-7547,-644,4530,40169,39139,27122,34025,39199
1031,AL,7176,5062,4457,8554,5619,3916,5399,4952,4728.659915,5356,8265,34394,4470,-7547,-644,4530,40183,38864,26847,33750,38924
1033,AL,7632,5062,4457,8554,5619,3916,5469,4982,4552.932688,5356,7925,34364,4470,-7547,-644,4530,40709,38834,26817,33720,38894
1035,AL,6792,5062,4457,8554,5619,3916,5339,5062,4728.659915,5356,8554,34409,4470,-7547,-644,4530,39739,38879,26862,33765,38939
1037,AL,6792,5062,4457,8554,5619,3916,5339,4606,4776.585522,5356,7537,32983,3536,-8481,-1461,3596,39739,36519,24502,31522,36579
1039,AL,6792,5062,4457,8554,5619,3916,5339,5062,4808.535927,5356,8554,34489,4470,-7547,-644,4530,39739,38959,26942,33845,39019
1041,AL,6900,5062,4457,8554,5619,3916,5356,5062,4552.932688,5356,8554,34341,4470,-7547,-644,4530,39864,38811,26794,33697,38871
1043,AL,6924,5062,4457,8554,5619,3916,5359,4719,4265.379045,5356,7741,32922,3536,-8481,-1461,3596,39891,36458,24441,31461,36518
1045,AL,6792,5062,4457,8554,5619,3916,5339,5193,4345.255057,5356,8203,33804,4003,-8014,-1053,4063,39739,37807,25790,32751,37867
1047,AL,6792,5062,4457,8554,5619,3916,5339,4708,4648.783903,5356,7122,32542,3536,-8481,-1461,3596,39739,36078,24061,31081,36138
1049,AL,7068,5062,4457,8554,5619,3916,5382,5062,4648.783903,5356,8554,34605,4470,-7547,-644,4530,40058,39075,27058,33961,39135
1051,AL,8520,5062,4457,8554,5619,3916,5607,4797,4856.461534,5356,8310,35756,4937,-7080,-236,4997,41735,40693,28676,35520,40753
1053,AL,6792,5062,4457,8554,5619,3916,5339,5062,4712.684712,5356,8554,34393,4470,-7547,-644,4530,39739,38863,26846,33749,38923
1055,AL,7152,5062,4457,8554,5619,3916,5395,4720,4313.304652,5356,7669,33126,4003,-8014,-1053,4063,40155,37129,25112,32073,37189
1057,AL,6792,5062,4457,8554,5619,3916,5339,5062,4696.70951,5356,8554,34377,4470,-7547,-644,4530,39739,38847,26830,33733,38907
1059,AL,6876,5062,4457,8554,5619,3916,5352,5062,4345.255057,5356,8554,34109,4470,-7547,-644,4530,39836,38579,26562,33465,38639
1061,AL,6792,5062,4457,8554,5619,3916,5339,5167,4664.759105,5356,8097,33993,4003,-8014,-1053,4063,39739,37996,25979,32940,38056
1063,AL,9780,5062,4457,8554,5619,3916,5803,5062,4824.511129,5356,8554,37493,5871,-6146,581,5931,43191,43364,31347,38074,43424
1065,AL,9780,5062,4457,8554,5619,3916,5803,4592,4824.511129,5356,8332,36801,5404,-6613,173,5464,43191,42205,30188,36974,42265
1067,AL,6792,5062,4457,8554,5619,3916,5339,4762,4696.70951,5356,8106,33629,4003,-8014,-1053,4063,39739,37632,25615,32576,37692
1069,AL,6792,5062,4457,8554,5619,3916,5339,5668,4744.635117,5356,8061,34538,4470,-7547,-644,4530,39739,39008,26991,33894,39068
1071,AL,6792,5062,4457,8554,5619,3916,5339,4709,4616.833498,5356,7693,33082,4003,-8014,-1053,4063,39739,37085,25068,32029,37145
1073,AL,8916,5062,4457,8554,5619,3916,5669,5054,4313.304652,5356,8339,35895,4937,-7080,-236,4997,42193,40832,28815,35659,40892
1075,AL,6792,5062,4457,8554,5619,3916,5339,5062,4568.90789,5356,8554,34249,4470,-7547,-644,4530,39739,38719,26702,33605,38779
1077,AL,7632,5062,4457,8554,5619,3916,5469,5004,4233.42864,5356,7925,34067,4470,-7547,-644,4530,40709,38537,26520,33423,38597
1079,AL,7140,5062,4457,8554,5619,3916,5393,4584,4536.957486,5356,8197,33729,4003,-8014,-1053,4063,40141,37732,25715,32676,37792
1081,AL,8688,5062,4457,8554,5619,3916,5633,4888,4920.362344,5356,8207,35975,4937,-7080,-236,4997,41929,40912,28895,35739,40972
1083,AL,8268,5062,4457,8554,5619,3916,5568,4946,4728.659915,5356,8542,35756,4937,-7080,-236,4997,41444,40693,28676,35520,40753
1085,AL,8520,5062,4457,8554,5619,3916,5607,4802,4648.783903,5356,8322,35565,4937,-7080,-236,4997,41735,40502,28485,35329,40562
1087,AL,6792,5062,4457,8554,5619,3916,5339,5062,5175.965582,5356,8554,34856,4470,-7547,-644,4530,39739,39326,27309,34212,39386
1089,AL,8268,5062,4457,8554,5619,3916,5568,4582,4329.279854,5356,8537,34988,4470,-7547,-644,4530,41444,39458,27441,34344,39518
1091,AL,6792,5062,4457,8554,5619,3916,5339,5062,4808.535927,5356,8554,34489,4470,-7547,-644,4530,39739,38959,26942,33845,39019
1093,AL,6792,5062,4457,8554,5619,3916,5339,5062,4536.957486,5356,8554,34217,4470,-7547,-644,4530,39739,38687,26670,33573,38747
1095,AL,6816,5062,4457,8554,5619,3916,5343,5267,4505.007081,5356,7877,33737,4003,-8014,-1053,4063,39767,37740,25723,32684,37800
1097,AL,9240,5062,4457,8554,5619,3916,5719,5041,4760.610319,5356,8185,36499,5404,-6613,173,5464,42567,41903,29886,36672,41963
1099,AL,6792,5062,4457,8554,5619,3916,5339,5062,4696.70951,5356,8554,34377,4470,-7547,-644,4530,39739,38847,26830,33733,38907
1101,AL,8520,5062,4457,8554,5619,3916,5607,5176,4473.056676,5356,8298,35739,4937,-7080,-236,4997,41735,40676,28659,35503,40736
1103,AL,7140,5062,4457,8554,5619,3916,5393,5517,4297.329449,5356,8166,34393,4470,-7547,-644,4530,40141,38863,26846,33749,38923
1105,AL,6792,5062,4457,8554,5619,3916,5339,5062,4680.734307,5356,8554,34361,4470,-7547,-644,4530,39739,38831,26814,33717,38891
1107,AL,6792,5062,4457,8554,5619,3916,5339,5058,4776.585522,5356,8339,34237,4470,-7547,-644,4530,39739,38707,26690,33593,38767
1109,AL,6792,5062,4457,8554,5619,3916,5339,5349,4824.511129,5356,7520,33758,4003,-8014,-1053,4063,39739,37761,25744,32705,37821
1111,AL,7344,5062,4457,8554,5619,3916,5425,5062,4457.081474,5356,8554,34689,4470,-7547,-644,4530,40377,39159,27142,34045,39219
1113,AL,8460,5062,4457,8554,5619,3916,5598,4833,4792.560724,5356,8182,35540,4937,-7080,-236,4997,41666,40477,28460,35304,40537
1115,AL,8916,5062,4457,8554,5619,3916,5669,6964,4792.560724,5356,8345,38289,6338,-5679,990,6398,42193,44627,32610,39279,44687
1117,AL,8916,5062,4457,8554,5619,3916,5669,6261,4776.585522,5356,8346,37572,5871,-6146,581,5931,42193,43443,31426,38153,43503
1119,AL,6792,5062,4457,8554,5619,3916,5339,5062,4536.957486,5356,8554,34217,4470,-7547,-644,4530,39739,38687,26670,33573,38747
1121,AL,6792,5062,4457,8554,5619,3916,5339,7175,4616.833498,5356,7486,35342,4937,-7080,-236,4997,39739,40279,28262,35106,40339
1123,AL,6876,5062,4457,8554,5619,3916,5352,5062,4728.659915,5356,8554,34493,4470,-7547,-644,4530,39836,38963,26946,33849,39023
1125,AL,9780,5062,4457,8554,5619,3916,5803,6407,4936.337546,5356,8342,38737,6338,-5679,990,6398,43191,45075,33058,39727,45135
1127,AL,6792,5062,4457,8554,5619,3916,5339,5269,4568.90789,5356,8347,34248,4470,-7547,-644,4530,39739,38718,26701,33604,38778
1129,AL,6792,5062,4457,8554,5619,3916,5339,5062,4696.70951,5356,8554,34377,4470,-7547,-644,4530,39739,38847,26830,33733,38907
1131,AL,6792,5062,4457,8554,5619,3916,5339,5062,4808.535927,5356,8554,34489,4470,-7547,-644,4530,39739,38959,26942,33845,39019
1133,AL,6792,5062,4457,8554,5619,3916,5339,5062,4600.858295,5356,8554,34281,4470,-7547,-644,4530,39739,38751,26734,33637,38811
2013,AK,8556,7977,5319,7382,6609,3971,4587,7977,7587.816121,12537,7382,48011,5514,-4815,2964,7262,44401,53525,43196,50975,55273
2016,AK,17232,7977,5319,7382,6609,3971,5586,7977,9951.859335,12537,7382,59051,7779,-1981,6549,9527,54076,66830,57070,65600,68578
2020,AK,13752,7977,5319,7382,6609,3971,5185,8759,6043.562087,12537,8271,53334,6420,-3909,4398,8168,50195,59754,49425,57732,61502
2050,AK,14208,7977,5319,7382,6609,3971,5238,7977,6329.535056,12537,7382,52405,6420,-3909,4398,8168,50704,58825,48496,56803,60573
2060,AK,12120,7977,5319,7382,6609,3971,4997,7977,6291.405327,12537,7382,50278,5967,-4362,3681,7715,48375,56245,45916,53959,57993
2068,AK,7644,7977,5319,7382,6609,3971,4482,7977,6253.275598,12537,7382,45764,-1272,-11600,-4217,477,43384,44492,34164,41547,46241
2070,AK,12384,7977,5319,7382,6609,3971,5028,7977,6348.599921,12537,7382,50600,5967,-4362,3681,7715,48670,56567,46238,54281,58315
2090,AK,15912,7977,5319,7382,6609,3971,5434,10067,6615.508025,12537,7959,57061,7326,-2755,5832,9074,52604,64387,54306,62893,66135
2100,AK,9816,7977,5319,7382,6609,3971,4732,7977,6062.626951,12537,7382,47746,-819,-11147,-3500,930,45806,46927,36599,44246,48676
2105,AK,8748,7977,5319,7382,6609,3971,4609,7977,5757.589117,12537,7382,46373,-1045,-11373,-3858,704,44615,45328,35000,42515,47077
2110,AK,14616,7977,5319,7382,6609,3971,5285,8889,5700.394523,12537,8189,53902,6420,-3909,4398,8168,51159,60322,49993,58300,62070
2122,AK,9912,7977,5319,7382,6609,3971,4743,7977,7759.399903,12537,7382,49538,5740,-4589,3322,7488,45913,55278,44949,52860,57026
2130,AK,11580,7977,5319,7382,6609,3971,4935,7219,5547.875606,12537,7755,48610,5514,-4815,2964,7262,47773,54124,43795,51574,55872
2150,AK,12276,7977,5319,7382,6609,3971,5015,7977,6310.470191,12537,7382,50453,5967,-4362,3681,7715,48549,56420,46091,54134,58168
2164,AK,8520,7977,5319,7382,6609,3971,4583,7977,6291.405327,12537,7382,46678,-1045,-11373,-3858,704,44361,45633,35305,42820,47382
2170,AK,12972,7977,5319,7382,6609,3971,5095,7111,7130.25937,12537,8050,51771,5967,-4362,3681,7715,49325,57738,47409,55452,59486
2180,AK,16320,7977,5319,7382,6609,3971,5481,7977,7587.816121,12537,7382,55775,6873,-3456,5115,8621,53059,62648,52319,60890,64396
2185,AK,11232,7977,5319,7382,6609,3971,4895,7977,6691.767484,12537,7382,49791,5740,-4589,3322,7488,47385,55531,45202,53113,57279
2188,AK,13692,7977,5319,7382,6609,3971,5178,7977,7092.129641,12537,7382,52651,6420,-3909,4398,8168,50128,59071,48742,57049,60819
2195,AK,9936,7977,5319,7382,6609,3971,4746,7977,5757.589117,12537,7382,47561,-819,-11147,-3500,930,45940,46742,36414,44061,48491
2198,AK,8700,7977,5319,7382,6609,3971,4603,7977,5757.589117,12537,7382,46325,-1045,-11373,-3858,704,44561,45280,34952,42467,47029
2220,AK,13608,7977,5319,7382,6609,3971,5169,7977,6043.562087,12537,7382,51519,5967,-4362,3681,7715,50035,57486,47157,55200,59234
2230,AK,13428,7977,5319,7382,6609,3971,5148,7977,5929.172899,12537,7382,51224,5967,-4362,3681,7715,49834,57191,46862,54905,58939
2240,AK,11112,7977,5319,7382,6609,3971,4881,7977,6272.340462,12537,7382,49251,5740,-4589,3322,7488,47251,54991,44662,52573,56739
2261,AK,10296,7977,5319,7382,6609,3971,4787,7977,6272.340462,12537,7382,48435,5514,-4815,2964,7262,46341,53949,43620,51399,55697
2270,AK,8712,7977,5319,7382,6609,3971,4605,7977,7587.816121,12537,7382,48167,5514,-4815,2964,7262,44575,53681,43352,51131,55429
2275,AK,9648,7977,5319,7382,6609,3971,4712,7977,6157.951274,12537,7382,47673,-819,-11147,-3500,930,45618,46854,36526,44173,48603
2282,AK,8580,7977,5319,7382,6609,3971,4589,7977,6386.72965,12537,7382,46834,-1045,-11373,-3858,704,44427,45789,35461,42976,47538
2290,AK,8520,7977,5319,7382,6609,3971,4583,7977,6348.599921,12537,7382,46736,-1045,-11373,-3858,704,44361,45691,35363,42878,47440
4001,AZ,7644,10687,5319,7382,6624,3971,5391,10687,5509.745877,4017,7382,39211,6050,-6027,583,6050,47018,45261,33184,39794,45261
4003,AZ,9936,10687,5319,7382,6624,3971,5721,10106,5280.967502,4017,6895,40206,6329,-5748,975,6329,49640,46535,34458,41181,46535
4005,AZ,12252,10687,5319,7382,6624,3971,6054,9289,5624.135065,4017,7468,42621,6850,-5227,1760,6850,52289,49471,37394,44381,49471
4007,AZ,8676,10687,5319,7382,6624,3971,5539,9233,5605.0702,4017,6519,38021,5599,-6478,191,5599,48198,43620,31543,38212,43620
4009,AZ,7752,10687,5319,7382,6624,3971,5406,10666,5433.486419,4017,7130,38970,5599,-6478,191,5599,47141,44569,32492,39161,44569
4011,AZ,7644,10687,5319,7382,6624,3971,5391,10687,5319.097231,4017,7382,39020,6050,-6027,583,6050,47018,45070,32993,39603,45070
4012,AZ,7956,10687,5319,7382,6624,3971,5436,10687,5528.810742,4017,7382,39542,6050,-6027,583,6050,47375,45592,33515,40125,45592
4013,AZ,11484,10687,5319,7382,6624,3971,5944,13962,5433.486419,4017,7403,46270,7890,-4187,3328,7890,51411,54160,42083,49598,54160
4015,AZ,8988,10687,5319,7382,6624,3971,5584,10191,5471.616148,4017,6378,39017,6050,-6027,583,6050,48555,45067,32990,39600,45067
4017,AZ,7932,10687,5319,7382,6624,3971,5432,12405,5414.421554,4017,6675,40415,6329,-5748,975,6329,47347,46744,34667,41390,46744
4019,AZ,10224,10687,5319,7382,6624,3971,5762,10913,5414.421554,4017,7015,41554,6589,-5488,1367,6589,49969,48143,36066,42921,48143
4021,AZ,11484,10687,5319,7382,6624,3971,5944,10960,5223.772908,4017,7400,43056,7109,-4968,2151,7109,51411,50165,38088,45207,50165
4023,AZ,7980,10687,5319,7382,6624,3971,5439,14321,4651.826969,4017,6956,41897,6589,-5488,1367,6589,47402,48486,36409,43264,48486
4025,AZ,9408,10687,5319,7382,6624,3971,5645,11967,5566.940471,4017,6667,41597,6589,-5488,1367,6589,49036,48186,36109,42964,48186
4027,AZ,9744,10687,5319,7382,6624,3971,5693,9461,4728.086427,4017,6911,38832,5599,-6478,191,5599,49420,44431,32354,39023,44431
5001,AR,6984,14676,4457,8554,5783,3916,4823,14676,4505.007081,5740,8554,44375,8326,-3725,3526,8352,49193,52701,40650,47901,52727
5003,AR,6732,14676,4457,8554,5783,3916,4787,14676,4441.106271,5740,8554,44059,8326,-3725,3526,8352,48905,52385,40334,47585,52411
5005,AR,7152,14676,4457,8554,5783,3916,4846,17729,4520.982283,5740,7209,46267,8919,-3132,4383,8945,49384,55186,43135,50650,55212
5007,AR,8220,14676,4457,8554,5783,3916,4996,19607,4329.279854,5740,8468,50281,10105,-1946,6097,10131,50602,60386,48335,56378,60412
5009,AR,6732,14676,4457,8554,5783,3916,4787,16504,3786.122972,5740,7560,44238,8326,-3725,3526,8352,48905,52564,40513,47764,52590
5011,AR,6732,14676,4457,8554,5783,3916,4787,14676,4489.031878,5740,8554,44107,8326,-3725,3526,8352,48905,52433,40382,47633,52459
5013,AR,6732,14676,4457,8554,5783,3916,4787,16294,4457.081474,5740,7465,44605,8326,-3725,3526,8352,48905,52931,40880,48131,52957
5015,AR,7620,14676,4457,8554,5783,3916,4912,14676,4169.52783,5740,8554,44676,8326,-3725,3526,8352,49918,53002,40951,48202,53028
5017,AR,6732,14676,4457,8554,5783,3916,4787,14676,4505.007081,5740,8554,44123,8326,-3725,3526,8352,48905,52449,40398,47649,52475
5019,AR,6804,14676,4457,8554,5783,3916,4797,19173,4457.081474,5740,7456,47546,9215,-2836,4811,9241,48987,56761,44710,52357,56787
5021,AR,6732,14676,4457,8554,5783,3916,4787,14676,3897.949389,5740,8554,43516,8029,-4022,3097,8055,48905,51545,39494,46613,51571
5023,AR,6996,14676,4457,8554,5783,3916,4824,14676,4520.982283,5740,8554,44403,8326,-3725,3526,8352,49206,52729,40678,47929,52755
5025,AR,7812,14676,4457,8554,5783,3916,4939,17124,4473.056676,5740,7600,46665,8919,-3132,4383,8945,50137,55584,43533,51048,55610
5027,AR,6732,14676,4457,8554,5783,3916,4787,15782,4648.783903,5740,7521,44340,8326,-3725,3526,8352,48905,52666,40615,47866,52692
5029,AR,7440,14676,4457,8554,5783,3916,4887,14676,4121.602223,5740,8554,44448,8326,-3725,3526,8352,49713,52774,40723,47974,52800
5031,AR,7368,14676,4457,8554,5783,3916,4876,18924,4361.230259,5740,7766,48075,9512,-2539,5240,9538,49630,57587,45536,53315,57613
5033,AR,7200,14676,4457,8554,5783,3916,4853,16776,4313.304652,5740,7835,45779,8622,-3429,3954,8648,49439,54401,42350,49733,54427
5035,AR,9360,14676,4457,8554,5783,3916,5156,15542,4505.007081,5740,8489,47551,9215,-2836,4811,9241,51902,56766,44715,52362,56792
5037,AR,7164,14676,4457,8554,5783,3916,4848,14676,4425.131069,5740,8554,44475,8326,-3725,3526,8352,49398,52801,40750,48001,52827
5039,AR,6732,14676,4457,8554,5783,3916,4787,14676,4473.056676,5740,8554,44091,8326,-3725,3526,8352,48905,52417,40366,47617,52443
5041,AR,6732,14676,4457,8554,5783,3916,4787,14676,4441.106271,5740,8554,44059,8326,-3725,3526,8352,48905,52385,40334,47585,52411
5043,AR,6732,14676,4457,8554,5783,3916,4787,14676,4552.932688,5740,8554,44171,8326,-3725,3526,8352,48905,52497,40446,47697,52523
5045,AR,8868,14676,4457,8554,5783,3916,5087,18412,4600.858295,5740,8451,49988,9808,-2243,5668,9834,51341,59796,47745,55656,59822
5047,AR,6732,14676,4457,8554,5783,3916,4787,14676,4121.602223,5740,8554,43740,8029,-4022,3097,8055,48905,51769,39718,46837,51795
5049,AR,6732,14676,4457,8554,5783,3916,4787,14676,4153.552628,5740,8554,43772,8029,-4022,3097,8055,48905,51801,39750,46869,51827
5051,AR,9444,14676,4457,8554,5783,3916,5168,18389,4345.255057,5740,7530,49364,9808,-2243,5668,9834,51998,59172,47121,55032,59198
5053,AR,6732,14676,4457,8554,5783,3916,4787,14130,4505.007081,5740,8461,43484,8029,-4022,3097,8055,48905,51513,39462,46581,51539
5055,AR,7392,14676,4457,8554,5783,3916,4880,15852,4473.056676,5740,7719,45092,8622,-3429,3954,8648,49658,53714,41663,49046,53740
5057,AR,6732,14676,4457,8554,5783,3916,4787,14676,4153.552628,5740,8554,43772,8029,-4022,3097,8055,48905,51801,39750,46869,51827
5059,AR,6732,14676,4457,8554,5783,3916,4787,13284,4377.205461,5740,8090,42140,7733,-4318,2669,7759,48905,49873,37822,44809,49899
5061,AR,6732,14676,4457,8554,5783,3916,4787,14676,4265.379045,5740,8554,43883,8029,-4022,3097,8055,48905,51912,39861,46980,51938
5063,AR,6828,14676,4457,8554,5783,3916,4801,14308,4297.329449,5740,7630,42720,7733,-4318,2669,7759,49015,50453,38402,45389,50479
5065,AR,6732,14676,4457,8554,5783,3916,4787,14676,4297.329449,5740,8554,43915,8029,-4022,3097,8055,48905,51944,39893,47012,51970
5067,AR,6732,14676,4457,8554,5783,3916,4787,14676,4409.155866,5740,8554,44027,8326,-3725,3526,8352,48905,52353,40302,47553,52379
5069,AR,7812,14676,4457,8554,5783,3916,4939,15596,4441.106271,5740,7502,45007,8622,-3429,3954,8648,50137,53629,41578,48961,53655
5071,AR,6960,14676,4457,8554,5783,3916,4819,14676,4265.379045,5740,8554,44111,8326,-3725,3526,8352,49165,52437,40386,47637,52463
5073,AR,6732,14676,4457,8554,5783,3916,4787,14676,4505.007081,5740,8554,44123,8326,-3725,3526,8352,48905,52449,40398,47649,52475
5075,AR,6732,14676,4457,8554,5783,3916,4787,14676,4329.279854,5740,8554,43947,8029,-4022,3097,8055,48905,51976,39925,47044,52002
5077,AR,6732,14676,4457,8554,5783,3916,4787,14676,4393.180664,5740,8554,44011,8326,-3725,3526,8352,48905,52337,40286,47537,52363
5079,AR,7812,14676,4457,8554,5783,3916,4939,14510,4441.106271,5740,7572,43991,8029,-4022,3097,8055,50137,52020,39969,47088,52046
5081,AR,7428,14676,4457,8554,5783,3916,4885,14192,4233.42864,5740,8142,43651,8029,-4022,3097,8055,49699,51680,39629,46748,51706
5083,AR,6732,14676,4457,8554,5783,3916,4787,14676,3913.924591,5740,8554,43532,8029,-4022,3097,8055,48905,51561,39510,46629,51587
5085,AR,8868,14676,4457,8554,5783,3916,5087,14758,4552.932688,5740,8459,46294,8919,-3132,4383,8945,51341,55213,43162,50677,55239
5087,AR,8220,14676,4457,8554,5783,3916,4996,13641,4297.329449,5740,8467,44282,8326,-3725,3526,8352,50602,52608,40557,47808,52634
5089,AR,6732,14676,4457,8554,5783,3916,4787,14676,4233.42864,5740,8554,43851,8029,-4022,3097,8055,48905,51880,39829,46948,51906
5091,AR,8448,14676,4457,8554,5783,3916,5028,15084,4520.982283,5740,8140,45849,8622,-3429,3954,8648,50862,54471,42420,49803,54497
5093,AR,6744,14676,4457,8554,5783,3916,4789,16465,4377.205461,5740,7691,44933,8326,-3725,3526,8352,48919,53259,41208,48459,53285
5095,AR,6732,14676,4457,8554,5783,3916,4787,14676,4313.304652,5740,8554,43931,8029,-4022,3097,8055,48905,51960,39909,47028,51986
5097,AR,6732,14676,4457,8554,5783,3916,4787,14676,4265.379045,5740,8554,43883,8029,-4022,3097,8055,48905,51912,39861,46980,51938
5099,AR,6732,14676,4457,8554,5783,3916,4787,14676,4329.279854,5740,8554,43947,8029,-4022,3097,8055,48905,51976,39925,47044,52002
5101,AR,6732,14676,4457,8554,5783,3916,4787,15914,4249.403842,5740,7622,44174,8326,-3725,3526,8352,48905,52500,40449,47700,52526
5103,AR,6732,14676,4457,8554,5783,3916,4787,15301,4505.007081,5740,7407,43601,8029,-4022,3097,8055,48905,51630,39579,46698,51656
5105,AR,8868,14676,4457,8554,5783,3916,5087,14153,4552.932688,5740,8463,45693,8622,-3429,3954,8648,51341,54315,42264,49647,54341
5107,AR,6732,14676,4457,8554,5783,3916,4787,13967,4425.131069,5740,7101,41881,7436,-4615,2240,7462,48905,49317,37266,44121,49343
5109,AR,6732,14676,4457,8554,5783,3916,4787,14676,4313.304652,5740,8554,43931,8029,-4022,3097,8055,48905,51960,39909,47028,51986
5111,AR,6732,14676,4457,8554,5783,3916,4787,14021,4265.379045,5740,7800,42475,7733,-4318,2669,7759,48905,50208,38157,45144,50234
5113,AR,6732,14676,4457,8554,5783,3916,4787,14676,4265.379045,5740,8554,43883,8029,-4022,3097,8055,48905,51912,39861,46980,51938
5115,AR,7068,14676,4457,8554,5783,3916,4834,14169,4473.056676,5740,7927,43293,8029,-4022,3097,8055,49288,51322,39271,46390,51348
5117,AR,6732,14676,4457,8554,5783,3916,4787,14676,4505.007081,5740,8554,44123,8326,-3725,3526,8352,48905,52449,40398,47649,52475
5119,AR,8868,14676,4457,8554,5783,3916,5087,15363,4536.957486,5740,8455,46879,8919,-3132,4383,8945,51341,55798,43747,51262,55824
5121,AR,6732,14676,4457,8554,5783,3916,4787,14676,4297.329449,5740,8554,43915,8029,-4022,3097,8055,48905,51944,39893,47012,51970
5123,AR,6732,14676,4457,8554,5783,3916,4787,13540,4441.106271,5740,7298,41667,7436,-4615,2240,7462,48905,49103,37052,43907,49129
5125,AR,8868,14676,4457,8554,5783,3916,5087,14929,4600.858295,5740,8455,46509,8919,-3132,4383,8945,51341,55428,43377,50892,55454
5127,AR,6744,14676,4457,8554,5783,3916,4789,14676,4185.503032,5740,8554,43816,8029,-4022,3097,8055,48919,51845,39794,46913,51871
5129,AR,6732,14676,4457,8554,5783,3916,4787,14676,4233.42864,5740,8554,43851,8029,-4022,3097,8055,48905,51880,39829,46948,51906
5131,AR,7200,14676,4457,8554,5783,3916,4853,13191,4073.676616,5740,7809,41929,7436,-4615,2240,7462,49439,49365,37314,44169,49391
5133,AR,6732,14676,4457,8554,5783,3916,4787,14676,4249.403842,5740,8554,43867,8029,-4022,3097,8055,48905,51896,39845,46964,51922
5135,AR,6732,14676,4457,8554,5783,3916,4787,14676,4201.478235,5740,8554,43819,8029,-4022,3097,8055,48905,51848,39797,46916,51874
5137,AR,6744,14676,4457,8554,5783,3916,4789,14676,4361.230259,5740,8554,43991,8029,-4022,3097,8055,48919,52020,39969,47088,52046
5139,AR,7440,14676,4457,8554,5783,3916,4887,15231,4473.056676,5740,7606,44407,8326,-3725,3526,8352,49713,52733,40682,47933,52759
5141,AR,6732,14676,4457,8554,5783,3916,4787,14676,4520.982283,5740,8554,44139,8326,-3725,3526,8352,48905,52465,40414,47665,52491
5143,AR,8220,14676,4457,8554,5783,3916,4996,13718,4281.354247,5740,8467,44343,8326,-3725,3526,8352,50602,52669,40618,47869,52695
5145,AR,7020,14676,4457,8554,5783,3916,4828,12136,4536.957486,5740,8107,41456,7436,-4615,2240,7462,49234,48892,36841,43696,48918
5147,AR,6732,14676,4457,8554,5783,3916,4787,14676,4425.131069,5740,8554,44043,8326,-3725,3526,8352,48905,52369,40318,47569,52395
5149,AR,6732,14676,4457,8554,5783,3916,4787,12532,4137.577425,5740,7950,41007,7436,-4615,2240,7462,48905,48443,36392,43247,48469
6001,CA,18936,6494,5319,7382,6363,3971,6663,7371,6482.053973,4653,8155,49568,9224,-2853,5058,9224,55128,58792,46715,54626,58792
6003,CA,10956,6494,5319,7382,6363,3971,5584,6494,6119.821545,4653,7382,39576,6254,-5823,787,6254,46069,45830,33753,40363,45830
6005,CA,12576,6494,5319,7382,6363,3971,5803,6494,7053.999912,4653,7382,42130,7133,-4944,2043,7133,47908,49263,37186,44173,49263
6007,CA,10212,6494,5319,7382,6363,3971,5484,6004,5681.329659,4653,6903,37425,-2536,-6777,-50,5300,45225,34889,30648,37375,42725
6009,CA,11136,6494,5319,7382,6363,3971,5609,6494,6863.351266,4653,7382,40499,6560,-5517,1206,6560,46274,47059,34982,41705,47059
6011,CA,9744,6494,5319,7382,6363,3971,5420,6494,7625.945851,4653,7382,39870,6254,-5823,787,6254,44693,46124,34047,40657,46124
6013,CA,18936,6494,5319,7382,6363,3971,6663,7263,6310.470191,4653,8093,49226,9224,-2853,5058,9224,55128,58450,46373,54284,58450
6015,CA,10440,6494,5319,7382,6363,3971,5514,5772,6177.016139,4653,6488,37501,-2536,-6777,-50,5300,45483,34965,30724,37451,42801
6017,CA,12864,6494,5319,7382,6363,3971,5842,6548,7282.778287,4653,7436,42755,7133,-4944,2043,7133,48235,49888,37811,44798,49888
6019,CA,9924,6494,5319,7382,6363,3971,5445,5870,5147.513449,4653,7468,37033,-2536,-6777,-50,5300,44898,34497,30256,36983,42333
6021,CA,9888,6494,5319,7382,6363,3971,5440,6494,5566.940471,4653,7382,37955,-2536,-6777,-50,5300,44857,35419,31178,37905,43255
6023,CA,11832,6494,5319,7382,6363,3971,5703,5905,5624.135065,4653,6954,38939,5777,-6300,369,5777,47064,44716,32639,39308,44716
6025,CA,9708,6494,5319,7382,6363,3971,5415,5699,4823.410751,4653,7361,36215,-3313,-7254,-468,4823,44652,32902,28961,35747,41038
6027,CA,11544,6494,5319,7382,6363,3971,5664,6494,5528.810742,4653,7382,39573,6254,-5823,787,6254,46737,45827,33750,40360,45827
6029,CA,9780,6494,5319,7382,6363,3971,5425,5725,5338.162095,4653,7528,36995,-3313,-7254,-468,4823,44734,33682,29741,36527,41818
6031,CA,10668,6494,5319,7382,6363,3971,5545,5682,5204.708043,4653,7558,37736,-2536,-6777,-50,5300,45742,35200,30959,37686,43036
6033,CA,10524,6494,5319,7382,6363,3971,5526,5965,6634.57289,4653,6238,37985,-2536,-6777,-50,5300,45579,35449,31208,37935,43285
6035,CA,11340,6494,5319,7382,6363,3971,5636,5777,6424.859379,4653,6695,38861,5777,-6300,369,5777,46505,44638,32561,39230,44638
6037,CA,16776,6494,5319,7382,6363,3971,6371,7138,5871.978305,4653,8189,46599,8305,-3772,3743,8305,52676,54904,42827,50342,54904
6039,CA,9420,6494,5319,7382,6363,3971,5377,5589,6348.599921,4653,7200,37182,-2536,-6777,-50,5300,44326,34646,30405,37132,42482
6041,CA,23472,6494,5319,7382,6363,3971,7276,8042,7130.25937,4653,8086,55355,10757,-1320,7251,10757,60277,66112,54035,62606,66112
6043,CA,9288,6494,5319,7382,6363,3971,5359,6494,5376.291825,4653,7382,37164,-2536,-6777,-50,5300,44176,34628,30387,37114,42464
6045,CA,11124,6494,5319,7382,6363,3971,5607,6066,6672.702619,4653,7002,39488,6254,-5823,787,6254,46260,45742,33665,40275,45742
6047,CA,9540,6494,5319,7382,6363,3971,5393,5544,5395.356689,4653,7484,36587,-3313,-7254,-468,4823,44462,33274,29333,36119,41410
6049,CA,7644,6494,5319,7382,6363,3971,5136,6494,5528.810742,4653,7382,35673,-4090,-7731,-887,4346,42309,31583,27942,34786,40019
6051,CA,15024,6494,5319,7382,6363,3971,6134,6494,5452.551283,4653,7382,42977,7133,-4944,2043,7133,50687,50110,38033,45020,50110
6053,CA,14808,6494,5319,7382,6363,3971,6105,6734,5738.524253,4653,7893,43797,7419,-4658,2461,7419,50442,51216,39139,46258,51216
6055,CA,16968,6494,5319,7382,6363,3971,6397,7003,6882.41613,4653,8010,47487,8611,-3466,4181,8611,52894,56098,44021,51668,56098
6057,CA,12564,6494,5319,7382,6363,3971,5802,6320,7664.07558,4653,7042,42214,7133,-4944,2043,7133,47895,49347,37270,44257,49347
6059,CA,19728,6494,5319,7382,6363,3971,6770,7643,5948.237763,4653,8153,50097,9531,-2546,5497,9531,56027,59628,47551,55594,59628
6061,CA,12864,6494,5319,7382,6363,3971,5842,6678,6329.535056,4653,7440,41936,6846,-5231,1624,6846,48235,48782,36705,43560,48782
6063,CA,11196,6494,5319,7382,6363,3971,5617,6494,5757.589117,4653,7382,39454,6254,-5823,787,6254,46342,45708,33631,40241,45708
6065,CA,13440,6494,5319,7382,6363,3971,5920,6418,5414.421554,4653,7760,41656,6846,-5231,1624,6846,48889,48502,36425,43280,48502
6067,CA,12864,6494,5319,7382,6363,3971,5842,6293,5566.940471,4653,7448,40796,6560,-5517,1206,6560,48235,47356,35279,42002,47356
6069,CA,14352,6494,5319,7382,6363,3971,6043,6660,6806.156672,4653,8404,44846,7706,-4371,2880,7706,49924,52552,40475,47726,52552
6071,CA,13440,6494,5319,7382,6363,3971,5920,6220,5280.967502,4653,7768,41333,6846,-5231,1624,6846,48889,48179,36102,42957,48179
6073,CA,16248,6494,5319,7382,6363,3971,6300,7255,6043.562087,4653,7998,46169,8305,-3772,3743,8305,52077,54474,42397,49912,54474
6075,CA,23472,6494,5319,7382,6363,3971,7276,8333,7473.426934,4653,8374,56277,11382,-447,8140,11382,60277,67659,55830,64417,67659
6077,CA,11160,6494,5319,7382,6363,3971,5612,6142,5433.486419,4653,7602,38961,5777,-6300,369,5777,46301,44738,32661,39330,44738
6079,CA,14580,6494,5319,7382,6363,3971,6074,6707,6367.664785,4653,7305,43584,7419,-4658,2461,7419,50183,51003,38926,46045,51003
6081,CA,23472,6494,5319,7382,6363,3971,7276,7972,6596.443161,4653,8115,54779,10757,-1320,7251,10757,60277,65536,53459,62030,65536
6083,CA,15264,6494,5319,7382,6363,3971,6167,7086,5833.848576,4653,8014,44821,7706,-4371,2880,7706,50960,52527,40450,47701,52527
6085,CA,19788,6494,5319,7382,6363,3971,6778,7916,6386.72965,4653,8611,51326,9531,-2546,5497,9531,56095,60857,48780,56823,60857
6087,CA,19164,6494,5319,7382,6363,3971,6694,7222,6596.443161,4653,7951,49557,9224,-2853,5058,9224,55387,58781,46704,54615,58781
6089,CA,11280,6494,5319,7382,6363,3971,5628,5912,5376.291825,4653,6916,38108,5777,-6300,369,5777,46437,43885,31808,38477,43885
6091,CA,10380,6494,5319,7382,6363,3971,5506,6494,5967.302628,4653,7382,38847,5777,-6300,369,5777,45415,44624,32547,39216,44624
6093,CA,9468,6494,5319,7382,6363,3971,5383,6494,5814.783711,4653,7382,37783,-2536,-6777,-50,5300,44380,35247,31006,37733,43083
6095,CA,13956,6494,5319,7382,6363,3971,5990,6526,5586.005336,4653,8016,42707,7133,-4944,2043,7133,49475,49840,37763,44750,49840
6097,CA,15012,6494,5319,7382,6363,3971,6133,6830,6482.053973,4653,7718,44667,7706,-4371,2880,7706,50674,52373,40296,47547,52373
6099,CA,10920,6494,5319,7382,6363,3971,5579,5891,5433.486419,4653,7482,38350,5777,-6300,369,5777,46028,44127,32050,38719,44127
6101,CA,9480,6494,5319,7382,6363,3971,5385,5861,4823.410751,4653,7288,36077,-3313,-7254,-468,4823,44394,32764,28823,35609,40900
6103,CA,10080,6494,5319,7382,6363,3971,5466,5743,5700.394523,4653,6954,37102,-2536,-6777,-50,5300,45075,34566,30325,37052,42402
6105,CA,11316,6494,5319,7382,6363,3971,5633,6494,5681.329659,4653,7382,39497,6254,-5823,787,6254,46478,45751,33674,40284,45751
6107,CA,8988,6494,5319,7382,6363,3971,5318,5513,5185.643178,4653,7550,35861,-4090,-7731,-887,4346,43835,31771,28130,34974,40207
6109,CA,11328,6494,5319,7382,6363,3971,5635,5925,6863.351266,4653,6684,39424,6254,-5823,787,6254,46492,45678,33601,40211,45678
6111,CA,17748,6494,5319,7382,6363,3971,6503,7246,6196.081004,4653,8410,48224,8918,-3159,4620,8918,53780,57142,45065,52844,57142
6113,CA,13248,6494,5319,7382,6363,3971,5894,6634,5814.783711,4653,7446,41767,6846,-5231,1624,6846,48671,48613,36536,43391,48613
6115,CA,9480,6494,5319,7382,6363,3971,5385,5794,5033.124261,4653,7291,36222,-3313,-7254,-468,4823,44394,32909,28968,35754,41045
8001,CO,11520,12426,5319,7382,6167,3971,6903,13647,5338.162095,5205,7834,47515,9033,-3020,4627,9057,53688,56548,44495,52142,56572
8003,CO,7668,12426,5319,7382,6167,3971,6281,12426,5795.718846,5205,7382,42448,7686,-4367,2620,7710,49214,50134,38081,45068,50158
8005,CO,11520,12426,5319,7382,6167,3971,6903,14521,5738.524253,5205,7846,48801,9303,-2750,5029,9327,53688,58104,46051,53830,58128
8007,CO,8772,12426,5319,7382,6167,3971,6460,12426,5738.524253,5205,7382,43495,7955,-4098,3021,7979,50497,51450,39397,46516,51474
8009,CO,7644,12426,5319,7382,6167,3971,6277,12426,4956.864803,5205,7382,41585,7416,-4637,2218,7440,49186,49001,36948,43803,49025
8011,CO,7644,12426,5319,7382,6167,3971,6277,12426,5242.837772,5205,7382,41871,7416,-4637,2218,7440,49186,49287,37234,44089,49311
8013,CO,14136,12426,5319,7382,6167,3971,7326,14908,6462.989108,5205,7752,52435,10381,-1672,6635,10405,56727,62816,50763,59070,62840
8014,CO,11520,12426,5319,7382,6167,3971,6903,14515,6729.897213,5205,7824,49765,9572,-2481,5430,9596,53688,59337,47284,55195,59361
8015,CO,8364,12426,5319,7382,6167,3971,6394,12426,5700.394523,5205,7382,43048,7955,-4098,3021,7979,50023,51003,38950,46069,51027
8017,CO,7644,12426,5319,7382,6167,3971,6277,12426,5319.097231,5205,7382,41947,7416,-4637,2218,7440,49186,49363,37310,44165,49387
8019,CO,11520,12426,5319,7382,6167,3971,6903,13027,5910.108034,5205,7783,47416,9033,-3020,4627,9057,53688,56449,44396,52043,56473
8021,CO,7644,12426,5319,7382,6167,3971,6277,12426,5814.783711,5205,7382,42443,7686,-4367,2620,7710,49186,50129,38076,45063,50153
8023,CO,7644,12426,5319,7382,6167,3971,6277,12426,5891.04317,5205,7382,42519,7686,-4367,2620,7710,49186,50205,38152,45139,50229
8025,CO,7644,12426,5319,7382,6167,3971,6277,12426,5547.875606,5205,7382,42176,7686,-4367,2620,7710,49186,49862,37809,44796,49886
8027,CO,7644,12426,5319,7382,6167,3971,6277,12426,5204.708043,5205,7382,41833,7416,-4637,2218,7440,49186,49249,37196,44051,49273
8029,CO,9120,12426,5319,7382,6167,3971,6516,12426,5738.524253,5205,7382,43843,7955,-4098,3021,7979,50901,51798,39745,46864,51822
8031,CO,11520,12426,5319,7382,6167,3971,6903,14429,5929.172899,5205,7873,48927,9303,-2750,5029,9327,53688,58230,46177,53956,58254
8033,CO,7644,12426,5319,7382,6167,3971,6277,12426,6234.210733,5205,7382,42862,7686,-4367,2620,7710,49186,50548,38495,45482,50572
8035,CO,11520,12426,5319,7382,6167,3971,6903,15239,5871.978305,5205,7813,49620,9572,-2481,5430,9596,53688,59192,47139,55050,59216
8037,CO,14328,12426,5319,7382,6167,3971,7357,17353,5662.264794,5205,8523,55042,10920,-1133,7438,10944,56950,65962,53909,62480,65986
8039,CO,11520,12426,5319,7382,6167,3971,6903,14117,6100.75668,5205,7787,48701,9303,-2750,5029,9327,53688,58004,45951,53730,58028
8041,CO,9684,12426,5319,7382,6167,3971,6607,13348,5509.745877,5205,7480,45198,8494,-3559,3824,8518,51556,53692,41639,49022,53716
8043,CO,7968,12426,5319,7382,6167,3971,6330,11907,5433.486419,5205,6048,40533,7147,-4906,1817,7171,49563,47680,35627,42350,47704
8045,CO,13440,12426,5319,7382,6167,3971,7214,14843,6100.75668,5205,7884,51444,9842,-2211,5832,9866,55919,61286,49233,57276,61310
8047,CO,11520,12426,5319,7382,6167,3971,6903,12832,5891.04317,5205,7772,47191,9033,-3020,4627,9057,53688,56224,44171,51818,56248
8049,CO,10680,12426,5319,7382,6167,3971,6768,12426,5967.302628,5205,7382,45631,8494,-3559,3824,8518,52713,54125,42072,49455,54149
8051,CO,10716,12426,5319,7382,6167,3971,6774,12426,5929.172899,5205,7382,45629,8494,-3559,3824,8518,52755,54123,42070,49453,54147
8053,CO,10344,12426,5319,7382,6167,3971,6714,12426,6501.118838,5205,7382,45829,8494,-3559,3824,8518,52323,54323,42270,49653,54347
8055,CO,8364,12426,5319,7382,6167,3971,6394,12426,5376.291825,5205,7382,42724,7686,-4367,2620,7710,50023,50410,38357,45344,50434
8057,CO,8340,12426,5319,7382,6167,3971,6390,12426,6501.118838,5205,7382,43825,7955,-4098,3021,7979,49995,51780,39727,46846,51804
8059,CO,11520,12426,5319,7382,6167,3971,6903,14264,5910.108034,5205,7832,48702,9303,-2750,5029,9327,53688,58005,45952,53731,58029
8061,CO,7644,12426,5319,7382,6167,3971,6277,12426,5280.967502,5205,7382,41909,7416,-4637,2218,7440,49186,49325,37272,44127,49349
8063,CO,7644,12426,5319,7382,6167,3971,6277,12426,5300.032366,5205,7382,41928,7416,-4637,2218,7440,49186,49344,37291,44146,49368
8065,CO,11772,12426,5319,7382,6167,3971,6944,12426,6367.664785,5205,7382,47124,9033,-3020,4627,9057,53981,56157,44104,51751,56181
8067,CO,11064,12426,5319,7382,6167,3971,6830,14066,6748.962078,5205,7357,48412,9303,-2750,5029,9327,53159,57715,45662,53441,57739
8069,CO,10752,12426,5319,7382,6167,3971,6779,13620,5967.302628,5205,7416,46931,8764,-3289,4226,8788,52796,55695,43642,51157,55719
8071,CO,8208,12426,5319,7382,6167,3971,6369,12426,5338.162095,5205,7382,42530,7686,-4367,2620,7710,49842,50216,38163,45150,50240
8073,CO,8256,12426,5319,7382,6167,3971,6376,12426,5795.718846,5205,7382,43036,7955,-4098,3021,7979,49897,50991,38938,46057,51015
8075,CO,7716,12426,5319,7382,6167,3971,6289,11347,5319.097231,5205,7219,40777,7147,-4906,1817,7171,49270,47924,35871,42594,47948
8077,CO,9180,12426,5319,7382,6167,3971,6526,12853,5586.005336,5205,7154,43949,7955,-4098,3021,7979,50971,51904,39851,46970,51928
8079,CO,9468,12426,5319,7382,6167,3971,6572,12426,6348.599921,5205,7382,44801,8225,-3828,3423,8249,51305,53026,40973,48224,53050
8081,CO,8856,12426,5319,7382,6167,3971,6473,12793,5929.172899,5205,7485,44239,8225,-3828,3423,8249,50594,52464,40411,47662,52488
8083,CO,7644,12426,5319,7382,6167,3971,6277,12426,5681.329659,5205,7382,42309,7686,-4367,2620,7710,49186,49995,37942,44929,50019
8085,CO,9120,12426,5319,7382,6167,3971,6516,12635,5871.978305,5205,6996,43799,7955,-4098,3021,7979,50901,51754,39701,46820,51778
8087,CO,7920,12426,5319,7382,6167,3971,6322,12051,5319.097231,5205,7242,41707,7416,-4637,2218,7440,49507,49123,37070,43925,49147
8089,CO,7644,12426,5319,7382,6167,3971,6277,12426,5185.643178,5205,7382,41814,7416,-4637,2218,7440,49186,49230,37177,44032,49254
8091,CO,12168,12426,5319,7382,6167,3971,7008,12426,5948.237763,5205,7382,47100,9033,-3020,4627,9057,54441,56133,44080,51727,56157
8093,CO,11520,12426,5319,7382,6167,3971,6903,12359,5738.524253,5205,7759,46552,8764,-3289,4226,8788,53688,55316,43263,50778,55340
8095,CO,7920,12426,5319,7382,6167,3971,6322,12426,5528.810742,5205,7382,42433,7686,-4367,2620,7710,49507,50119,38066,45053,50143
8097,CO,15972,12426,5319,7382,6167,3971,7622,16274,6177.016139,5205,7881,55480,10920,-1133,7438,10944,58859,66400,54347,62918,66424
8099,CO,7644,12426,5319,7382,6167,3971,6277,12426,5223.772908,5205,7382,41852,7416,-4637,2218,7440,49186,49268,37215,44070,49292
8101,CO,8316,12426,5319,7382,6167,3971,6386,11620,5147.513449,5205,6907,41166,7416,-4637,2218,7440,49967,48582,36529,43384,48606
8103,CO,8604,12426,5319,7382,6167,3971,6433,12426,6005.432357,5205,7382,43593,7955,-4098,3021,7979,50302,51548,39495,46614,51572
8105,CO,7644,12426,5319,7382,6167,3971,6277,12426,5948.237763,5205,7382,42576,7686,-4367,2620,7710,49186,50262,38209,45196,50286
8107,CO,12960,12426,5319,7382,6167,3971,7136,15274,7339.972881,5205,7810,52560,10381,-1672,6635,10405,55361,62941,50888,59195,62965
8109,CO,7644,12426,5319,7382,6167,3971,6277,12426,5891.04317,5205,7382,42519,7686,-4367,2620,7710,49186,50205,38152,45139,50229
8111,CO,10104,12426,5319,7382,6167,3971,6675,12426,6424.859379,5205,7382,45513,8494,-3559,3824,8518,52044,54007,41954,49337,54031
8113,CO,13428,12426,5319,7382,6167,3971,7212,12426,5833.848576,5205,7382,48246,9303,-2750,5029,9327,55905,57549,45496,53275,57573
8115,CO,7644,12426,5319,7382,6167,3971,6277,12426,5605.0702,5205,7382,42233,7686,-4367,2620,7710,49186,49919,37866,44853,49943
8117,CO,14796,12426,5319,7382,6167,3971,7433,16388,7320.908017,5205,7982,55662,10920,-1133,7438,10944,57494,66582,54529,63100,66606
8119,CO,10332,12426,5319,7382,6167,3971,6712,12484,6196.081004,5205,7463,45651,8494,-3559,3824,8518,52309,54145,42092,49475,54169
8121,CO,7740,12426,5319,7382,6167,3971,6293,12426,5566.940471,5205,7382,42291,7686,-4367,2620,7710,49298,49977,37924,44911,50001
8123,CO,8508,12426,5319,7382,6167,3971,6417,12931,5605.0702,5205,7620,43840,7955,-4098,3021,7979,50190,51795,39742,46861,51819
8125,CO,7644,12426,5319,7382,6167,3971,6277,12426,5319.097231,5205,7382,41947,7416,-4637,2218,7440,49186,49363,37310,44165,49387
9001,CT,16851,12733,5176,6855,7389,3644,8174,17369,6048.053208,5883,7667,57463,10921,-904,7683,10925,60822,68384,56559,65146,68388
9003,CT,14040,12733,5176,6855,7389,3644,7709,14124,5380.170032,5883,7280,50351,9262,-2811,5232,9266,57546,59613,47540,55583,59617
9005,CT,11736,12733,5176,6855,7389,3644,7329,11760,5769.768551,5883,7323,46116,8156,-3917,3598,8160,54862,54272,42199,49714,54276
9007,CT,14512,12733,5176,6855,7389,3644,7787,12960,6122.26245,5883,7254,50376,9262,-2811,5232,9266,58096,59638,47565,55608,59642
9009,CT,13945,12733,5176,6855,7389,3644,7694,14887,5417.274653,5883,7221,50998,9262,-2811,5232,9266,57436,60260,48187,56230,60264
9011,CT,12499,12733,5176,6855,7389,3644,7455,12561,6029.500898,5883,7216,47833,8432,-3641,4006,8436,55751,56265,44192,51839,56269
9013,CT,14040,12733,5176,6855,7389,3644,7709,12257,5788.320862,5883,7258,48871,8709,-3364,4415,8713,57546,57580,45507,53286,57584
9015,CT,11256,12733,5176,6855,7389,3644,7249,11746,5176.094617,5883,7294,45000,3952,-4470,2781,7607,54302,48952,40530,47781,52607
10001,DE,10920,9562,4457,8554,6813,3916,6275,7929,4457.081474,6508,8694,42424,7519,-4558,2429,7519,50497,49943,37866,44853,49943
10003,DE,13620,9562,4457,8554,6813,3916,6691,13553,4872.436736,6508,9041,51510,9844,-2233,5810,9844,53613,61354,49277,57320,61354
10005,DE,10008,9562,4457,8554,6813,3916,6134,8096,4856.461534,6508,8418,41802,7236,-4841,2014,7236,49444,49038,36961,43816,49038
12001,FL,10428,10892,4457,8554,7523,3916,4766,12186,5080.114368,4936,8062,44609,6129,-5948,1171,6129,50536,50738,38661,45780,50738
12003,FL,8772,10892,4457,8554,7523,3916,4575,11459,4425.131069,4936,8535,42043,5903,-6174,813,5903,48689,47946,35869,42856,47946
12005,FL,10344,10892,4457,8554,7523,3916,4756,11898,4856.461534,4936,8279,44230,6129,-5948,1171,6129,50442,50359,38282,45401,50359
12007,FL,7644,10892,4457,8554,7523,3916,4445,10892,4185.503032,4936,8554,40128,5450,-6627,96,5450,47431,45578,33501,40224,45578
12009,FL,10344,10892,4457,8554,7523,3916,4756,11322,4616.833498,4936,8106,43241,6129,-5948,1171,6129,50442,49370,37293,44412,49370
12011,FL,15120,10892,4457,8554,7523,3916,5307,14362,4984.263153,4936,8601,51919,7715,-4362,3681,7715,55769,59634,47557,55600,59634
12013,FL,7644,10892,4457,8554,7523,3916,4445,10892,4760.610319,4936,8554,40703,5450,-6627,96,5450,47431,46153,34076,40799,46153
12015,FL,10308,10892,4457,8554,7523,3916,4752,11079,4792.560724,4936,7527,42558,5903,-6174,813,5903,50402,48461,36384,43371,48461
12017,FL,8964,10892,4457,8554,7523,3916,4598,10255,4856.461534,4936,7144,40072,5204,-6873,-263,5204,48904,45276,33199,39809,45276
12019,FL,11220,10892,4457,8554,7523,3916,4857,11253,4808.535927,4936,8535,44669,6356,-5721,1530,6356,51419,51025,38948,46199,51025
12021,FL,12072,10892,4457,8554,7523,3916,4956,14746,4952.312748,4936,8377,48999,7262,-4815,2964,7262,52370,56261,44184,51963,56261
12023,FL,9372,10892,4457,8554,7523,3916,4645,11090,4505.007081,4936,7676,41494,5676,-6401,454,5676,49359,47170,35093,41948,47170
12027,FL,7848,10892,4457,8554,7523,3916,4469,11511,4409.155866,4936,7744,40365,5450,-6627,96,5450,47659,45815,33738,40461,45815
12029,FL,7644,10892,4457,8554,7523,3916,4445,10892,4457.081474,4936,8554,40399,5450,-6627,96,5450,47431,45849,33772,40495,45849
12031,FL,11220,10892,4457,8554,7523,3916,4857,11625,4728.659915,4936,8534,44960,6356,-5721,1530,6356,51419,51316,39239,46490,51316
12033,FL,9960,10892,4457,8554,7523,3916,4712,10626,4600.858295,4936,8282,42321,5903,-6174,813,5903,50014,48224,36147,43134,48224
12035,FL,11988,10892,4457,8554,7523,3916,4946,10628,5000.238356,4936,7979,44447,6129,-5948,1171,6129,52276,50576,38499,45618,50576
12037,FL,8436,10892,4457,8554,7523,3916,4537,10892,4409.155866,4936,8554,41143,5676,-6401,454,5676,48315,46819,34742,41597,46819
12039,FL,10920,10892,4457,8554,7523,3916,4823,10418,4377.205461,4936,8245,42812,5903,-6174,813,5903,51085,48715,36638,43625,48715
12041,FL,10428,10892,4457,8554,7523,3916,4766,11757,4872.436736,4936,8097,44006,6129,-5948,1171,6129,50536,50135,38058,45177,50135
12043,FL,8952,10892,4457,8554,7523,3916,4596,10892,4936.337546,4936,8554,42186,5676,-6401,454,5676,48890,47862,35785,42640,47862
12045,FL,8484,10892,4457,8554,7523,3916,4542,11023,4824.511129,4936,8288,41471,5676,-6401,454,5676,48368,47147,35070,41925,47147
12047,FL,7644,10892,4457,8554,7523,3916,4445,10892,4393.180664,4936,8554,40335,5450,-6627,96,5450,47431,45785,33708,40431,45785
12049,FL,8136,10892,4457,8554,7523,3916,4502,10802,4217.453437,4936,8257,40264,5450,-6627,96,5450,47980,45714,33637,40360,45714
12051,FL,9336,10892,4457,8554,7523,3916,4640,10957,4393.180664,4936,8066,41604,5676,-6401,454,5676,49318,47280,35203,42058,47280
12053,FL,11412,10892,4457,8554,7523,3916,4880,10074,4616.833498,4936,8188,43143,5903,-6174,813,5903,51634,49046,36969,43956,49046
12055,FL,8364,10892,4457,8554,7523,3916,4528,10719,4616.833498,4936,7172,39724,5204,-6873,-263,5204,48234,44928,32851,39461,44928
12057,FL,11412,10892,4457,8554,7523,3916,4880,12290,4744.635117,4936,8137,45436,6582,-5495,1888,6582,51634,52018,39941,47324,52018
12059,FL,7644,10892,4457,8554,7523,3916,4445,10892,5016.213558,4936,8554,40958,5450,-6627,96,5450,47431,46408,34331,41054,46408
12061,FL,10368,10892,4457,8554,7523,3916,4759,11818,5064.139165,4936,7781,43883,6129,-5948,1171,6129,50469,50012,37935,45054,50012
12063,FL,7644,10892,4457,8554,7523,3916,4445,10892,4680.734307,4936,8554,40623,5450,-6627,96,5450,47431,46073,33996,40719,46073
12065,FL,10920,10892,4457,8554,7523,3916,4823,10763,4616.833498,4936,8250,43402,6129,-5948,1171,6129,51085,49531,37454,44573,49531
12067,FL,7644,10892,4457,8554,7523,3916,4445,10892,4441.106271,4936,8554,40383,5450,-6627,96,5450,47431,45833,33756,40479,45833
12069,FL,11796,10892,4457,8554,7523,3916,4924,11181,4632.8087,4936,8645,45107,6356,-5721,1530,6356,52062,51463,39386,46637,51463
12071,FL,10716,10892,4457,8554,7523,3916,4799,12427,4776.585522,4936,8122,44893,6356,-5721,1530,6356,50857,51249,39172,46423,51249
12073,FL,10920,10892,4457,8554,7523,3916,4823,12180,4792.560724,4936,8220,44965,6356,-5721,1530,6356,51085,51321,39244,46495,51321
12075,FL,7644,10892,4457,8554,7523,3916,4445,10892,4457.081474,4936,8554,40399,5450,-6627,96,5450,47431,45849,33772,40495,45849
12077,FL,7644,10892,4457,8554,7523,3916,4445,10892,4728.659915,4936,8554,40671,5450,-6627,96,5450,47431,46121,34044,40767,46121
12079,FL,7884,10892,4457,8554,7523,3916,4473,10892,4600.858295,4936,8554,40783,5450,-6627,96,5450,47699,46233,34156,40879,46233
12081,FL,12132,10892,4457,8554,7523,3916,4962,12699,5000.238356,4936,7878,46562,6809,-5268,2247,6809,52436,53371,41294,48809,53371
12083,FL,9444,10892,4457,8554,7523,3916,4653,10479,4473.056676,4936,7439,40687,5450,-6627,96,5450,49439,46137,34060,40783,46137
12085,FL,11112,10892,4457,8554,7523,3916,4845,13422,5495.46963,4936,8017,46899,6582,-5495,1888,6582,51299,53481,41404,48787,53481
12086,FL,13992,10892,4457,8554,7523,3916,5177,14131,5064.139165,4936,8603,50642,7715,-4362,3681,7715,54511,58357,46280,54323,58357
12087,FL,16392,10892,4457,8554,7523,3916,5453,14751,5798.998476,4936,8620,54414,8168,-3909,4398,8168,57187,62582,50505,58812,62582
12089,FL,11220,10892,4457,8554,7523,3916,4857,12106,5128.039975,4936,8535,45841,6582,-5495,1888,6582,51419,52423,40346,47729,52423
12091,FL,10668,10892,4457,8554,7523,3916,4794,11575,4888.411939,4936,8417,44401,6129,-5948,1171,6129,50804,50530,38453,45572,50530
12093,FL,9108,10892,4457,8554,7523,3916,4614,11196,4441.106271,4936,7674,41272,5676,-6401,454,5676,49064,46948,34871,41726,46948
12095,FL,11796,10892,4457,8554,7523,3916,4924,12448,4648.783903,4936,8658,46403,6809,-5268,2247,6809,52062,53212,41135,48650,53212
12097,FL,11796,10892,4457,8554,7523,3916,4924,11820,4409.155866,4936,8651,45528,6582,-5495,1888,6582,52062,52110,40033,47416,52110
12099,FL,14424,10892,4457,8554,7523,3916,5226,14089,5096.08957,4936,8597,51058,7715,-4362,3681,7715,54992,58773,46696,54739,58773
12101,FL,11412,10892,4457,8554,7523,3916,4880,11401,4760.610319,4936,8166,44592,6356,-5721,1530,6356,51634,50948,38871,46122,50948
12103,FL,11412,10892,4457,8554,7523,3916,4880,12775,4824.511129,4936,8113,45976,6582,-5495,1888,6582,51634,52558,40481,47864,52558
12105,FL,9684,10892,4457,8554,7523,3916,4680,11143,4473.056676,4936,8205,42358,5903,-6174,813,5903,49706,48261,36184,43171,48261
12107,FL,7812,10892,4457,8554,7523,3916,4465,11033,4473.056676,4936,7323,39492,5204,-6873,-263,5204,47619,44696,32619,39229,44696
12109,FL,11220,10892,4457,8554,7523,3916,4857,12815,5431.568821,4936,8535,46854,6582,-5495,1888,6582,51419,53436,41359,48742,53436
12111,FL,11112,10892,4457,8554,7523,3916,4845,10993,4744.635117,4936,8040,43741,6129,-5948,1171,6129,51299,49870,37793,44912,49870
12113,FL,9960,10892,4457,8554,7523,3916,4712,10828,5080.114368,4936,8291,43011,5903,-6174,813,5903,50014,48914,36837,43824,48914
12115,FL,12132,10892,4457,8554,7523,3916,4962,12291,5112.064773,4936,7886,46273,6582,-5495,1888,6582,52436,52855,40778,48161,52855
12117,FL,11796,10892,4457,8554,7523,3916,4924,12211,4664.759105,4936,8654,46178,6582,-5495,1888,6582,52062,52760,40683,48066,52760
12119,FL,8556,10892,4457,8554,7523,3916,4550,9641,4824.511129,4936,6936,38810,4787,-7290,-621,4787,48448,43597,31520,38189,43597
12121,FL,7728,10892,4457,8554,7523,3916,4455,10892,4409.155866,4936,8554,40435,5450,-6627,96,5450,47525,45885,33808,40531,45885
12123,FL,7644,10892,4457,8554,7523,3916,4445,10892,4505.007081,4936,8554,40447,5450,-6627,96,5450,47431,45897,33820,40543,45897
12125,FL,7644,10892,4457,8554,7523,3916,4445,10892,4872.436736,4936,8554,40814,5450,-6627,96,5450,47431,46264,34187,40910,46264
12127,FL,10536,10892,4457,8554,7523,3916,4779,11161,4856.461534,4936,7972,43378,5903,-6174,813,5903,50657,49281,37204,44191,49281
12129,FL,9108,10892,4457,8554,7523,3916,4614,11232,4552.932688,4936,8244,41989,5676,-6401,454,5676,49064,47665,35588,42443,47665
12131,FL,10620,10892,4457,8554,7523,3916,4788,11697,5383.643214,4936,8427,44979,6356,-5721,1530,6356,50750,51335,39258,46509,51335
12133,FL,7644,10892,4457,8554,7523,3916,4445,10892,4393.180664,4936,8554,40335,5450,-6627,96,5450,47431,45785,33708,40431,45785
13001,GA,7632,12273,4457,8554,6278,3916,4902,12273,4217.453437,4804,8554,41396,7310,-4767,2088,7310,48012,48706,36629,43484,48706
13003,GA,7632,12273,4457,8554,6278,3916,4902,12273,4121.602223,4804,8554,41301,7310,-4767,2088,7310,48012,48611,36534,43389,48611
13005,GA,7632,12273,4457,8554,6278,3916,4902,12273,4153.552628,4804,8554,41333,7310,-4767,2088,7310,48012,48643,36566,43421,48643
13007,GA,8400,12273,4457,8554,6278,3916,5006,13288,4473.056676,4804,7711,42592,7597,-4480,2507,7597,48884,50189,38112,45099,50189
13009,GA,8520,12273,4457,8554,6278,3916,5022,12871,4552.932688,4804,7328,41992,7310,-4767,2088,7310,49020,49302,37225,44080,49302
13011,GA,8424,12273,4457,8554,6278,3916,5009,12273,4520.982283,4804,8554,42492,7597,-4480,2507,7597,48911,50089,38012,44999,50089
13013,GA,10752,12273,4457,8554,6278,3916,5324,11924,4249.403842,4804,8746,44391,8170,-3907,3344,8170,51554,52561,40484,47735,52561
13015,GA,10752,12273,4457,8554,6278,3916,5324,12487,4457.081474,4804,8753,45169,8456,-3621,3762,8456,51554,53625,41548,48931,53625
13017,GA,7956,12273,4457,8554,6278,3916,4946,11783,4313.304652,4804,7333,40105,7024,-5053,1670,7024,48380,47129,35052,41775,47129
13019,GA,7632,12273,4457,8554,6278,3916,4902,12273,4377.205461,4804,8554,41556,7310,-4767,2088,7310,48012,48866,36789,43644,48866
13021,GA,8760,12273,4457,8554,6278,3916,5054,12313,4281.354247,4804,8126,42201,7597,-4480,2507,7597,49292,49798,37721,44708,49798
13023,GA,7632,12273,4457,8554,6278,3916,4902,12273,4409.155866,4804,8554,41588,7310,-4767,2088,7310,48012,48898,36821,43676,48898
13025,GA,8040,12273,4457,8554,6278,3916,4957,12944,4584.883093,4804,8190,42478,7597,-4480,2507,7597,48475,50075,37998,44985,50075
13027,GA,8628,12273,4457,8554,6278,3916,5037,12089,4441.106271,4804,7863,41741,7310,-4767,2088,7310,49143,49051,36974,43829,49051
13029,GA,10320,12273,4457,8554,6278,3916,5265,13433,5016.213558,4804,8480,45970,8456,-3621,3762,8456,51063,54426,42349,49732,54426
13031,GA,8700,12273,4457,8554,6278,3916,5046,13200,4616.833498,4804,7721,42958,7597,-4480,2507,7597,49224,50555,38478,45465,50555
13033,GA,8760,12273,4457,8554,6278,3916,5054,12256,4185.503032,4804,8339,42261,7597,-4480,2507,7597,49292,49858,37781,44768,49858
13035,GA,9228,12273,4457,8554,6278,3916,5118,11878,5575.345643,4804,8744,44145,7883,-4194,2925,7883,49824,52028,39951,47070,52028
13037,GA,7632,12273,4457,8554,6278,3916,4902,12273,4473.056676,4804,8554,41652,7310,-4767,2088,7310,48012,48962,36885,43740,48962
13039,GA,9756,12273,4457,8554,6278,3916,5189,13313,4632.8087,4804,8636,45058,8170,-3907,3344,8170,50423,53228,41151,48402,53228
13043,GA,7632,12273,4457,8554,6278,3916,4902,12273,4409.155866,4804,8554,41588,7310,-4767,2088,7310,48012,48898,36821,43676,48898
13045,GA,10752,12273,4457,8554,6278,3916,5324,12257,4600.858295,4804,8753,45082,8170,-3907,3344,8170,51554,53252,41175,48426,53252
13047,GA,8148,12273,4457,8554,6278,3916,4972,12196,4233.42864,4804,8249,41546,7310,-4767,2088,7310,48598,48856,36779,43634,48856
13049,GA,7704,12273,4457,8554,6278,3916,4912,12273,4840.486331,4804,8554,42091,7310,-4767,2088,7310,48094,49401,37324,44179,49401
13051,GA,10320,12273,4457,8554,6278,3916,5265,13765,4712.684712,4804,8474,45992,8456,-3621,3762,8456,51063,54448,42371,49754,54448
13053,GA,8460,12273,4457,8554,6278,3916,5014,14285,4776.585522,4804,8167,44409,8170,-3907,3344,8170,48952,52579,40502,47753,52579
13055,GA,7632,12273,4457,8554,6278,3916,4902,11587,4281.354247,4804,7414,39635,6718,-5359,1251,6718,48012,46353,34276,40886,46353
13057,GA,10752,12273,4457,8554,6278,3916,5324,13379,4680.734307,4804,8743,46275,8743,-3334,4181,8743,51554,55018,42941,50456,55018
13059,GA,8652,12273,4457,8554,6278,3916,5040,13615,4505.007081,4804,8300,43792,7883,-4194,2925,7883,49170,51675,39598,46717,51675
13061,GA,7932,12273,4457,8554,6278,3916,4943,12273,4632.8087,4804,8554,42112,7310,-4767,2088,7310,48353,49422,37345,44200,49422
13063,GA,10752,12273,4457,8554,6278,3916,5324,12896,3818.073377,4804,8762,44947,8456,-3621,3762,8456,51554,53403,41326,48709,53403
13065,GA,7632,12273,4457,8554,6278,3916,4902,12273,4377.205461,4804,8554,41556,7310,-4767,2088,7310,48012,48866,36789,43644,48866
13067,GA,10752,12273,4457,8554,6278,3916,5324,14289,4680.734307,4804,8762,47205,8743,-3334,4181,8743,51554,55948,43871,51386,55948
13069,GA,7632,12273,4457,8554,6278,3916,4902,12314,4201.478235,4804,7690,40558,7024,-5053,1670,7024,48012,47582,35505,42228,47582
13071,GA,7632,12273,4457,8554,6278,3916,4902,12398,4233.42864,4804,7796,40780,7310,-4767,2088,7310,48012,48090,36013,42868,48090
13073,GA,8760,12273,4457,8554,6278,3916,5054,13037,4648.783903,4804,8347,43512,7883,-4194,2925,7883,49292,51395,39318,46437,51395
13075,GA,7860,12273,4457,8554,6278,3916,4933,12273,4409.155866,4804,8554,41816,7310,-4767,2088,7310,48271,49126,37049,43904,49126
13077,GA,10752,12273,4457,8554,6278,3916,5324,12442,4728.659915,4804,8741,45383,8456,-3621,3762,8456,51554,53839,41762,49145,53839
13079,GA,8760,12273,4457,8554,6278,3916,5054,13079,4329.279854,4804,8149,43037,7883,-4194,2925,7883,49292,50920,38843,45962,50920
13081,GA,7704,12273,4457,8554,6278,3916,4912,11927,4393.180664,4804,7588,40332,7024,-5053,1670,7024,48094,47356,35279,42002,47356
13083,GA,8148,12273,4457,8554,6278,3916,4972,11923,4425.131069,4804,8251,41467,7310,-4767,2088,7310,48598,48777,36700,43555,48777
13085,GA,10752,12273,4457,8554,6278,3916,5324,13248,4536.957486,4804,8744,46000,8456,-3621,3762,8456,51554,54456,42379,49762,54456
13087,GA,7848,12273,4457,8554,6278,3916,4931,12080,4632.8087,4804,7411,40691,7024,-5053,1670,7024,48257,47715,35638,42361,47715
13089,GA,10752,12273,4457,8554,6278,3916,5324,14613,4616.833498,4804,8785,47486,9029,-3048,4599,9029,51554,56515,44438,52085,56515
13091,GA,7632,12273,4457,8554,6278,3916,4902,12273,4313.304652,4804,8554,41492,7310,-4767,2088,7310,48012,48802,36725,43580,48802
13093,GA,7632,12273,4457,8554,6278,3916,4902,12273,4425.131069,4804,8554,41604,7310,-4767,2088,7310,48012,48914,36837,43692,48914
13095,GA,8400,12273,4457,8554,6278,3916,5006,12372,4393.180664,4804,7594,41479,7310,-4767,2088,7310,48884,48789,36712,43567,48789
13097,GA,10752,12273,4457,8554,6278,3916,5324,12922,4297.329449,4804,8746,45437,8456,-3621,3762,8456,51554,53893,41816,49199,53893
13099,GA,7632,12273,4457,8554,6278,3916,4902,12273,4616.833498,4804,8554,41796,7310,-4767,2088,7310,48012,49106,37029,43884,49106
13101,GA,8628,12273,4457,8554,6278,3916,5037,13434,4473.056676,4804,7868,43123,7883,-4194,2925,7883,49143,51006,38929,46048,51006
13103,GA,10320,12273,4457,8554,6278,3916,5265,13434,4457.081474,4804,8478,45409,8456,-3621,3762,8456,51063,53865,41788,49171,53865
13105,GA,7632,12273,4457,8554,6278,3916,4902,12273,4457.081474,4804,8554,41636,7310,-4767,2088,7310,48012,48946,36869,43724,48946
13107,GA,7632,12273,4457,8554,6278,3916,4902,12273,4089.651818,4804,8554,41269,7310,-4767,2088,7310,48012,48579,36502,43357,48579
13109,GA,7632,12273,4457,8554,6278,3916,4902,12273,4536.957486,4804,8554,41716,7310,-4767,2088,7310,48012,49026,36949,43804,49026
13111,GA,7632,12273,4457,8554,6278,3916,4902,12273,4776.585522,4804,8554,41956,7310,-4767,2088,7310,48012,49266,37189,44044,49266
13113,GA,10752,12273,4457,8554,6278,3916,5324,14130,4856.461534,4804,8751,47209,8743,-3334,4181,8743,51554,55952,43875,51390,55952
13115,GA,8088,12273,4457,8554,6278,3916,4964,12045,4329.279854,4804,8143,41324,7310,-4767,2088,7310,48530,48634,36557,43412,48634
13117,GA,10752,12273,4457,8554,6278,3916,5324,14399,5383.643214,4804,8745,47999,9029,-3048,4599,9029,51554,57028,44951,52598,57028
13119,GA,7632,12273,4457,8554,6278,3916,4902,12273,4648.783903,4804,8554,41828,7310,-4767,2088,7310,48012,49138,37061,43916,49138
13121,GA,10752,12273,4457,8554,6278,3916,5324,15863,4936.337546,4804,8789,49060,9316,-2761,5018,9316,51554,58376,46299,54078,58376
13123,GA,8340,12273,4457,8554,6278,3916,4998,12273,4457.081474,4804,8554,42344,7597,-4480,2507,7597,48816,49941,37864,44851,49941
13125,GA,7632,12273,4457,8554,6278,3916,4902,12273,4313.304652,4804,8554,41492,7310,-4767,2088,7310,48012,48802,36725,43580,48802
13127,GA,8040,12273,4457,8554,6278,3916,4957,13506,4968.287951,4804,8156,43390,7597,-4480,2507,7597,48475,50987,38910,45897,50987
13129,GA,8460,12273,4457,8554,6278,3916,5014,12060,4393.180664,4804,8408,42041,7597,-4480,2507,7597,48952,49638,37561,44548,49638
13131,GA,7632,12273,4457,8554,6278,3916,4902,12273,4281.354247,4804,8554,41460,7310,-4767,2088,7310,48012,48770,36693,43548,48770
13133,GA,7836,12273,4457,8554,6278,3916,4930,12273,4584.883093,4804,8554,41968,7310,-4767,2088,7310,48244,49278,37201,44056,49278
13135,GA,10752,12273,4457,8554,6278,3916,5324,13795,4409.155866,4804,8756,46432,8743,-3334,4181,8743,51554,55175,43098,50613,55175
13137,GA,7632,12273,4457,8554,6278,3916,4902,12158,4536.957486,4804,7865,40911,7024,-5053,1670,7024,48012,47935,35858,42581,47935
13139,GA,9780,12273,4457,8554,6278,3916,5192,12999,4473.056676,4804,8760,44732,8170,-3907,3344,8170,50450,52902,40825,48076,52902
13141,GA,7632,12273,4457,8554,6278,3916,4902,12711,4600.858295,4804,7417,41081,7024,-5053,1670,7024,48012,48105,36028,42751,48105
13143,GA,7632,12273,4457,8554,6278,3916,4902,12090,4409.155866,4804,8746,41597,7310,-4767,2088,7310,48012,48907,36830,43685,48907
13145,GA,8460,12273,4457,8554,6278,3916,5014,12713,4904.387141,4804,8202,43000,7597,-4480,2507,7597,48952,50597,38520,45507,50597
13147,GA,7632,12273,4457,8554,6278,3916,4902,12273,4409.155866,4804,8554,41588,7310,-4767,2088,7310,48012,48898,36821,43676,48898
13149,GA,10752,12273,4457,8554,6278,3916,5324,12647,4600.858295,4804,8742,45462,8456,-3621,3762,8456,51554,53918,41841,49224,53918
13151,GA,10752,12273,4457,8554,6278,3916,5324,12725,4313.304652,4804,8748,45258,8456,-3621,3762,8456,51554,53714,41637,49020,53714
13153,GA,9120,12273,4457,8554,6278,3916,5103,12261,4409.155866,4804,8569,43079,7883,-4194,2925,7883,49701,50962,38885,46004,50962
13155,GA,7632,12273,4457,8554,6278,3916,4902,12273,4297.329449,4804,8554,41476,7310,-4767,2088,7310,48012,48786,36709,43564,48786
13157,GA,9324,12273,4457,8554,6278,3916,5131,12818,4984.263153,4804,8625,44471,7883,-4194,2925,7883,49933,52354,40277,47396,52354
13159,GA,10752,12273,4457,8554,6278,3916,5324,11949,4313.304652,4804,8737,44470,8170,-3907,3344,8170,51554,52640,40563,47814,52640
13161,GA,7632,12273,4457,8554,6278,3916,4902,12273,4233.42864,4804,8554,41412,7310,-4767,2088,7310,48012,48722,36645,43500,48722
13163,GA,7632,12273,4457,8554,6278,3916,4902,12273,4393.180664,4804,8554,41572,7310,-4767,2088,7310,48012,48882,36805,43660,48882
13165,GA,7632,12273,4457,8554,6278,3916,4902,12273,4425.131069,4804,8554,41604,7310,-4767,2088,7310,48012,48914,36837,43692,48914
13167,GA,7632,12273,4457,8554,6278,3916,4902,11349,4265.379045,4804,7653,39619,6718,-5359,1251,6718,48012,46337,34260,40870,46337
13169,GA,8760,12273,4457,8554,6278,3916,5054,12723,3786.122972,4804,8166,42156,7597,-4480,2507,7597,49292,49753,37676,44663,49753
13171,GA,7632,12273,4457,8554,6278,3916,4902,12358,4409.155866,4804,8747,41866,7310,-4767,2088,7310,48012,49176,37099,43954,49176
13173,GA,8628,12273,4457,8554,6278,3916,5037,12585,4409.155866,4804,7850,42192,7597,-4480,2507,7597,49143,49789,37712,44699,49789
13175,GA,7632,12273,4457,8554,6278,3916,4902,12254,4409.155866,4804,7609,40624,7024,-5053,1670,7024,48012,47648,35571,42294,47648
13177,GA,8400,12273,4457,8554,6278,3916,5006,12697,4776.585522,4804,7674,42268,7310,-4767,2088,7310,48884,49578,37501,44356,49578
13179,GA,8964,12273,4457,8554,6278,3916,5082,13451,4377.205461,4804,8451,43964,8170,-3907,3344,8170,49524,52134,40057,47308,52134
13181,GA,7632,12273,4457,8554,6278,3916,4902,12963,4600.858295,4804,8341,42257,7597,-4480,2507,7597,48012,49854,37777,44764,49854
13183,GA,7632,12273,4457,8554,6278,3916,4902,13602,4297.329449,4804,8459,42711,7597,-4480,2507,7597,48012,50308,38231,45218,50308
13185,GA,8628,12273,4457,8554,6278,3916,5037,12407,4505.007081,4804,7812,42072,7597,-4480,2507,7597,49143,49669,37592,44579,49669
13187,GA,8952,12273,4457,8554,6278,3916,5080,12273,4792.560724,4804,8554,43292,7597,-4480,2507,7597,49510,50889,38812,45799,50889
13189,GA,8760,12273,4457,8554,6278,3916,5054,12194,4345.255057,4804,8334,42353,7597,-4480,2507,7597,49292,49950,37873,44860,49950
13191,GA,8040,12273,4457,8554,6278,3916,4957,13645,4632.8087,4804,8186,43224,7883,-4194,2925,7883,48475,51107,39030,46149,51107
13193,GA,7632,12273,4457,8554,6278,3916,4902,12273,4425.131069,4804,8554,41604,7310,-4767,2088,7310,48012,48914,36837,43692,48914
13195,GA,8652,12273,4457,8554,6278,3916,5040,12335,4680.734307,4804,8317,42705,7597,-4480,2507,7597,49170,50302,38225,45212,50302
13197,GA,8460,12273,4457,8554,6278,3916,5014,12716,4281.354247,4804,8177,42355,7597,-4480,2507,7597,48952,49952,37875,44862,49952
13199,GA,7632,12273,4457,8554,6278,3916,4902,11848,4872.436736,4804,8741,41813,7310,-4767,2088,7310,48012,49123,37046,43901,49123
13201,GA,7632,12273,4457,8554,6278,3916,4902,12273,4536.957486,4804,8554,41716,7310,-4767,2088,7310,48012,49026,36949,43804,49026
13205,GA,8268,12273,4457,8554,6278,3916,4988,12273,4409.155866,4804,8554,42224,7597,-4480,2507,7597,48734,49821,37744,44731,49821
13207,GA,7812,12273,4457,8554,6278,3916,4926,12892,4457.081474,4804,8142,42023,7597,-4480,2507,7597,48216,49620,37543,44530,49620
13209,GA,7632,12273,4457,8554,6278,3916,4902,12374,4201.478235,4804,7547,40474,7024,-5053,1670,7024,48012,47498,35421,42144,47498
13211,GA,8388,12273,4457,8554,6278,3916,5004,12472,4473.056676,4804,8739,42792,7597,-4480,2507,7597,48870,50389,38312,45299,50389
13213,GA,8004,12273,4457,8554,6278,3916,4952,12528,4600.858295,4804,8127,41980,7310,-4767,2088,7310,48434,49290,37213,44068,49290
13215,GA,8460,12273,4457,8554,6278,3916,5014,12569,4936.337546,4804,8150,42835,7597,-4480,2507,7597,48952,50432,38355,45342,50432
13217,GA,10752,12273,4457,8554,6278,3916,5324,12001,4249.403842,4804,8746,44469,8170,-3907,3344,8170,51554,52639,40562,47813,52639
13219,GA,8652,12273,4457,8554,6278,3916,5040,13369,4888.411939,4804,8338,43967,7883,-4194,2925,7883,49170,51850,39773,46892,51850
13221,GA,8652,12273,4457,8554,6278,3916,5040,12491,4680.734307,4804,8329,42873,7597,-4480,2507,7597,49170,50470,38393,45380,50470
13223,GA,10752,12273,4457,8554,6278,3916,5324,11997,4329.279854,4804,8742,44540,8170,-3907,3344,8170,51554,52710,40633,47884,52710
13225,GA,7692,12273,4457,8554,6278,3916,4910,12206,4169.52783,4804,8568,41355,7310,-4767,2088,7310,48080,48665,36588,43443,48665
13227,GA,10752,12273,4457,8554,6278,3916,5324,12767,4680.734307,4804,8745,45665,8456,-3621,3762,8456,51554,54121,42044,49427,54121
13229,GA,7632,12273,4457,8554,6278,3916,4902,12185,4153.552628,4804,7558,40249,7024,-5053,1670,7024,48012,47273,35196,41919,47273
13231,GA,10752,12273,4457,8554,6278,3916,5324,12607,4409.155866,4804,8739,45227,8456,-3621,3762,8456,51554,53683,41606,48989,53683
13233,GA,8052,12273,4457,8554,6278,3916,4959,11893,4361.230259,4804,7901,40928,7310,-4767,2088,7310,48489,48238,36161,43016,48238
13235,GA,7632,12273,4457,8554,6278,3916,4902,11787,4377.205461,4804,8568,41084,7310,-4767,2088,7310,48012,48394,36317,43172,48394
13237,GA,9684,12273,4457,8554,6278,3916,5179,12273,4425.131069,4804,8554,43656,7883,-4194,2925,7883,50341,51539,39462,46581,51539
13239,GA,7632,12273,4457,8554,6278,3916,4902,12273,4728.659915,4804,8554,41908,7310,-4767,2088,7310,48012,49218,37141,43996,49218
13241,GA,9204,12273,4457,8554,6278,3916,5115,12273,4473.056676,4804,8554,43224,7883,-4194,2925,7883,49797,51107,39030,46149,51107
13243,GA,7632,12273,4457,8554,6278,3916,4902,12273,4712.684712,4804,8554,41892,7310,-4767,2088,7310,48012,49202,37125,43980,49202
13245,GA,8760,12273,4457,8554,6278,3916,5054,12590,4329.279854,4804,8337,42736,7597,-4480,2507,7597,49292,50333,38256,45243,50333
13247,GA,10752,12273,4457,8554,6278,3916,5324,12747,4233.42864,4804,8747,45200,8456,-3621,3762,8456,51554,53656,41579,48962,53656
13249,GA,7632,12273,4457,8554,6278,3916,4902,12536,4441.106271,4804,7696,41025,7310,-4767,2088,7310,48012,48335,36258,43113,48335
13251,GA,7632,12273,4457,8554,6278,3916,4902,12273,4425.131069,4804,8554,41604,7310,-4767,2088,7310,48012,48914,36837,43692,48914
13253,GA,7632,12273,4457,8554,6278,3916,4902,12273,4632.8087,4804,8554,41812,7310,-4767,2088,7310,48012,49122,37045,43900,49122
13255,GA,10752,12273,4457,8554,6278,3916,5324,12104,4441.106271,4804,8754,44771,8170,-3907,3344,8170,51554,52941,40864,48115,52941
13257,GA,8232,12273,4457,8554,6278,3916,4983,12263,4489.031878,4804,7805,41509,7310,-4767,2088,7310,48693,48819,36742,43597,48819
13259,GA,7632,12273,4457,8554,6278,3916,4902,12273,4728.659915,4804,8554,41908,7310,-4767,2088,7310,48012,49218,37141,43996,49218
13261,GA,7632,12273,4457,8554,6278,3916,4902,12114,4505.007081,4804,7652,40623,7024,-5053,1670,7024,48012,47647,35570,42293,47647
13263,GA,8568,12273,4457,8554,6278,3916,5029,12273,4744.635117,4804,8554,42860,7597,-4480,2507,7597,49075,50457,38380,45367,50457
13265,GA,9840,12273,4457,8554,6278,3916,5201,12273,4808.535927,4804,8554,44196,7883,-4194,2925,7883,50519,52079,40002,47121,52079
13267,GA,7632,12273,4457,8554,6278,3916,4902,12273,4153.552628,4804,8554,41333,7310,-4767,2088,7310,48012,48643,36566,43421,48643
13269,GA,7632,12273,4457,8554,6278,3916,4902,12273,4425.131069,4804,8554,41604,7310,-4767,2088,7310,48012,48914,36837,43692,48914
13271,GA,7632,12273,4457,8554,6278,3916,4902,12273,4249.403842,4804,8554,41428,7310,-4767,2088,7310,48012,48738,36661,43516,48738
13273,GA,8400,12273,4457,8554,6278,3916,5006,11001,4473.056676,4804,7682,40277,7024,-5053,1670,7024,48884,47301,35224,41947,47301
13275,GA,8376,12273,4457,8554,6278,3916,5003,12209,4664.759105,4804,7441,41410,7310,-4767,2088,7310,48857,48720,36643,43498,48720
13277,GA,7848,12273,4457,8554,6278,3916,4931,12593,4505.007081,4804,7792,41458,7310,-4767,2088,7310,48257,48768,36691,43546,48768
13279,GA,7632,12273,4457,8554,6278,3916,4902,12053,4297.329449,4804,7506,40208,7024,-5053,1670,7024,48012,47232,35155,41878,47232
13281,GA,8184,12273,4457,8554,6278,3916,4977,12273,4664.759105,4804,8554,42396,7597,-4480,2507,7597,48639,49993,37916,44903,49993
13283,GA,7632,12273,4457,8554,6278,3916,4902,12273,4281.354247,4804,8554,41460,7310,-4767,2088,7310,48012,48770,36693,43548,48770
13285,GA,8400,12273,4457,8554,6278,3916,5006,11948,4712.684712,4804,8210,41991,7310,-4767,2088,7310,48884,49301,37224,44079,49301
13287,GA,7632,12273,4457,8554,6278,3916,4902,12273,4361.230259,4804,8554,41540,7310,-4767,2088,7310,48012,48850,36773,43628,48850
13289,GA,8760,12273,4457,8554,6278,3916,5054,12802,4329.279854,4804,8159,42770,7597,-4480,2507,7597,49292,50367,38290,45277,50367
13291,GA,8664,12273,4457,8554,6278,3916,5042,12273,4808.535927,4804,8554,43020,7597,-4480,2507,7597,49184,50617,38540,45527,50617
13293,GA,7632,12273,4457,8554,6278,3916,4902,11458,4297.329449,4804,7571,39679,6718,-5359,1251,6718,48012,46397,34320,40930,46397
13295,GA,8148,12273,4457,8554,6278,3916,4972,11500,4536.957486,4804,8242,41147,7310,-4767,2088,7310,48598,48457,36380,43235,48457
13297,GA,10752,12273,4457,8554,6278,3916,5324,12326,4632.8087,4804,8748,45179,8456,-3621,3762,8456,51554,53635,41558,48941,53635
13299,GA,7680,12273,4457,8554,6278,3916,4908,11869,4137.577425,4804,7513,39920,7024,-5053,1670,7024,48066,46944,34867,41590,46944
13301,GA,7632,12273,4457,8554,6278,3916,4902,12273,4377.205461,4804,8554,41556,7310,-4767,2088,7310,48012,48866,36789,43644,48866
13303,GA,7632,12273,4457,8554,6278,3916,4902,12273,4281.354247,4804,8554,41460,7310,-4767,2088,7310,48012,48770,36693,43548,48770
13305,GA,7632,12273,4457,8554,6278,3916,4902,12623,4249.403842,4804,7687,40912,7310,-4767,2088,7310,48012,48222,36145,43000,48222
13307,GA,7632,12273,4457,8554,6278,3916,4902,12273,4457.081474,4804,8554,41636,7310,-4767,2088,7310,48012,48946,36869,43724,48946
13309,GA,7632,12273,4457,8554,6278,3916,4902,12273,4297.329449,4804,8554,41476,7310,-4767,2088,7310,48012,48786,36709,43564,48786
13311,GA,7788,12273,4457,8554,6278,3916,4923,12273,4536.957486,4804,8554,41872,7310,-4767,2088,7310,48189,49182,37105,43960,49182
13313,GA,8364,12273,4457,8554,6278,3916,5001,12454,4105.62702,4804,8112,41755,7597,-4480,2507,7597,48843,49352,37275,44262,49352
13315,GA,7632,12273,4457,8554,6278,3916,4902,12273,4377.205461,4804,8554,41556,7310,-4767,2088,7310,48012,48866,36789,43644,48866
13317,GA,7632,12273,4457,8554,6278,3916,4902,12273,4728.659915,4804,8554,41908,7310,-4767,2088,7310,48012,49218,37141,43996,49218
13319,GA,7632,12273,4457,8554,6278,3916,4902,12273,4345.255057,4804,8554,41524,7310,-4767,2088,7310,48012,48834,36757,43612,48834
13321,GA,8400,12273,4457,8554,6278,3916,5006,12976,4217.453437,4804,7673,41986,7597,-4480,2507,7597,48884,49583,37506,44493,49583
15001,HI,11400,14267,5319,7382,4944,3971,5974,14366,5776.653982,4929,7390,47832,8473,-1998,5649,10079,53257,56305,45834,53481,57911
15003,HI,21840,14267,5319,7382,4944,3971,7511,20222,5891.04317,4929,8537,65390,13708,4768,13128,15314,65234,79098,70158,78518,80704
15005,HI,7644,14267,5319,7382,4944,3971,5421,12428,5910.108034,4929,8066,42948,6946,-3525,3462,8552,48948,49894,39423,46410,51500
15007,HI,19164,14267,5319,7382,4944,3971,7117,16400,5452.551283,4929,8090,58006,11236,1013,9600,12842,62164,69242,59019,67606,70848
15009,HI,15144,14267,5319,7382,4944,3971,6525,18170,6272.340462,4929,8152,56638,10618,147,8718,12224,57552,67256,56785,65356,68862
16001,ID,8628,7568,5319,7382,5422,3971,5434,6566,5566.940471,5121,7347,37199,5375,-6691,95,5386,43724,42574,30508,37294,42585
16003,ID,7644,7568,5319,7382,5422,3971,5285,7568,6138.88641,5121,7382,37825,5866,-6200,527,5877,42591,43691,31625,38352,43702
16005,ID,7644,7568,5319,7382,5422,3971,5285,8997,5185.643178,5121,7242,38161,6357,-5709,960,6368,42591,44518,32452,39121,44529
16007,ID,7644,7568,5319,7382,5422,3971,5285,7568,5395.356689,5121,7382,37081,5866,-6200,527,5877,42591,42947,30881,37608,42958
16009,ID,7644,7568,5319,7382,5422,3971,5285,7568,5643.199929,5121,7382,37329,5866,-6200,527,5877,42591,43195,31129,37856,43206
16011,ID,7644,7568,5319,7382,5422,3971,5285,6572,5204.708043,5121,7530,36043,5375,-6691,95,5386,42591,41418,29352,36138,41429
16013,ID,11112,7568,5319,7382,5422,3971,5809,10063,7835.659362,5121,7376,45479,7769,-4297,2690,7780,46583,53248,41182,48169,53259
16015,ID,8628,7568,5319,7382,5422,3971,5434,6803,5376.291825,5121,7353,37252,5866,-6200,527,5877,43724,43118,31052,37779,43129
16017,ID,8268,7568,5319,7382,5422,3971,5379,6322,6024.497222,5121,6743,36449,4884,-7182,-338,4895,43309,41333,29267,36111,41344
16019,ID,7920,7568,5319,7382,5422,3971,5327,6338,5052.189126,5121,7589,35991,5375,-6691,95,5386,42909,41366,29300,36086,41377
16021,ID,7644,7568,5319,7382,5422,3971,5285,7568,6024.497222,5121,7382,37710,5866,-6200,527,5877,42591,43576,31510,38237,43587
16023,ID,7644,7568,5319,7382,5422,3971,5285,8550,5147.513449,5121,7543,37977,6357,-5709,960,6368,42591,44334,32268,38937,44345
16025,ID,7644,7568,5319,7382,5422,3971,5285,6269,5204.708043,5121,7377,35587,4884,-7182,-338,4895,42591,40471,28405,35249,40482
16027,ID,8628,7568,5319,7382,5422,3971,5434,6327,4994.994532,5121,7349,36392,5375,-6691,95,5386,43724,41767,29701,36487,41778
16029,ID,7644,7568,5319,7382,5422,3971,5285,7568,5166.578314,5121,7382,36853,5866,-6200,527,5877,42591,42719,30653,37380,42730
16031,ID,7644,7568,5319,7382,5422,3971,5285,6474,5643.199929,5121,7317,36171,4884,-7182,-338,4895,42591,41055,28989,35833,41066
16033,ID,7644,7568,5319,7382,5422,3971,5285,7568,5319.097231,5121,7382,37005,5866,-6200,527,5877,42591,42871,30805,37532,42882
16035,ID,7644,7568,5319,7382,5422,3971,5285,7568,5662.264794,5121,7382,37348,5866,-6200,527,5877,42591,43214,31148,37875,43225
16037,ID,7644,7568,5319,7382,5422,3971,5285,7568,6043.562087,5121,7382,37730,5866,-6200,527,5877,42591,43596,31530,38257,43607
16039,ID,7644,7568,5319,7382,5422,3971,5285,8226,5357.22696,5121,7248,37567,5866,-6200,527,5877,42591,43433,31367,38094,43444
16041,ID,7644,7568,5319,7382,5422,3971,5285,7408,5280.967502,5121,7702,37128,5866,-6200,527,5877,42591,42994,30928,37655,43005
16043,ID,7716,7568,5319,7382,5422,3971,5296,6980,5509.745877,5121,7171,36469,5375,-6691,95,5386,42674,41844,29778,36564,41855
16045,ID,7668,7568,5319,7382,5422,3971,5289,9207,5357.22696,5121,7344,38668,6357,-5709,960,6368,42619,45025,32959,39628,45036
16047,ID,7644,7568,5319,7382,5422,3971,5285,7568,5147.513449,5121,7382,36834,5866,-6200,527,5877,42591,42700,30634,37361,42711
16049,ID,7644,7568,5319,7382,5422,3971,5285,7568,5814.783711,5121,7382,37501,5866,-6200,527,5877,42591,43367,31301,38028,43378
16051,ID,7920,7568,5319,7382,5422,3971,5327,7811,6043.562087,5121,7563,38430,5866,-6200,527,5877,42909,44296,32230,38957,44307
16053,ID,7692,7568,5319,7382,5422,3971,5292,9181,5166.578314,5121,7245,38377,6357,-5709,960,6368,42646,44734,32668,39337,44745
16055,ID,9036,7568,5319,7382,5422,3971,5496,6551,5566.940471,5121,7128,37374,5866,-6200,527,5877,44194,43240,31174,37901,43251
16057,ID,7860,7568,5319,7382,5422,3971,5318,9881,5586.005336,5121,6933,39353,6848,-5218,1392,6859,42840,46201,34135,40745,46212
16059,ID,7644,7568,5319,7382,5422,3971,5285,7568,6310.470191,5121,7382,37996,5866,-6200,527,5877,42591,43862,31796,38523,43873
16061,ID,7644,7568,5319,7382,5422,3971,5285,7568,5586.005336,5121,7382,37272,5866,-6200,527,5877,42591,43138,31072,37799,43149
16063,ID,7644,7568,5319,7382,5422,3971,5285,7062,5185.643178,5121,7377,36360,5375,-6691,95,5386,42591,41735,29669,36455,41746
16065,ID,7824,7568,5319,7382,5422,3971,5312,7023,5795.718846,5121,7169,36903,5375,-6691,95,5386,42798,42278,30212,36998,42289
16067,ID,7644,7568,5319,7382,5422,3971,5285,6973,5090.318855,5121,7317,36116,5375,-6691,95,5386,42591,41491,29425,36211,41502
16069,ID,7908,7568,5319,7382,5422,3971,5325,6605,6806.156672,5121,6984,37395,4884,-7182,-338,4895,42895,42279,30213,37057,42290
16071,ID,7644,7568,5319,7382,5422,3971,5285,7568,5185.643178,5121,7382,36872,5866,-6200,527,5877,42591,42738,30672,37399,42749
16073,ID,8628,7568,5319,7382,5422,3971,5434,7492,5414.421554,5121,7349,37975,5866,-6200,527,5877,43724,43841,31775,38502,43852
16075,ID,7848,7568,5319,7382,5422,3971,5316,8775,6177.016139,5121,6678,38569,5866,-6200,527,5877,42826,44435,32369,39096,44446
16077,ID,7644,7568,5319,7382,5422,3971,5285,7568,5185.643178,5121,7382,36872,5866,-6200,527,5877,42591,42738,30672,37399,42749
16079,ID,7644,7568,5319,7382,5422,3971,5285,7568,5643.199929,5121,7382,37329,5866,-6200,527,5877,42591,43195,31129,37856,43206
16081,ID,8280,7568,5319,7382,5422,3971,5381,8368,5376.291825,5121,8174,39291,6848,-5218,1392,6859,43323,46139,34073,40683,46150
16083,ID,7944,7568,5319,7382,5422,3971,5330,6770,5109.38372,5121,7238,36154,5375,-6691,95,5386,42936,41529,29463,36249,41540
16085,ID,8256,7568,5319,7382,5422,3971,5378,7568,5414.421554,5121,7382,37712,5866,-6200,527,5877,43296,43578,31512,38239,43589
16087,ID,7644,7568,5319,7382,5422,3971,5285,7568,5090.318855,5121,7382,36776,5866,-6200,527,5877,42591,42642,30576,37303,42653
17001,IL,7644,22807,4553,8320,6322,3699,6261,21789,4030.865797,4012,8009,49183,9109,-2910,5001,9167,59606,58292,46273,54184,58350
17003,IL,8148,22807,4553,8320,6322,3699,6344,24144,4177.73945,4012,8019,52200,9901,-2118,6189,9959,60193,62101,50082,58389,62159
17005,IL,8244,22807,4553,8320,6322,3699,6360,24567,4161.420155,4012,8275,52958,9901,-2118,6189,9959,60305,62859,50840,59147,62917
17007,IL,9048,22807,4553,8320,6322,3699,6493,20134,3818.714966,4012,8189,48901,9109,-2910,5001,9167,61242,58010,45991,53902,58068
17009,IL,9336,22807,4553,8320,6322,3699,6541,22807,3998.227208,4012,8320,52172,9901,-2118,6189,9959,61578,62073,50054,58361,62131
17011,IL,7980,22807,4553,8320,6322,3699,6317,24319,4634.679702,4012,8179,52824,9901,-2118,6189,9959,59998,62725,50706,59013,62783
17013,IL,9768,22807,4553,8320,6322,3699,6612,22752,4389.890281,4012,8278,52899,9901,-2118,6189,9959,62081,62800,50781,59088,62858
17015,IL,7644,22807,4553,8320,6322,3699,6261,22807,4047.185092,4012,8320,50529,9373,-2646,5397,9431,59606,59902,47883,55926,59960
17017,IL,7812,22807,4553,8320,6322,3699,6289,22807,4291.974513,4012,8320,50942,9373,-2646,5397,9431,59802,60315,48296,56339,60373
17019,IL,10344,22807,4553,8320,6322,3699,6707,20021,4487.80605,4012,8005,50568,9373,-2646,5397,9431,62752,59941,47922,55965,59999
17021,IL,8064,22807,4553,8320,6322,3699,6331,25242,3818.714966,4012,7843,52678,9901,-2118,6189,9959,60096,62579,50560,58867,62637
17023,IL,8364,22807,4553,8320,6322,3699,6380,22807,4063.504387,4012,8320,51266,9373,-2646,5397,9431,60445,60639,48620,56663,60697
17025,IL,7644,22807,4553,8320,6322,3699,6261,22807,3981.907913,4012,8320,50464,9373,-2646,5397,9431,59606,59837,47818,55861,59895
17027,IL,9768,22807,4553,8320,6322,3699,6612,23733,3786.076376,4012,8275,53273,10429,-1590,6981,10487,62081,63702,51683,60254,63760
17029,IL,8004,22807,4553,8320,6322,3699,6321,23529,4047.185092,4012,7435,50726,9373,-2646,5397,9431,60026,60099,48080,56123,60157
17031,IL,11748,22807,4553,8320,6322,3699,6939,25406,4324.613102,4012,8983,58173,11485,35,8565,11543,64388,69658,58208,66738,69716
17033,IL,7644,22807,4553,8320,6322,3699,6261,22807,4210.378039,4012,8320,50692,9373,-2646,5397,9431,59606,60065,48046,56089,60123
17035,IL,7644,22807,4553,8320,6322,3699,6261,21221,4030.865797,4012,7506,48112,8845,-3174,4605,8903,59606,56957,44938,52717,57015
17037,IL,10512,22807,4553,8320,6322,3699,6735,22485,4602.041113,4012,8878,54187,10429,-1590,6981,10487,62948,64616,52597,61168,64674
17039,IL,7644,22807,4553,8320,6322,3699,6261,25082,4340.932397,4012,8829,53606,9901,-2118,6189,9959,59606,63507,51488,59795,63565
17041,IL,8328,22807,4553,8320,6322,3699,6374,22807,4275.655218,4012,8320,51442,9373,-2646,5397,9431,60403,60815,48796,56839,60873
17043,IL,11748,22807,4553,8320,6322,3699,6939,26752,4504.125344,4012,8914,59629,11485,35,8565,11543,64388,71114,59664,68194,71172
17045,IL,7644,22807,4553,8320,6322,3699,6261,22807,4243.016629,4012,8320,50725,9373,-2646,5397,9431,59606,60098,48079,56122,60156
17047,IL,7644,22807,4553,8320,6322,3699,6261,22807,4422.528871,4012,8320,50905,9373,-2646,5397,9431,59606,60278,48259,56302,60336
17049,IL,7644,22807,4553,8320,6322,3699,6261,26058,3867.67285,4012,8342,53622,10429,-1590,6981,10487,59606,64051,52032,60603,64109
17051,IL,7644,22807,4553,8320,6322,3699,6261,22807,3622.883429,4012,8320,50105,9373,-2646,5397,9431,59606,59478,47459,55502,59536
17053,IL,10344,22807,4553,8320,6322,3699,6707,21943,4373.570986,4012,8044,52416,9901,-2118,6189,9959,62752,62317,50298,58605,62375
17055,IL,7644,22807,4553,8320,6322,3699,6261,22807,4455.16746,4012,8320,50937,9373,-2646,5397,9431,59606,60310,48291,56334,60368
17057,IL,7704,22807,4553,8320,6322,3699,6271,19286,3835.03426,4012,7797,46333,8581,-3438,4209,8639,59676,54914,42895,50542,54972
17059,IL,7644,22807,4553,8320,6322,3699,6261,22807,3998.227208,4012,8320,50480,9373,-2646,5397,9431,59606,59853,47834,55877,59911
17061,IL,7644,22807,4553,8320,6322,3699,6261,22807,4096.142976,4012,8320,50578,9373,-2646,5397,9431,59606,59951,47932,55975,60009
17063,IL,10956,22807,4553,8320,6322,3699,6808,23579,4438.848165,4012,8881,55566,10429,-1590,6981,10487,63465,65995,53976,62547,66053
17065,IL,7644,22807,4553,8320,6322,3699,6261,22807,4047.185092,4012,8320,50529,9373,-2646,5397,9431,59606,59902,47883,55926,59960
17067,IL,7644,22807,4553,8320,6322,3699,6261,22619,3949.269324,4012,7894,49817,9373,-2646,5397,9431,59606,59190,47171,55214,59248
17069,IL,7644,22807,4553,8320,6322,3699,6261,22807,3949.269324,4012,8320,50431,9373,-2646,5397,9431,59606,59804,47785,55828,59862
17071,IL,7644,22807,4553,8320,6322,3699,6261,21462,3932.950029,4012,7853,48603,9109,-2910,5001,9167,59606,57712,45693,53604,57770
17073,IL,8196,22807,4553,8320,6322,3699,6352,22131,3883.992145,4012,8150,50072,9373,-2646,5397,9431,60249,59445,47426,55469,59503
17075,IL,7788,22807,4553,8320,6322,3699,6285,22807,4471.486755,4012,8320,51097,9373,-2646,5397,9431,59774,60470,48451,56494,60528
17077,IL,8184,22807,4553,8320,6322,3699,6350,30408,4291.974513,4012,7415,58010,11485,35,8565,11543,60235,69495,58045,66575,69553
17079,IL,7644,22807,4553,8320,6322,3699,6261,22807,4128.781566,4012,8320,50611,9373,-2646,5397,9431,59606,59984,47965,56008,60042
17081,IL,7644,22807,4553,8320,6322,3699,6261,24229,3981.907913,4012,7794,51360,9373,-2646,5397,9431,59606,60733,48714,56757,60791
17083,IL,9768,22807,4553,8320,6322,3699,6612,26720,4471.486755,4012,8276,56946,10957,-814,7773,11015,62081,67903,56132,64719,67961
17085,IL,7644,22807,4553,8320,6322,3699,6261,22807,4863.149828,4012,8320,51345,9373,-2646,5397,9431,59606,60718,48699,56742,60776
17087,IL,7644,22807,4553,8320,6322,3699,6261,22807,4112.462271,4012,8320,50594,9373,-2646,5397,9431,59606,59967,47948,55991,60025
17089,IL,11748,22807,4553,8320,6322,3699,6939,23116,4226.697334,4012,8889,55690,10957,-814,7773,11015,64388,66647,54876,63463,66705
17091,IL,9096,22807,4553,8320,6322,3699,6501,21298,4373.570986,4012,8201,50679,9373,-2646,5397,9431,61298,60052,48033,56076,60110
17093,IL,11988,22807,4553,8320,6322,3699,6979,23519,4030.865797,4012,8861,56110,10957,-814,7773,11015,64668,67067,55296,63883,67125
17095,IL,7644,22807,4553,8320,6322,3699,6261,23875,4128.781566,4012,7521,50880,9373,-2646,5397,9431,59606,60253,48234,56277,60311
17097,IL,11748,22807,4553,8320,6322,3699,6939,19022,4634.679702,4012,8889,52005,9373,-2646,5397,9431,64388,61378,49359,57402,61436
17099,IL,9204,22807,4553,8320,6322,3699,6519,26234,4063.504387,4012,8171,55384,10429,-1590,6981,10487,61424,65813,53794,62365,65871
17101,IL,7644,22807,4553,8320,6322,3699,6261,22807,4389.890281,4012,8320,50872,9373,-2646,5397,9431,59606,60245,48226,56269,60303
17103,IL,7680,22807,4553,8320,6322,3699,6267,21459,3883.992145,4012,8058,48793,9109,-2910,5001,9167,59648,57902,45883,53794,57960
17105,IL,8160,22807,4553,8320,6322,3699,6346,20975,3835.03426,4012,7990,48672,9109,-2910,5001,9167,60207,57781,45762,53673,57839
17107,IL,7668,22807,4553,8320,6322,3699,6265,20921,3851.353555,4012,7449,47600,8845,-3174,4605,8903,59634,56445,44426,52205,56503
17109,IL,8496,22807,4553,8320,6322,3699,6402,25029,4014.546502,4012,7199,52450,9901,-2118,6189,9959,60599,62351,50332,58639,62409
17111,IL,11748,22807,4553,8320,6322,3699,6939,21565,4438.848165,4012,8867,54330,10429,-1590,6981,10487,64388,64759,52740,61311,64817
17113,IL,10380,22807,4553,8320,6322,3699,6713,21295,4422.528871,4012,8846,52654,9901,-2118,6189,9959,62794,62555,50536,58843,62613
17115,IL,8208,22807,4553,8320,6322,3699,6354,21125,4063.504387,4012,7885,48993,9109,-2910,5001,9167,60263,58102,46083,53994,58160
17117,IL,7644,22807,4553,8320,6322,3699,6261,23275,4585.721818,4012,8276,51491,9373,-2646,5397,9431,59606,60864,48845,56888,60922
17119,IL,9768,22807,4553,8320,6322,3699,6612,21990,4243.016629,4012,8269,51981,9901,-2118,6189,9959,62081,61882,49863,58170,61940
17121,IL,7644,22807,4553,8320,6322,3699,6261,22924,4357.251692,4012,7769,50406,9373,-2646,5397,9431,59606,59779,47760,55803,59837
17123,IL,8700,22807,4553,8320,6322,3699,6436,23935,4194.058744,4012,8193,52732,9901,-2118,6189,9959,60837,62633,50614,58921,62691
17125,IL,7644,22807,4553,8320,6322,3699,6261,22807,4210.378039,4012,8320,50692,9373,-2646,5397,9431,59606,60065,48046,56089,60123
17127,IL,8052,22807,4553,8320,6322,3699,6329,22554,4063.504387,4012,7832,50212,9373,-2646,5397,9431,60082,59585,47566,55609,59643
17129,IL,8916,22807,4553,8320,6322,3699,6471,24339,4291.974513,4012,8222,53480,9901,-2118,6189,9959,61088,63381,51362,59669,63439
17131,IL,8196,22807,4553,8320,6322,3699,6352,21568,4226.697334,4012,8154,49856,9373,-2646,5397,9431,60249,59229,47210,55253,59287
17133,IL,9768,22807,4553,8320,6322,3699,6612,24041,4765.23406,4012,8274,54559,10429,-1590,6981,10487,62081,64988,52969,61540,65046
17135,IL,8172,22807,4553,8320,6322,3699,6348,22807,3737.118492,4012,8320,50747,9373,-2646,5397,9431,60221,60120,48101,56144,60178
17137,IL,7812,22807,4553,8320,6322,3699,6289,21503,3851.353555,4012,7920,48798,9109,-2910,5001,9167,59802,57907,45888,53799,57965
17139,IL,7644,22807,4553,8320,6322,3699,6261,22807,4096.142976,4012,8320,50578,9373,-2646,5397,9431,59606,59951,47932,55975,60009
17141,IL,8268,22807,4553,8320,6322,3699,6364,27132,3818.714966,4012,8326,55255,10429,-1590,6981,10487,60333,65684,53665,62236,65742
17143,IL,8700,22807,4553,8320,6322,3699,6436,22799,4259.335923,4012,8172,51641,9373,-2646,5397,9431,60837,61014,48995,57038,61072
17145,IL,7644,22807,4553,8320,6322,3699,6261,22807,4357.251692,4012,8320,50839,9373,-2646,5397,9431,59606,60212,48193,56236,60270
17147,IL,10344,22807,4553,8320,6322,3699,6707,23365,4340.932397,4012,8047,53808,10429,-1590,6981,10487,62752,64237,52218,60789,64295
17149,IL,7644,22807,4553,8320,6322,3699,6261,22807,3949.269324,4012,8320,50431,9373,-2646,5397,9431,59606,59804,47785,55828,59862
17151,IL,7644,22807,4553,8320,6322,3699,6261,22807,4030.865797,4012,8320,50513,9373,-2646,5397,9431,59606,59886,47867,55910,59944
17153,IL,7644,22807,4553,8320,6322,3699,6261,22807,4112.462271,4012,8320,50594,9373,-2646,5397,9431,59606,59967,47948,55991,60025
17155,IL,7836,22807,4553,8320,6322,3699,6293,23669,4096.142976,4012,8182,51495,9373,-2646,5397,9431,59830,60868,48849,56892,60926
17157,IL,7824,22807,4553,8320,6322,3699,6291,22807,3671.841313,4012,8320,50334,9373,-2646,5397,9431,59816,59707,47688,55731,59765
17159,IL,7644,22807,4553,8320,6322,3699,6261,22807,4389.890281,4012,8320,50872,9373,-2646,5397,9431,59606,60245,48226,56269,60303
17161,IL,8196,22807,4553,8320,6322,3699,6352,21162,4210.378039,4012,8130,49409,9109,-2910,5001,9167,60249,58518,46499,54410,58576
17163,IL,9768,22807,4553,8320,6322,3699,6612,22859,4259.335923,4012,8267,52864,9901,-2118,6189,9959,62081,62765,50746,59053,62823
17165,IL,7644,22807,4553,8320,6322,3699,6261,22807,3851.353555,4012,8320,50333,9373,-2646,5397,9431,59606,59706,47687,55730,59764
17167,IL,8916,22807,4553,8320,6322,3699,6471,21175,4422.528871,4012,8206,50430,9373,-2646,5397,9431,61088,59803,47784,55827,59861
17169,IL,7644,22807,4553,8320,6322,3699,6261,22807,3998.227208,4012,8320,50480,9373,-2646,5397,9431,59606,59853,47834,55877,59911
17171,IL,7644,22807,4553,8320,6322,3699,6261,23116,3949.269324,4012,7963,50383,9373,-2646,5397,9431,59606,59756,47737,55780,59814
17173,IL,7644,22807,4553,8320,6322,3699,6261,22807,4177.73945,4012,8320,50660,9373,-2646,5397,9431,59606,60033,48014,56057,60091
17175,IL,8700,22807,4553,8320,6322,3699,6436,22133,4177.73945,4012,8198,50919,9373,-2646,5397,9431,60837,60292,48273,56316,60350
17177,IL,7836,22807,4553,8320,6322,3699,6293,24538,4096.142976,4012,7844,52025,9901,-2118,6189,9959,59830,61926,49907,58214,61984
17179,IL,8700,22807,4553,8320,6322,3699,6436,24390,4259.335923,4012,8180,53241,9901,-2118,6189,9959,60837,63142,51123,59430,63200
17181,IL,7644,22807,4553,8320,6322,3699,6261,22807,4177.73945,4012,8320,50660,9373,-2646,5397,9431,59606,60033,48014,56057,60091
17183,IL,8532,22807,4553,8320,6322,3699,6408,25793,3835.03426,4012,7830,53700,10429,-1590,6981,10487,60641,64129,52110,60681,64187
17185,IL,7824,22807,4553,8320,6322,3699,6291,22807,4422.528871,4012,8320,51085,9373,-2646,5397,9431,59816,60458,48439,56482,60516
17187,IL,8304,22807,4553,8320,6322,3699,6370,22807,4047.185092,4012,8320,51189,9373,-2646,5397,9431,60375,60562,48543,56586,60620
17189,IL,7944,22807,4553,8320,6322,3699,6311,22807,4112.462271,4012,8320,50894,9373,-2646,5397,9431,59956,60267,48248,56291,60325
17191,IL,7644,22807,4553,8320,6322,3699,6261,22807,4210.378039,4012,8320,50692,9373,-2646,5397,9431,59606,60065,48046,56089,60123
17193,IL,7644,22807,4553,8320,6322,3699,6261,22807,4226.697334,4012,8320,50709,9373,-2646,5397,9431,59606,60082,48063,56106,60140
17195,IL,8208,22807,4553,8320,6322,3699,6354,21868,4030.865797,4012,8052,49869,9373,-2646,5397,9431,60263,59242,47223,55266,59300
17197,IL,11748,22807,4553,8320,6322,3699,6939,23903,4389.890281,4012,8877,56630,10957,-814,7773,11015,64388,67587,55816,64403,67645
17199,IL,7800,22807,4553,8320,6322,3699,6287,26141,4030.865797,4012,7433,53116,9901,-2118,6189,9959,59788,63017,50998,59305,63075
17201,IL,9048,22807,4553,8320,6322,3699,6493,23385,4096.142976,4012,8187,52427,9901,-2118,6189,9959,61242,62328,50309,58616,62386
17203,IL,8700,22807,4553,8320,6322,3699,6436,22280,4650.998997,4012,8191,51533,9373,-2646,5397,9431,60837,60906,48887,56930,60964
18001,IN,7512,10892,4553,8320,6140,3699,5326,10255,4226.697334,5668,8256,39617,6341,-5668,942,6409,46442,45958,33949,40559,46026
18003,IN,7968,10892,4553,8320,6140,3699,5394,12063,4194.058744,5668,8199,41791,7139,-4870,2117,7207,46966,48930,36921,43908,48998
18005,IN,9924,10892,4553,8320,6140,3699,5685,10629,4112.462271,5668,8376,42409,7139,-4870,2117,7207,49213,49548,37539,44526,49616
18007,IN,9360,10892,4553,8320,6140,3699,5601,10194,4128.781566,5668,8030,41079,6879,-5130,1725,6947,48565,47958,35949,42804,48026
18009,IN,7512,10892,4553,8320,6140,3699,5326,10892,3981.907913,5668,8320,40073,6620,-5389,1334,6688,46442,46693,34684,41407,46761
18011,IN,9324,10892,4553,8320,6140,3699,5596,12569,4177.73945,5668,8308,43745,7658,-4351,2900,7726,48524,51403,39394,46645,51471
18013,IN,9324,10892,4553,8320,6140,3699,5596,10456,4210.378039,5668,8308,41666,7139,-4870,2117,7207,48524,48805,36796,43783,48873
18015,IN,7512,10892,4553,8320,6140,3699,5326,11166,4455.16746,5668,8025,40526,6620,-5389,1334,6688,46442,47146,35137,41860,47214
18017,IN,7512,10892,4553,8320,6140,3699,5326,9454,3688.160608,5668,7985,38006,5891,-6118,551,5959,46442,43897,31888,38557,43965
18019,IN,8460,10892,4553,8320,6140,3699,5467,10587,4063.504387,5668,8165,40643,6879,-5130,1725,6947,47531,47522,35513,42368,47590
18021,IN,8760,10892,4553,8320,6140,3699,5512,11062,3557.60625,5668,7897,40643,6879,-5130,1725,6947,47876,47522,35513,42368,47590
18023,IN,8016,10892,4553,8320,6140,3699,5401,10463,3606.564134,5668,8371,39823,6620,-5389,1334,6688,47021,46443,34434,41157,46511
18025,IN,7512,10892,4553,8320,6140,3699,5326,10892,4259.335923,5668,8320,40350,6620,-5389,1334,6688,46442,46970,34961,41684,47038
18027,IN,7512,10892,4553,8320,6140,3699,5326,9913,4438.848165,5668,8331,39562,6341,-5668,942,6409,46442,45903,33894,40504,45971
18029,IN,8820,10892,4553,8320,6140,3699,5521,12668,3883.992145,5668,8339,43077,7398,-4611,2508,7466,47945,50475,38466,45585,50543
18031,IN,8196,10892,4553,8320,6140,3699,5428,10758,3688.160608,5668,8185,40194,6879,-5130,1725,6947,47228,47073,35064,41919,47141
18033,IN,7512,10892,4553,8320,6140,3699,5326,11278,4324.613102,5668,8149,40630,6620,-5389,1334,6688,46442,47250,35241,41964,47318
18035,IN,8016,10892,4553,8320,6140,3699,5401,10530,4014.546502,5668,7380,39307,6341,-5668,942,6409,47021,45648,33639,40249,45716
18037,IN,7512,10892,4553,8320,6140,3699,5326,11045,4487.80605,5668,8372,40784,6620,-5389,1334,6688,46442,47404,35395,42118,47472
18039,IN,8904,10892,4553,8320,6140,3699,5533,11026,3900.311439,5668,8327,41524,7139,-4870,2117,7207,48041,48663,36654,43641,48731
18041,IN,7728,10892,4553,8320,6140,3699,5358,10983,4128.781566,5668,7322,39530,6341,-5668,942,6409,46690,45871,33862,40472,45939
18043,IN,8460,10892,4553,8320,6140,3699,5467,9863,4210.378039,5668,8166,40067,6620,-5389,1334,6688,47531,46687,34678,41401,46755
18045,IN,7512,10892,4553,8320,6140,3699,5326,10892,4177.73945,5668,8320,40269,6620,-5389,1334,6688,46442,46889,34880,41603,46957
18047,IN,8820,10892,4553,8320,6140,3699,5521,10892,4438.848165,5668,8320,41838,6879,-5130,1725,6947,47945,48717,36708,43563,48785
18049,IN,7836,10892,4553,8320,6140,3699,5374,10892,4291.974513,5668,8320,40707,6620,-5389,1334,6688,46814,47327,35318,42041,47395
18051,IN,7512,10892,4553,8320,6140,3699,5326,10892,4471.486755,5668,8320,40562,6620,-5389,1334,6688,46442,47182,35173,41896,47250
18053,IN,7512,10892,4553,8320,6140,3699,5326,11995,3916.630734,5668,7350,40141,6620,-5389,1334,6688,46442,46761,34752,41475,46829
18055,IN,7512,10892,4553,8320,6140,3699,5326,10892,4308.293808,5668,8320,40399,6620,-5389,1334,6688,46442,47019,35010,41733,47087
18057,IN,9324,10892,4553,8320,6140,3699,5596,10481,5010.023481,5668,8308,42490,7139,-4870,2117,7207,48524,49629,37620,44607,49697
18059,IN,9324,10892,4553,8320,6140,3699,5596,11000,4079.823681,5668,8308,42079,7139,-4870,2117,7207,48524,49218,37209,44196,49286
18061,IN,8460,10892,4553,8320,6140,3699,5467,9232,4177.73945,5668,8176,39413,6341,-5668,942,6409,47531,45754,33745,40355,45822
18063,IN,9324,10892,4553,8320,6140,3699,5596,10433,4308.293808,5668,8307,41740,6879,-5130,1725,6947,48524,48619,36610,43465,48687
18065,IN,7512,10892,4553,8320,6140,3699,5326,9617,3769.757082,5668,7724,37990,5891,-6118,551,5959,46442,43881,31872,38541,43949
18067,IN,7956,10892,4553,8320,6140,3699,5392,11788,4014.546502,5668,7716,40842,6879,-5130,1725,6947,46952,47721,35712,42567,47789
18069,IN,7740,10892,4553,8320,6140,3699,5360,10500,3753.437787,5668,8128,39488,6620,-5389,1334,6688,46704,46108,34099,40822,46176
18071,IN,8184,10892,4553,8320,6140,3699,5426,9998,3671.841313,5668,8109,39330,6620,-5389,1334,6688,47214,45950,33941,40664,46018
18073,IN,8292,10892,4553,8320,6140,3699,5442,9971,4438.848165,5668,8856,40926,6879,-5130,1725,6947,47338,47805,35796,42651,47873
18075,IN,7512,10892,4553,8320,6140,3699,5326,10892,4096.142976,5668,8320,40187,6620,-5389,1334,6688,46442,46807,34798,41521,46875
18077,IN,7512,10892,4553,8320,6140,3699,5326,10724,3753.437787,5668,7836,39193,6341,-5668,942,6409,46442,45534,33525,40135,45602
18079,IN,8112,10892,4553,8320,6140,3699,5415,10794,4194.058744,5668,8031,40498,6620,-5389,1334,6688,47131,47118,35109,41832,47186
18081,IN,9324,10892,4553,8320,6140,3699,5596,11287,4259.335923,5668,8308,42546,7139,-4870,2117,7207,48524,49685,37676,44663,49753
18083,IN,7512,10892,4553,8320,6140,3699,5326,11396,4438.848165,5668,7861,40576,6620,-5389,1334,6688,46442,47196,35187,41910,47264
18085,IN,8088,10892,4553,8320,6140,3699,5412,10937,3949.269324,5668,8281,40623,6879,-5130,1725,6947,47104,47502,35493,42348,47570
18087,IN,7932,10892,4553,8320,6140,3699,5388,10892,4438.848165,5668,8320,40950,6879,-5130,1725,6947,46924,47829,35820,42675,47897
18089,IN,9636,10892,4553,8320,6140,3699,5642,9921,4063.504387,5668,8884,41871,7139,-4870,2117,7207,48882,49010,37001,43988,49078
18091,IN,8628,10892,4553,8320,6140,3699,5492,10467,3965.588618,5668,7896,40324,6620,-5389,1334,6688,47724,46944,34935,41658,47012
18093,IN,7704,10892,4553,8320,6140,3699,5354,9940,3704.479903,5668,7829,38544,6341,-5668,942,6409,46662,44885,32876,39486,44953
18095,IN,8124,10892,4553,8320,6140,3699,5417,10540,4096.142976,5668,8306,40434,6620,-5389,1334,6688,47145,47054,35045,41768,47122
18097,IN,9324,10892,4553,8320,6140,3699,5596,14126,4177.73945,5668,8307,45301,7917,-4092,3291,7985,48524,53218,41209,48592,53286
18099,IN,8076,10892,4553,8320,6140,3699,5410,10155,3753.437787,5668,8157,39508,6620,-5389,1334,6688,47090,46128,34119,40842,46196
18101,IN,7512,10892,4553,8320,6140,3699,5326,10892,4112.462271,5668,8320,40203,6620,-5389,1334,6688,46442,46823,34814,41537,46891
18103,IN,7512,10892,4553,8320,6140,3699,5326,10332,3639.202724,5668,7928,38778,6341,-5668,942,6409,46442,45119,33110,39720,45187
18105,IN,9348,10892,4553,8320,6140,3699,5600,11523,4569.402523,5668,7772,42580,7139,-4870,2117,7207,48552,49719,37710,44697,49787
18107,IN,8316,10892,4553,8320,6140,3699,5446,11728,4324.613102,5668,8093,41828,7139,-4870,2117,7207,47366,48967,36958,43945,49035
18109,IN,9324,10892,4553,8320,6140,3699,5596,10159,4373.570986,5668,8307,41531,6879,-5130,1725,6947,48524,48410,36401,43256,48478
18111,IN,9636,10892,4553,8320,6140,3699,5642,10219,4112.462271,5668,8845,42179,7139,-4870,2117,7207,48882,49318,37309,44296,49386
18113,IN,7644,10892,4553,8320,6140,3699,5345,10590,4243.016629,5668,8184,40028,6620,-5389,1334,6688,46593,46648,34639,41362,46716
18115,IN,8820,10892,4553,8320,6140,3699,5521,10953,4373.570986,5668,8340,41853,7139,-4870,2117,7207,47945,48992,36983,43970,49060
18117,IN,7512,10892,4553,8320,6140,3699,5326,10892,4063.504387,5668,8320,40155,6620,-5389,1334,6688,46442,46775,34766,41489,46843
18119,IN,7512,10892,4553,8320,6140,3699,5326,10274,4618.360407,5668,7811,39582,6341,-5668,942,6409,46442,45923,33914,40524,45991
18121,IN,7512,10892,4553,8320,6140,3699,5326,10892,3981.907913,5668,8320,40073,6620,-5389,1334,6688,46442,46693,34684,41407,46761
18123,IN,7512,10892,4553,8320,6140,3699,5326,10892,4259.335923,5668,8320,40350,6620,-5389,1334,6688,46442,46970,34961,41684,47038
18125,IN,7512,10892,4553,8320,6140,3699,5326,14124,4324.613102,5668,8371,43699,7398,-4611,2508,7466,46442,51097,39088,46207,51165
18127,IN,9636,10892,4553,8320,6140,3699,5642,10933,4357.251692,5668,8862,43155,7398,-4611,2508,7466,48882,50553,38544,45663,50621
18129,IN,8868,10892,4553,8320,6140,3699,5528,9780,4634.679702,5668,8101,40750,6620,-5389,1334,6688,48000,47370,35361,42084,47438
18131,IN,7512,10892,4553,8320,6140,3699,5326,10892,3883.992145,5668,8320,39975,6620,-5389,1334,6688,46442,46595,34586,41309,46663
18133,IN,7512,10892,4553,8320,6140,3699,5326,12438,3737.118492,5668,8307,41362,7139,-4870,2117,7207,46442,48501,36492,43479,48569
18135,IN,7512,10892,4553,8320,6140,3699,5326,10892,3492.329071,5668,8320,39583,6620,-5389,1334,6688,46442,46203,34194,40917,46271
18137,IN,7560,10892,4553,8320,6140,3699,5333,10892,4585.721818,5668,8320,40725,6620,-5389,1334,6688,46497,47345,35336,42059,47413
18139,IN,7512,10892,4553,8320,6140,3699,5326,10892,4047.185092,5668,8320,40138,6620,-5389,1334,6688,46442,46758,34749,41472,46826
18141,IN,8568,10892,4553,8320,6140,3699,5483,11832,4128.781566,5668,8005,41900,7139,-4870,2117,7207,47655,49039,37030,44017,49107
18143,IN,7752,10892,4553,8320,6140,3699,5361,10045,4340.932397,5668,8168,39673,6341,-5668,942,6409,46717,46014,34005,40615,46082
18145,IN,9324,10892,4553,8320,6140,3699,5596,10889,3818.714966,5668,8307,41705,7139,-4870,2117,7207,48524,48844,36835,43822,48912
18147,IN,7512,10892,4553,8320,6140,3699,5326,10892,4504.125344,5668,8320,40595,6620,-5389,1334,6688,46442,47215,35206,41929,47283
18149,IN,7644,10892,4553,8320,6140,3699,5345,10892,4585.721818,5668,8320,40809,6620,-5389,1334,6688,46593,47429,35420,42143,47497
18151,IN,8112,10892,4553,8320,6140,3699,5415,12161,3851.353555,5668,8106,41598,7139,-4870,2117,7207,47131,48737,36728,43715,48805
18153,IN,7512,10892,4553,8320,6140,3699,5326,11381,4520.444639,5668,7905,40685,6620,-5389,1334,6688,46442,47305,35296,42019,47373
18155,IN,7512,10892,4553,8320,6140,3699,5326,10892,4177.73945,5668,8320,40269,6620,-5389,1334,6688,46442,46889,34880,41603,46957
18157,IN,9360,10892,4553,8320,6140,3699,5601,10184,4226.697334,5668,8003,41140,6879,-5130,1725,6947,48565,48019,36010,42865,48087
18159,IN,7956,10892,4553,8320,6140,3699,5392,10892,4471.486755,5668,8320,41006,6879,-5130,1725,6947,46952,47885,35876,42731,47953
18161,IN,7512,10892,4553,8320,6140,3699,5326,12836,4324.613102,5668,8339,42379,7139,-4870,2117,7207,46442,49518,37509,44496,49586
18163,IN,8868,10892,4553,8320,6140,3699,5528,11464,4226.697334,5668,8081,42007,7139,-4870,2117,7207,48000,49146,37137,44124,49214
18165,IN,8760,10892,4553,8320,6140,3699,5512,12211,3949.269324,5668,7906,42193,7139,-4870,2117,7207,47876,49332,37323,44310,49400
18167,IN,8760,10892,4553,8320,6140,3699,5512,12893,4063.504387,5668,7862,42945,7398,-4611,2508,7466,47876,50343,38334,45453,50411
18169,IN,7512,10892,4553,8320,6140,3699,5326,9884,4243.016629,5668,7899,38905,6341,-5668,942,6409,46442,45246,33237,39847,45314
18171,IN,7512,10892,4553,8320,6140,3699,5326,10892,4177.73945,5668,8320,40269,6620,-5389,1334,6688,46442,46889,34880,41603,46957
18173,IN,8868,10892,4553,8320,6140,3699,5528,12337,4683.637586,5668,8100,43356,7398,-4611,2508,7466,48000,50754,38745,45864,50822
18175,IN,7512,10892,4553,8320,6140,3699,5326,11411,4830.511239,5668,8173,41294,6879,-5130,1725,6947,46442,48173,36164,43019,48241
18177,IN,7656,10892,4553,8320,6140,3699,5347,9847,3916.630734,5668,7334,38121,5891,-6118,551,5959,46607,44012,32003,38672,44080
18179,IN,7968,10892,4553,8320,6140,3699,5394,10540,4177.73945,5668,8200,40252,6620,-5389,1334,6688,46966,46872,34863,41586,46940
18181,IN,7512,10892,4553,8320,6140,3699,5326,10892,4194.058744,5668,8320,40285,6620,-5389,1334,6688,46442,46905,34896,41619,46973
18183,IN,7968,10892,4553,8320,6140,3699,5394,9443,3753.437787,5668,8203,38734,6341,-5668,942,6409,46966,45075,33066,39676,45143
19001,IA,7428,8693,4553,8320,5881,3699,6838,8693,4422.528871,5440,8320,38003,5389,-5438,1231,6639,45412,43392,32565,39234,44642
19003,IA,7488,8693,4553,8320,5881,3699,6849,8693,4161.420155,5440,8320,37801,5389,-5438,1231,6639,45483,43190,32363,39032,44440
19005,IA,6948,8693,4553,8320,5881,3699,6748,8693,4096.142976,5440,8320,37196,4904,-5923,804,6154,44842,42100,31273,38000,43350
19007,IA,6948,8693,4553,8320,5881,3699,6748,8693,3769.757082,5440,8320,36870,4904,-5923,804,6154,44842,41774,30947,37674,43024
19009,IA,6948,8693,4553,8320,5881,3699,6748,8693,4291.974513,5440,8320,37392,4904,-5923,804,6154,44842,42296,31469,38196,43546
19011,IA,6948,8693,4553,8320,5881,3699,6748,9347,4308.293808,5440,8388,38130,5389,-5438,1231,6639,44842,43519,32692,39361,44769
19013,IA,8640,8693,4553,8320,5881,3699,7065,8820,4194.058744,5440,8157,38950,5874,-4953,1657,7124,46851,44824,33997,40607,46074
19015,IA,7536,8693,4553,8320,5881,3699,6858,8482,4243.016629,5440,8206,37606,4904,-5923,804,6154,45540,42510,31683,38410,43760
19017,IA,7800,8693,4553,8320,5881,3699,6908,11093,4389.890281,5440,8164,40586,6188,-4639,2084,7438,45854,46774,35947,42670,48024
19019,IA,6948,8693,4553,8320,5881,3699,6748,8693,4389.890281,5440,8320,37490,4904,-5923,804,6154,44842,42394,31567,38294,43644
19021,IA,7320,8693,4553,8320,5881,3699,6818,8802,4161.420155,5440,8238,37660,5389,-5438,1231,6639,45284,43049,32222,38891,44299
19023,IA,6948,8693,4553,8320,5881,3699,6748,8693,4210.378039,5440,8320,37310,4904,-5923,804,6154,44842,42214,31387,38114,43464
19025,IA,6948,8693,4553,8320,5881,3699,6748,8693,4096.142976,5440,8320,37196,4904,-5923,804,6154,44842,42100,31273,38000,43350
19027,IA,6948,8693,4553,8320,5881,3699,6748,8693,4438.848165,5440,8320,37539,4904,-5923,804,6154,44842,42443,31616,38343,43693
19029,IA,6948,8693,4553,8320,5881,3699,6748,8693,4128.781566,5440,8320,37229,4904,-5923,804,6154,44842,42133,31306,38033,43383
19031,IA,7620,8693,4553,8320,5881,3699,6874,8693,4324.613102,5440,8320,38097,5389,-5438,1231,6639,45640,43486,32659,39328,44736
19033,IA,7992,8693,4553,8320,5881,3699,6944,9521,4194.058744,5440,7857,38703,5874,-4953,1657,7124,46082,44577,33750,40360,45827
19035,IA,6948,8693,4553,8320,5881,3699,6748,8693,4259.335923,5440,8320,37359,4904,-5923,804,6154,44842,42263,31436,38163,43513
19037,IA,6948,8693,4553,8320,5881,3699,6748,8693,4243.016629,5440,8320,37343,4904,-5923,804,6154,44842,42247,31420,38147,43497
19039,IA,7692,8693,4553,8320,5881,3699,6887,8693,4357.251692,5440,8320,38201,5389,-5438,1231,6639,45725,43590,32763,39432,44840
19041,IA,6948,8693,4553,8320,5881,3699,6748,8983,4324.613102,5440,8046,37440,4904,-5923,804,6154,44842,42344,31517,38244,43594
19043,IA,6948,8693,4553,8320,5881,3699,6748,8693,4210.378039,5440,8320,37310,4904,-5923,804,6154,44842,42214,31387,38114,43464
19045,IA,7488,8693,4553,8320,5881,3699,6849,8390,4030.865797,5440,8106,37154,4904,-5923,804,6154,45483,42058,31231,37958,43308
19047,IA,6948,8693,4553,8320,5881,3699,6748,8693,4226.697334,5440,8320,37327,4904,-5923,804,6154,44842,42231,31404,38131,43481
19049,IA,9396,8693,4553,8320,5881,3699,7206,8065,4520.444639,5440,8815,39936,5874,-4953,1657,7124,47748,45810,34983,41593,47060
19051,IA,7464,8693,4553,8320,5881,3699,6845,8513,3900.311439,5440,7912,36928,4904,-5923,804,6154,45455,41832,31005,37732,43082
19053,IA,6948,8693,4553,8320,5881,3699,6748,8693,4047.185092,5440,8320,37147,4904,-5923,804,6154,44842,42051,31224,37951,43301
19055,IA,6948,8693,4553,8320,5881,3699,6748,8693,4259.335923,5440,8320,37359,4904,-5923,804,6154,44842,42263,31436,38163,43513
19057,IA,8184,8693,4553,8320,5881,3699,6980,7995,4079.823681,5440,7783,37181,4904,-5923,804,6154,46310,42085,31258,37985,43335
19059,IA,7224,8693,4553,8320,5881,3699,6800,9019,4340.932397,5440,7971,37694,4904,-5923,804,6154,45170,42598,31771,38498,43848
19061,IA,8700,8693,4553,8320,5881,3699,7076,8236,4389.890281,5440,8282,38748,5389,-5438,1231,6639,46922,44137,33310,39979,45387
19063,IA,7404,8693,4553,8320,5881,3699,6833,8693,4536.763934,5440,8320,38093,5389,-5438,1231,6639,45383,43482,32655,39324,44732
19065,IA,6948,8693,4553,8320,5881,3699,6748,8693,4291.974513,5440,8320,37392,4904,-5923,804,6154,44842,42296,31469,38196,43546
19067,IA,6948,8693,4553,8320,5881,3699,6748,8693,4226.697334,5440,8320,37327,4904,-5923,804,6154,44842,42231,31404,38131,43481
19069,IA,6948,8693,4553,8320,5881,3699,6748,8693,4210.378039,5440,8320,37310,4904,-5923,804,6154,44842,42214,31387,38114,43464
19071,IA,6948,8693,4553,8320,5881,3699,6748,8693,4308.293808,5440,8320,37408,4904,-5923,804,6154,44842,42312,31485,38212,43562
19073,IA,7080,8693,4553,8320,5881,3699,6773,8693,4340.932397,5440,8320,37573,4904,-5923,804,6154,44999,42477,31650,38377,43727
19075,IA,8640,8693,4553,8320,5881,3699,7065,8664,4161.420155,5440,8171,38775,5874,-4953,1657,7124,46851,44649,33822,40432,45899
19077,IA,9396,8693,4553,8320,5881,3699,7206,8457,4357.251692,5440,8796,40145,6188,-4639,2084,7438,47748,46333,35506,42229,47583
19079,IA,7824,8693,4553,8320,5881,3699,6912,8693,4226.697334,5440,8320,38203,5389,-5438,1231,6639,45882,43592,32765,39434,44842
19081,IA,6948,8693,4553,8320,5881,3699,6748,8693,4243.016629,5440,8320,37343,4904,-5923,804,6154,44842,42247,31420,38147,43497
19083,IA,6948,8693,4553,8320,5881,3699,6748,8693,4210.378039,5440,8320,37310,4904,-5923,804,6154,44842,42214,31387,38114,43464
19085,IA,9480,8693,4553,8320,5881,3699,7222,8623,4389.890281,5440,8511,40143,6188,-4639,2084,7438,47848,46331,35504,42227,47581
19087,IA,7176,8693,4553,8320,5881,3699,6791,8693,3688.160608,5440,8320,37016,4904,-5923,804,6154,45113,41920,31093,37820,43170
19089,IA,6948,8693,4553,8320,5881,3699,6748,8693,4161.420155,5440,8320,37261,4904,-5923,804,6154,44842,42165,31338,38065,43415
19091,IA,6948,8693,4553,8320,5881,3699,6748,8693,4096.142976,5440,8320,37196,4904,-5923,804,6154,44842,42100,31273,38000,43350
19093,IA,6948,8693,4553,8320,5881,3699,6748,8693,4275.655218,5440,8320,37376,4904,-5923,804,6154,44842,42280,31453,38180,43530
19095,IA,6948,8693,4553,8320,5881,3699,6748,8693,4438.848165,5440,8320,37539,4904,-5923,804,6154,44842,42443,31616,38343,43693
19097,IA,6948,8693,4553,8320,5881,3699,6748,8693,4275.655218,5440,8320,37376,4904,-5923,804,6154,44842,42280,31453,38180,43530
19099,IA,7860,8693,4553,8320,5881,3699,6919,8410,4487.80605,5440,8007,37903,4904,-5923,804,6154,45925,42807,31980,38707,44057
19101,IA,7668,8693,4553,8320,5881,3699,6883,9342,3916.630734,5440,7815,37881,5389,-5438,1231,6639,45697,43270,32443,39112,44520
19103,IA,10212,8693,4553,8320,5881,3699,7359,9703,4585.721818,5440,8331,41971,6482,-4345,2510,7732,48717,48453,37626,44481,49703
19105,IA,6948,8693,4553,8320,5881,3699,6748,8660,4373.570986,5440,8390,37511,4904,-5923,804,6154,44842,42415,31588,38315,43665
19107,IA,6948,8693,4553,8320,5881,3699,6748,8693,4357.251692,5440,8320,37457,4904,-5923,804,6154,44842,42361,31534,38261,43611
19109,IA,6948,8693,4553,8320,5881,3699,6748,8693,4471.486755,5440,8320,37571,4904,-5923,804,6154,44842,42475,31648,38375,43725
19111,IA,7068,8693,4553,8320,5881,3699,6771,9788,3639.202724,5440,7862,37497,5389,-5438,1231,6639,44985,42886,32059,38728,44136
19113,IA,7860,8693,4553,8320,5881,3699,6919,7828,4373.570986,5440,8391,37591,4904,-5923,804,6154,45925,42495,31668,38395,43745
19115,IA,7416,8693,4553,8320,5881,3699,6836,8693,4324.613102,5440,8320,37893,5389,-5438,1231,6639,45398,43282,32455,39124,44532
19117,IA,6948,8693,4553,8320,5881,3699,6748,8693,4079.823681,5440,8320,37180,4904,-5923,804,6154,44842,42084,31257,37984,43334
19119,IA,6948,8693,4553,8320,5881,3699,6748,8693,4373.570986,5440,8320,37474,4904,-5923,804,6154,44842,42378,31551,38278,43628
19121,IA,9396,8693,4553,8320,5881,3699,7206,9001,4357.251692,5440,8802,40695,6188,-4639,2084,7438,47748,46883,36056,42779,48133
19123,IA,7020,8693,4553,8320,5881,3699,6762,8340,4275.655218,5440,8064,36838,4904,-5923,804,6154,44928,41742,30915,37642,42992
19125,IA,8412,8693,4553,8320,5881,3699,7022,8693,4422.528871,5440,8320,38987,5874,-4953,1657,7124,46580,44861,34034,40644,46111
19127,IA,7500,8693,4553,8320,5881,3699,6851,8690,3949.269324,5440,8285,37564,5389,-5438,1231,6639,45497,42953,32126,38795,44203
19129,IA,9480,8693,4553,8320,5881,3699,7222,9936,4389.890281,5440,8511,41456,6482,-4345,2510,7732,47848,47938,37111,43966,49188
19131,IA,6948,8693,4553,8320,5881,3699,6748,8693,4210.378039,5440,8320,37310,4904,-5923,804,6154,44842,42214,31387,38114,43464
19133,IA,6948,8693,4553,8320,5881,3699,6748,8693,4275.655218,5440,8320,37376,4904,-5923,804,6154,44842,42280,31453,38180,43530
19135,IA,7104,8693,4553,8320,5881,3699,6777,8693,3965.588618,5440,8320,37222,4904,-5923,804,6154,45027,42126,31299,38026,43376
19137,IA,6948,8693,4553,8320,5881,3699,6748,8693,4145.10086,5440,8320,37245,4904,-5923,804,6154,44842,42149,31322,38049,43399
19139,IA,8556,8693,4553,8320,5881,3699,7049,8531,3949.269324,5440,8345,38520,5874,-4953,1657,7124,46751,44394,33567,40177,45644
19141,IA,6948,8693,4553,8320,5881,3699,6748,8693,4259.335923,5440,8320,37359,4904,-5923,804,6154,44842,42263,31436,38163,43513
19143,IA,7368,8693,4553,8320,5881,3699,6827,8693,4291.974513,5440,8320,37812,5389,-5438,1231,6639,45341,43201,32374,39043,44451
19145,IA,6948,8693,4553,8320,5881,3699,6748,8693,4308.293808,5440,8320,37408,4904,-5923,804,6154,44842,42312,31485,38212,43562
19147,IA,6948,8693,4553,8320,5881,3699,6748,8693,4406.209576,5440,8320,37506,4904,-5923,804,6154,44842,42410,31583,38310,43660
19149,IA,7500,8693,4553,8320,5881,3699,6851,8291,4259.335923,5440,8361,37551,4904,-5923,804,6154,45497,42455,31628,38355,43705
19151,IA,6948,8693,4553,8320,5881,3699,6748,8693,4128.781566,5440,8320,37229,4904,-5923,804,6154,44842,42133,31306,38033,43383
19153,IA,9396,8693,4553,8320,5881,3699,7206,8111,4324.613102,5440,8835,39806,6188,-4639,2084,7438,47748,45994,35167,41890,47244
19155,IA,9480,8693,4553,8320,5881,3699,7222,8486,4112.462271,5440,8521,39738,6188,-4639,2084,7438,47848,45926,35099,41822,47176
19157,IA,7740,8693,4553,8320,5881,3699,6896,8693,4112.462271,5440,8320,38004,5389,-5438,1231,6639,45782,43393,32566,39235,44643
19159,IA,6948,8693,4553,8320,5881,3699,6748,8693,4047.185092,5440,8320,37147,4904,-5923,804,6154,44842,42051,31224,37951,43301
19161,IA,6948,8693,4553,8320,5881,3699,6748,8693,4226.697334,5440,8320,37327,4904,-5923,804,6154,44842,42231,31404,38131,43481
19163,IA,8196,8693,4553,8320,5881,3699,6982,10031,4357.251692,5440,8129,39852,6188,-4639,2084,7438,46324,46040,35213,41936,47290
19165,IA,6948,8693,4553,8320,5881,3699,6748,8693,4161.420155,5440,8320,37261,4904,-5923,804,6154,44842,42165,31338,38065,43415
19167,IA,6948,8693,4553,8320,5881,3699,6748,8693,4145.10086,5440,8320,37245,4904,-5923,804,6154,44842,42149,31322,38049,43399
19169,IA,8604,8693,4553,8320,5881,3699,7058,8099,4406.209576,5440,8232,38481,5389,-5438,1231,6639,46808,43870,33043,39712,45120
19171,IA,7152,8693,4553,8320,5881,3699,6786,8693,4177.73945,5440,8320,37482,4904,-5923,804,6154,45084,42386,31559,38286,43636
19173,IA,6948,8693,4553,8320,5881,3699,6748,8693,4194.058744,5440,8320,37294,4904,-5923,804,6154,44842,42198,31371,38098,43448
19175,IA,6948,8693,4553,8320,5881,3699,6748,8693,4128.781566,5440,8320,37229,4904,-5923,804,6154,44842,42133,31306,38033,43383
19177,IA,6948,8693,4553,8320,5881,3699,6748,8693,3818.714966,5440,8320,36919,4904,-5923,804,6154,44842,41823,30996,37723,43073
19179,IA,7800,8693,4553,8320,5881,3699,6908,8149,3851.353555,5440,7857,36797,4904,-5923,804,6154,45854,41701,30874,37601,42951
19181,IA,9396,8693,4553,8320,5881,3699,7206,9842,4455.16746,5440,8804,41636,6482,-4345,2510,7732,47748,48118,37291,44146,49368
19183,IA,7740,8693,4553,8320,5881,3699,6896,7764,4210.378039,5440,8333,37187,4904,-5923,804,6154,45782,42091,31264,37991,43341
19185,IA,6948,8693,4553,8320,5881,3699,6748,8693,3769.757082,5440,8320,36870,4904,-5923,804,6154,44842,41774,30947,37674,43024
19187,IA,6948,8693,4553,8320,5881,3699,6748,8904,3949.269324,5440,7704,36645,4904,-5923,804,6154,44842,41549,30722,37449,42799
19189,IA,6948,8693,4553,8320,5881,3699,6748,8693,4340.932397,5440,8320,37441,4904,-5923,804,6154,44842,42345,31518,38245,43595
19191,IA,6948,8693,4553,8320,5881,3699,6748,8693,4520.444639,5440,8320,37620,4904,-5923,804,6154,44842,42524,31697,38424,43774
19193,IA,8352,8693,4553,8320,5881,3699,7011,8449,4324.613102,5440,8372,38637,5389,-5438,1231,6639,46509,44026,33199,39868,45276
19195,IA,6948,8693,4553,8320,5881,3699,6748,12155,4210.378039,5440,7913,40365,6188,-4639,2084,7438,44842,46553,35726,42449,47803
19197,IA,6948,8693,4553,8320,5881,3699,6748,8693,4145.10086,5440,8320,37245,4904,-5923,804,6154,44842,42149,31322,38049,43399
20001,KS,7464,5216,4553,8320,6001,3699,5870,5216,4634.679702,4360,8320,33694,3444,-8498,-1537,3579,41123,37138,25196,32157,37273
20003,KS,7464,5216,4553,8320,6001,3699,5870,5216,4814.191944,4360,8320,33873,3444,-8498,-1537,3579,41123,37317,25375,32336,37452
20005,KS,7464,5216,4553,8320,6001,3699,5870,4812,4618.360407,4360,7967,32920,2981,-8961,-1941,3116,41123,35901,23959,30979,36036
20007,KS,7464,5216,4553,8320,6001,3699,5870,5216,4814.191944,4360,8320,33873,3444,-8498,-1537,3579,41123,37317,25375,32336,37452
20009,KS,7464,5216,4553,8320,6001,3699,5870,4478,4536.763934,4360,8023,32561,2981,-8961,-1941,3116,41123,35542,23600,30620,35677
20011,KS,7596,5216,4553,8320,6001,3699,5891,5216,4373.570986,4360,8320,33565,3444,-8498,-1537,3579,41276,37009,25067,32028,37144
20013,KS,7464,5216,4553,8320,6001,3699,5870,5216,4259.335923,4360,8320,33318,3444,-8498,-1537,3579,41123,36762,24820,31781,36897
20015,KS,8880,5216,4553,8320,6001,3699,6101,5360,4863.149828,4360,8284,35446,4370,-7572,-728,4505,42770,39816,27874,34718,39951
20017,KS,7464,5216,4553,8320,6001,3699,5870,5216,4422.528871,4360,8320,33482,3444,-8498,-1537,3579,41123,36926,24984,31945,37061
20019,KS,7464,5216,4553,8320,6001,3699,5870,5216,4569.402523,4360,8320,33628,3444,-8498,-1537,3579,41123,37072,25130,32091,37207
20021,KS,7464,5216,4553,8320,6001,3699,5870,5216,4748.914765,4360,8320,33808,3444,-8498,-1537,3579,41123,37252,25310,32271,37387
20023,KS,7464,5216,4553,8320,6001,3699,5870,5216,4912.107712,4360,8320,33971,3444,-8498,-1537,3579,41123,37415,25473,32434,37550
20025,KS,7464,5216,4553,8320,6001,3699,5870,5216,4455.16746,4360,8320,33514,3444,-8498,-1537,3579,41123,36958,25016,31977,37093
20027,KS,8628,5216,4553,8320,6001,3699,6060,5216,4455.16746,4360,8320,34678,3907,-8035,-1132,4042,42477,38585,26643,33546,38720
20029,KS,7464,5216,4553,8320,6001,3699,5870,5216,4553.083228,4360,8320,33612,3444,-8498,-1537,3579,41123,37056,25114,32075,37191
20031,KS,7464,5216,4553,8320,6001,3699,5870,5216,4259.335923,4360,8320,33318,3444,-8498,-1537,3579,41123,36762,24820,31781,36897
20033,KS,7464,5216,4553,8320,6001,3699,5870,5216,4781.553355,4360,8320,33841,3444,-8498,-1537,3579,41123,37285,25343,32304,37420
20035,KS,7680,5216,4553,8320,6001,3699,5905,4719,4569.402523,4360,7883,32910,2981,-8961,-1941,3116,41374,35891,23949,30969,36026
20037,KS,8028,5216,4553,8320,6001,3699,5962,4721,4047.185092,4360,7541,32397,2981,-8961,-1941,3116,41779,35378,23436,30456,35513
20039,KS,7464,5216,4553,8320,6001,3699,5870,5216,4732.59547,4360,8320,33792,3444,-8498,-1537,3579,41123,37236,25294,32255,37371
20041,KS,7464,5216,4553,8320,6001,3699,5870,5216,4553.083228,4360,8320,33612,3444,-8498,-1537,3579,41123,37056,25114,32075,37191
20043,KS,8940,5216,4553,8320,6001,3699,6111,4901,4291.974513,4360,8129,34322,3907,-8035,-1132,4042,42840,38229,26287,33190,38364
20045,KS,9348,5216,4553,8320,6001,3699,6177,6281,5026.342775,4360,8246,36960,4833,-7109,-323,4968,43314,41793,29851,36637,41928
20047,KS,7464,5216,4553,8320,6001,3699,5870,5216,4536.763934,4360,8320,33596,3444,-8498,-1537,3579,41123,37040,25098,32059,37175
20049,KS,7464,5216,4553,8320,6001,3699,5870,5216,4765.23406,4360,8320,33824,3444,-8498,-1537,3579,41123,37268,25326,32287,37403
20051,KS,7536,5216,4553,8320,6001,3699,5882,5327,4748.914765,4360,8132,33803,3444,-8498,-1537,3579,41207,37247,25305,32266,37382
20053,KS,7464,5216,4553,8320,6001,3699,5870,5216,4291.974513,4360,8320,33351,3444,-8498,-1537,3579,41123,36795,24853,31814,36930
20055,KS,7908,5216,4553,8320,6001,3699,5942,5381,4259.335923,4360,8692,34299,3907,-8035,-1132,4042,41639,38206,26264,33167,38341
20057,KS,7860,5216,4553,8320,6001,3699,5935,5207,4520.444639,4360,8817,34464,3907,-8035,-1132,4042,41584,38371,26429,33332,38506
20059,KS,9408,5216,4553,8320,6001,3699,6187,5274,4667.318291,4360,8234,35643,4370,-7572,-728,4505,43384,40013,28071,34915,40148
20061,KS,9432,5216,4553,8320,6001,3699,6191,6173,4471.486755,4360,8452,36588,4833,-7109,-323,4968,43412,41421,29479,36265,41556
20063,KS,7464,5216,4553,8320,6001,3699,5870,5216,4814.191944,4360,8320,33873,3444,-8498,-1537,3579,41123,37317,25375,32336,37452
20065,KS,7464,5216,4553,8320,6001,3699,5870,5216,4748.914765,4360,8320,33808,3444,-8498,-1537,3579,41123,37252,25310,32271,37387
20067,KS,7464,5216,4553,8320,6001,3699,5870,5216,4308.293808,4360,8320,33367,3444,-8498,-1537,3579,41123,36811,24869,31830,36946
20069,KS,7464,5216,4553,8320,6001,3699,5870,5216,4340.932397,4360,8320,33400,3444,-8498,-1537,3579,41123,36844,24902,31863,36979
20071,KS,7464,5216,4553,8320,6001,3699,5870,5216,4830.511239,4360,8320,33890,3444,-8498,-1537,3579,41123,37334,25392,32353,37469
20073,KS,7464,5216,4553,8320,6001,3699,5870,5216,4471.486755,4360,8320,33530,3444,-8498,-1537,3579,41123,36974,25032,31993,37109
20075,KS,8148,5216,4553,8320,6001,3699,5982,5216,4357.251692,4360,8320,34100,3907,-8035,-1132,4042,41919,38007,26065,32968,38142
20077,KS,7464,5216,4553,8320,6001,3699,5870,5216,4487.80605,4360,8320,33547,3444,-8498,-1537,3579,41123,36991,25049,32010,37126
20079,KS,8880,5216,4553,8320,6001,3699,6101,4938,4732.59547,4360,8281,34891,3907,-8035,-1132,4042,42770,38798,26856,33759,38933
20081,KS,7836,5216,4553,8320,6001,3699,5931,5216,4324.613102,4360,8320,33756,3444,-8498,-1537,3579,41556,37200,25258,32219,37335
20083,KS,7464,5216,4553,8320,6001,3699,5870,5216,4340.932397,4360,8320,33400,3444,-8498,-1537,3579,41123,36844,24902,31863,36979
20085,KS,8556,5216,4553,8320,6001,3699,6048,5043,4520.444639,4360,8139,34318,3907,-8035,-1132,4042,42393,38225,26283,33186,38360
20087,KS,8556,5216,4553,8320,6001,3699,6048,5297,4683.637586,4360,8142,34737,3907,-8035,-1132,4042,42393,38644,26702,33605,38779
20089,KS,7464,5216,4553,8320,6001,3699,5870,5216,4520.444639,4360,8320,33579,3444,-8498,-1537,3579,41123,37023,25081,32042,37158
20091,KS,10224,5216,4553,8320,6001,3699,6320,6698,4748.914765,4360,8402,38133,5296,-6646,81,5431,44333,43429,31487,38214,43564
20093,KS,7464,5216,4553,8320,6001,3699,5870,5081,4226.697334,4360,8647,33477,3444,-8498,-1537,3579,41123,36921,24979,31940,37056
20095,KS,7464,5216,4553,8320,6001,3699,5870,4797,4487.80605,4360,8285,33093,3444,-8498,-1537,3579,41123,36537,24595,31556,36672
20097,KS,7464,5216,4553,8320,6001,3699,5870,5216,4536.763934,4360,8320,33596,3444,-8498,-1537,3579,41123,37040,25098,32059,37175
20099,KS,7464,5216,4553,8320,6001,3699,5870,4442,4765.23406,4360,7841,32570,2981,-8961,-1941,3116,41123,35551,23609,30629,35686
20101,KS,8052,5216,4553,8320,6001,3699,5966,5216,4259.335923,4360,8320,33906,3907,-8035,-1132,4042,41807,37813,25871,32774,37948
20103,KS,10224,5216,4553,8320,6001,3699,6320,5881,4438.848165,4360,8405,37007,5296,-6646,81,5431,44333,42303,30361,37088,42438
20105,KS,7464,5216,4553,8320,6001,3699,5870,5216,4194.058744,4360,8320,33253,3444,-8498,-1537,3579,41123,36697,24755,31716,36832
20107,KS,10224,5216,4553,8320,6001,3699,6320,5084,4569.402523,4360,8397,36334,4833,-7109,-323,4968,44333,41167,29225,36011,41302
20109,KS,7464,5216,4553,8320,6001,3699,5870,5216,4716.276176,4360,8320,33775,3444,-8498,-1537,3579,41123,37219,25277,32238,37354
20111,KS,7596,5216,4553,8320,6001,3699,5891,5022,4047.185092,4360,7715,32439,2981,-8961,-1941,3116,41276,35420,23478,30498,35555
20113,KS,7896,5216,4553,8320,6001,3699,5940,4977,4797.872649,4360,8321,34051,3444,-8498,-1537,3579,41625,37495,25553,32514,37630
20115,KS,7464,5216,4553,8320,6001,3699,5870,5216,4471.486755,4360,8320,33530,3444,-8498,-1537,3579,41123,36974,25032,31993,37109
20117,KS,7464,5216,4553,8320,6001,3699,5870,5216,4667.318291,4360,8320,33726,3444,-8498,-1537,3579,41123,37170,25228,32189,37305
20119,KS,7464,5216,4553,8320,6001,3699,5870,5216,4373.570986,4360,8320,33433,3444,-8498,-1537,3579,41123,36877,24935,31896,37012
20121,KS,10224,5216,4553,8320,6001,3699,6320,5806,5058.981365,4360,8400,37548,5296,-6646,81,5431,44333,42844,30902,37629,42979
20123,KS,7464,5216,4553,8320,6001,3699,5870,5216,4504.125344,4360,8320,33563,3444,-8498,-1537,3579,41123,37007,25065,32026,37142
20125,KS,7464,5216,4553,8320,6001,3699,5870,4565,4765.23406,4360,7524,32378,2981,-8961,-1941,3116,41123,35359,23417,30437,35494
20127,KS,7464,5216,4553,8320,6001,3699,5870,5216,4487.80605,4360,8320,33547,3444,-8498,-1537,3579,41123,36991,25049,32010,37126
20129,KS,7464,5216,4553,8320,6001,3699,5870,5216,4520.444639,4360,8320,33579,3444,-8498,-1537,3579,41123,37023,25081,32042,37158
20131,KS,7464,5216,4553,8320,6001,3699,5870,5216,4275.655218,4360,8320,33335,3444,-8498,-1537,3579,41123,36779,24837,31798,36914
20133,KS,7464,5216,4553,8320,6001,3699,5870,5216,4438.848165,4360,8320,33498,3444,-8498,-1537,3579,41123,36942,25000,31961,37077
20135,KS,7464,5216,4553,8320,6001,3699,5870,5216,4422.528871,4360,8320,33482,3444,-8498,-1537,3579,41123,36926,24984,31945,37061
20137,KS,7464,5216,4553,8320,6001,3699,5870,5216,4716.276176,4360,8320,33775,3444,-8498,-1537,3579,41123,37219,25277,32238,37354
20139,KS,8556,5216,4553,8320,6001,3699,6048,5016,4504.125344,4360,8135,34270,3907,-8035,-1132,4042,42393,38177,26235,33138,38312
20141,KS,7464,5216,4553,8320,6001,3699,5870,5216,4748.914765,4360,8320,33808,3444,-8498,-1537,3579,41123,37252,25310,32271,37387
20143,KS,7464,5216,4553,8320,6001,3699,5870,4809,4226.697334,4360,8219,32778,3444,-8498,-1537,3579,41123,36222,24280,31241,36357
20145,KS,7740,5216,4553,8320,6001,3699,5915,5216,4634.679702,4360,8320,33970,3444,-8498,-1537,3579,41444,37414,25472,32433,37549
20147,KS,7464,5216,4553,8320,6001,3699,5870,5216,4814.191944,4360,8320,33873,3444,-8498,-1537,3579,41123,37317,25375,32336,37452
20149,KS,9432,5216,4553,8320,6001,3699,6191,5214,4030.865797,4360,8233,34969,4370,-7572,-728,4505,43412,39339,27397,34241,39474
20151,KS,7752,5216,4553,8320,6001,3699,5917,5216,4340.932397,4360,8320,33688,3444,-8498,-1537,3579,41458,37132,25190,32151,37267
20153,KS,7464,5216,4553,8320,6001,3699,5870,5216,4732.59547,4360,8320,33792,3444,-8498,-1537,3579,41123,37236,25294,32255,37371
20155,KS,8016,5216,4553,8320,6001,3699,5960,4819,4243.016629,4360,7872,33009,3444,-8498,-1537,3579,41765,36453,24511,31472,36588
20157,KS,7464,5216,4553,8320,6001,3699,5870,5216,4602.041113,4360,8320,33661,3444,-8498,-1537,3579,41123,37105,25163,32124,37240
20159,KS,7464,5216,4553,8320,6001,3699,5870,5216,4357.251692,4360,8320,33416,3444,-8498,-1537,3579,41123,36860,24918,31879,36995
20161,KS,9432,5216,4553,8320,6001,3699,6191,6236,5205.855017,4360,8216,37149,4833,-7109,-323,4968,43412,41982,30040,36826,42117
20163,KS,7464,5216,4553,8320,6001,3699,5870,5216,4683.637586,4360,8320,33743,3444,-8498,-1537,3579,41123,37187,25245,32206,37322
20165,KS,7464,5216,4553,8320,6001,3699,5870,5216,4602.041113,4360,8320,33661,3444,-8498,-1537,3579,41123,37105,25163,32124,37240
20167,KS,8244,5216,4553,8320,6001,3699,5997,5216,4683.637586,4360,8320,34523,3907,-8035,-1132,4042,42030,38430,26488,33391,38565
20169,KS,8100,5216,4553,8320,6001,3699,5974,5162,4194.058744,4360,8214,33729,3907,-8035,-1132,4042,41863,37636,25694,32597,37771
20171,KS,7464,5216,4553,8320,6001,3699,5870,5216,4308.293808,4360,8320,33367,3444,-8498,-1537,3579,41123,36811,24869,31830,36946
20173,KS,8880,5216,4553,8320,6001,3699,6101,5386,4504.125344,4360,8285,35113,4370,-7572,-728,4505,42770,39483,27541,34385,39618
20175,KS,8700,5216,4553,8320,6001,3699,6072,5324,4553.083228,4360,8707,35343,4370,-7572,-728,4505,42561,39713,27771,34615,39848
20177,KS,8556,5216,4553,8320,6001,3699,6048,5342,4373.570986,4360,8099,34430,3907,-8035,-1132,4042,42393,38337,26395,33298,38472
20179,KS,7464,5216,4553,8320,6001,3699,5870,5216,4765.23406,4360,8320,33824,3444,-8498,-1537,3579,41123,37268,25326,32287,37403
20181,KS,7464,5216,4553,8320,6001,3699,5870,5216,4928.427007,4360,8320,33987,3444,-8498,-1537,3579,41123,37431,25489,32450,37566
20183,KS,7464,5216,4553,8320,6001,3699,5870,5216,4634.679702,4360,8320,33694,3444,-8498,-1537,3579,41123,37138,25196,32157,37273
20185,KS,7464,5216,4553,8320,6001,3699,5870,5216,4373.570986,4360,8320,33433,3444,-8498,-1537,3579,41123,36877,24935,31896,37012
20187,KS,7464,5216,4553,8320,6001,3699,5870,5216,4373.570986,4360,8320,33433,3444,-8498,-1537,3579,41123,36877,24935,31896,37012
20189,KS,9552,5216,4553,8320,6001,3699,6211,5216,4520.444639,4360,8320,35667,4370,-7572,-728,4505,43552,40037,28095,34939,40172
20191,KS,8040,5216,4553,8320,6001,3699,5964,4824,4634.679702,4360,8283,33840,3444,-8498,-1537,3579,41793,37284,25342,32303,37419
20193,KS,7464,5216,4553,8320,6001,3699,5870,5216,4699.956881,4360,8320,33759,3444,-8498,-1537,3579,41123,37203,25261,32222,37338
20195,KS,7848,5216,4553,8320,6001,3699,5933,5216,4765.23406,4360,8320,34208,3444,-8498,-1537,3579,41570,37652,25710,32671,37787
20197,KS,8556,5216,4553,8320,6001,3699,6048,4795,4438.848165,4360,8145,33994,3907,-8035,-1132,4042,42393,37901,25959,32862,38036
20199,KS,7464,5216,4553,8320,6001,3699,5870,5216,4814.191944,4360,8320,33873,3444,-8498,-1537,3579,41123,37317,25375,32336,37452
20201,KS,7464,5216,4553,8320,6001,3699,5870,5216,4944.746302,4360,8320,34004,3444,-8498,-1537,3579,41123,37448,25506,32467,37583
20203,KS,8256,5216,4553,8320,6001,3699,5999,5216,4308.293808,4360,8320,34159,3907,-8035,-1132,4042,42044,38066,26124,33027,38201
20205,KS,7464,5216,4553,8320,6001,3699,5870,5216,4667.318291,4360,8320,33726,3444,-8498,-1537,3579,41123,37170,25228,32189,37305
20207,KS,7464,5216,4553,8320,6001,3699,5870,5216,4210.378039,4360,8320,33269,3444,-8498,-1537,3579,41123,36713,24771,31732,36848
20209,KS,10224,5216,4553,8320,6001,3699,6320,5313,4340.932397,4360,8402,36338,4833,-7109,-323,4968,44333,41171,29229,36015,41306
21001,KY,6780,16670,4457,8554,5728,3916,4772,16670,4073.676616,4360,8554,44354,8559,-3496,3755,8581,50877,52913,40858,48109,52935
21003,KY,6780,16670,4457,8554,5728,3916,4772,15856,4409.155866,4360,8186,43507,8274,-3781,3338,8296,50877,51781,39726,46845,51803
21005,KY,8052,16670,4457,8554,5728,3916,4956,16212,4153.552628,4360,8196,44890,8843,-3212,4171,8865,52333,53733,41678,49061,53755
21007,KY,6780,16670,4457,8554,5728,3916,4772,15507,3945.874996,4360,8094,42603,8274,-3781,3338,8296,50877,50877,38822,45941,50899
21009,KY,6780,16670,4457,8554,5728,3916,4772,16018,4201.478235,4360,7714,42990,8274,-3781,3338,8296,50877,51264,39209,46328,51286
21011,KY,6780,16670,4457,8554,5728,3916,4772,17222,4217.453437,4360,7573,44068,8559,-3496,3755,8581,50877,52627,40572,47823,52649
21013,KY,6780,16670,4457,8554,5728,3916,4772,16266,4153.552628,4360,6960,42436,7990,-4065,2922,8012,50877,50426,38371,45358,50448
21015,KY,8820,16670,4457,8554,5728,3916,5068,19189,4313.304652,4360,8571,49169,9981,-2074,5837,10003,53213,59150,47095,55006,59172
21017,KY,8604,16670,4457,8554,5728,3916,5036,15990,4265.379045,4360,8390,45526,8843,-3212,4171,8865,52965,54369,42314,49697,54391
21019,KY,7716,16670,4457,8554,5728,3916,4907,15723,3945.874996,4360,7979,43641,8559,-3496,3755,8581,51948,52200,40145,47396,52222
21021,KY,7680,16670,4457,8554,5728,3916,4902,16012,3802.098175,4360,7522,43293,8274,-3781,3338,8296,51907,51567,39512,46631,51589
21023,KY,8820,16670,4457,8554,5728,3916,5068,16853,4233.42864,4360,8574,46756,9128,-2927,4588,9150,53213,55884,43829,51344,55906
21025,KY,6780,16670,4457,8554,5728,3916,4772,16670,4249.403842,4360,8554,44529,8559,-3496,3755,8581,50877,53088,41033,48284,53110
21027,KY,6780,16670,4457,8554,5728,3916,4772,16670,4361.230259,4360,8554,44641,8559,-3496,3755,8581,50877,53200,41145,48396,53222
21029,KY,8460,16670,4457,8554,5728,3916,5015,16772,4393.180664,4360,8406,46308,9128,-2927,4588,9150,52800,55436,43381,50896,55458
21031,KY,6780,16670,4457,8554,5728,3916,4772,16013,4089.651818,4360,8192,43351,8274,-3781,3338,8296,50877,51625,39570,46689,51647
21033,KY,6780,16670,4457,8554,5728,3916,4772,16670,4137.577425,4360,8554,44418,8559,-3496,3755,8581,50877,52977,40922,48173,52999
21035,KY,7632,16670,4457,8554,5728,3916,4895,17205,4361.230259,4360,7676,45150,8843,-3212,4171,8865,51852,53993,41938,49321,54015
21037,KY,8820,16670,4457,8554,5728,3916,5068,18490,4616.833498,4360,8572,48774,9697,-2358,5421,9719,53213,58471,46416,54195,58493
21039,KY,7284,16670,4457,8554,5728,3916,4845,16670,3993.800604,4360,8554,44778,8843,-3212,4171,8865,51454,53621,41566,48949,53643
21041,KY,7752,16670,4457,8554,5728,3916,4913,16670,3786.122972,4360,8554,45038,8843,-3212,4171,8865,51990,53881,41826,49209,53903
21043,KY,6780,16670,4457,8554,5728,3916,4772,16670,4824.511129,4360,8554,45105,8559,-3496,3755,8581,50877,53664,41609,48860,53686
21045,KY,6780,16670,4457,8554,5728,3916,4772,16670,3913.924591,4360,8554,44194,8559,-3496,3755,8581,50877,52753,40698,47949,52775
21047,KY,9204,16670,4457,8554,5728,3916,5124,16951,4009.775806,4360,8409,46849,9412,-2643,5004,9434,53653,56261,44206,51853,56283
21049,KY,8604,16670,4457,8554,5728,3916,5036,17396,4265.379045,4360,8381,46923,9412,-2643,5004,9434,52965,56335,44280,51927,56357
21051,KY,6780,16670,4457,8554,5728,3916,4772,16670,4249.403842,4360,8554,44529,8559,-3496,3755,8581,50877,53088,41033,48284,53110
21053,KY,6780,16670,4457,8554,5728,3916,4772,16670,4073.676616,4360,8554,44354,8559,-3496,3755,8581,50877,52913,40858,48109,52935
21055,KY,6780,16670,4457,8554,5728,3916,4772,16670,4297.329449,4360,8554,44577,8559,-3496,3755,8581,50877,53136,41081,48332,53158
21057,KY,6780,16670,4457,8554,5728,3916,4772,16670,4153.552628,4360,8554,44434,8559,-3496,3755,8581,50877,52993,40938,48189,53015
21059,KY,7512,16670,4457,8554,5728,3916,4878,15857,4153.552628,4360,8267,44066,8559,-3496,3755,8581,51715,52625,40570,47821,52647
21061,KY,7932,16670,4457,8554,5728,3916,4939,16791,4089.651818,4360,8189,45278,8843,-3212,4171,8865,52196,54121,42066,49449,54143
21063,KY,6780,16670,4457,8554,5728,3916,4772,16670,4201.478235,4360,8554,44481,8559,-3496,3755,8581,50877,53040,40985,48236,53062
21065,KY,6780,16670,4457,8554,5728,3916,4772,16670,4233.42864,4360,8554,44513,8559,-3496,3755,8581,50877,53072,41017,48268,53094
21067,KY,8604,16670,4457,8554,5728,3916,5036,18742,4249.403842,4360,8370,48242,9697,-2358,5421,9719,52965,57939,45884,53663,57961
21069,KY,6780,16670,4457,8554,5728,3916,4772,16670,4153.552628,4360,8554,44434,8559,-3496,3755,8581,50877,52993,40938,48189,53015
21071,KY,6780,16670,4457,8554,5728,3916,4772,16670,4505.007081,4360,8554,44785,8559,-3496,3755,8581,50877,53344,41289,48540,53366
21073,KY,7980,16670,4457,8554,5728,3916,4946,17390,4377.205461,4360,8165,46189,9128,-2927,4588,9150,52251,55317,43262,50777,55339
21075,KY,6780,16670,4457,8554,5728,3916,4772,14889,4025.751008,4360,7605,41577,7990,-4065,2922,8012,50877,49567,37512,44499,49589
21077,KY,8820,16670,4457,8554,5728,3916,5068,19064,4281.354247,4360,8573,49015,9981,-2074,5837,10003,53213,58996,46941,54852,59018
21079,KY,6864,16670,4457,8554,5728,3916,4784,16670,4105.62702,4360,8554,44470,8559,-3496,3755,8581,50973,53029,40974,48225,53051
21081,KY,8232,16670,4457,8554,5728,3916,4982,18380,4121.602223,4360,8573,47583,9412,-2643,5004,9434,52539,56995,44940,52587,57017
21083,KY,6912,16670,4457,8554,5728,3916,4791,15371,4153.552628,4360,7725,42438,7990,-4065,2922,8012,51028,50428,38373,45360,50450
21085,KY,6780,16670,4457,8554,5728,3916,4772,16670,3945.874996,4360,8554,44226,8559,-3496,3755,8581,50877,52785,40730,47981,52807
21087,KY,6780,16670,4457,8554,5728,3916,4772,16670,4057.701413,4360,8554,44338,8559,-3496,3755,8581,50877,52897,40842,48093,52919
21089,KY,7716,16670,4457,8554,5728,3916,4907,15843,4584.883093,4360,7964,44384,8559,-3496,3755,8581,51948,52943,40888,48139,52965
21091,KY,7512,16670,4457,8554,5728,3916,4878,16668,4217.453437,4360,8272,44946,8843,-3212,4171,8865,51715,53789,41734,49117,53811
21093,KY,7020,16670,4457,8554,5728,3916,4806,17421,3977.825401,4360,8411,45105,8843,-3212,4171,8865,51151,53948,41893,49276,53970
21095,KY,6780,16670,4457,8554,5728,3916,4772,16670,4233.42864,4360,8554,44513,8559,-3496,3755,8581,50877,53072,41017,48268,53094
21097,KY,7188,16670,4457,8554,5728,3916,4831,16670,4265.379045,4360,8554,44953,8843,-3212,4171,8865,51344,53796,41741,49124,53818
21099,KY,6780,16670,4457,8554,5728,3916,4772,16670,3993.800604,4360,8554,44274,8559,-3496,3755,8581,50877,52833,40778,48029,52855
21101,KY,8868,16670,4457,8554,5728,3916,5075,16464,4329.279854,4360,8330,46268,9128,-2927,4588,9150,53268,55396,43341,50856,55418
21103,KY,8460,16670,4457,8554,5728,3916,5015,16221,4153.552628,4360,8408,45518,8843,-3212,4171,8865,52800,54361,42306,49689,54383
21105,KY,6780,16670,4457,8554,5728,3916,4772,16670,4249.403842,4360,8554,44529,8559,-3496,3755,8581,50877,53088,41033,48284,53110
21107,KY,6780,16670,4457,8554,5728,3916,4772,15753,4345.255057,4360,8061,43215,8274,-3781,3338,8296,50877,51489,39434,46553,51511
21109,KY,7584,16670,4457,8554,5728,3916,4888,16670,4057.701413,4360,8554,45142,8843,-3212,4171,8865,51797,53985,41930,49313,54007
21111,KY,8460,16670,4457,8554,5728,3916,5015,18181,4297.329449,4360,8381,47595,9412,-2643,5004,9434,52800,57007,44952,52599,57029
21113,KY,8604,16670,4457,8554,5728,3916,5036,18331,4249.403842,4360,8385,47845,9697,-2358,5421,9719,52965,57542,45487,53266,57564
21115,KY,6780,16670,4457,8554,5728,3916,4772,16670,4249.403842,4360,8554,44529,8559,-3496,3755,8581,50877,53088,41033,48284,53110
21117,KY,8820,16670,4457,8554,5728,3916,5068,18147,4249.403842,4360,8573,48065,9697,-2358,5421,9719,53213,57762,45707,53486,57784
21119,KY,6780,16670,4457,8554,5728,3916,4772,16670,4281.354247,4360,8554,44561,8559,-3496,3755,8581,50877,53120,41065,48316,53142
21121,KY,6780,16670,4457,8554,5728,3916,4772,17490,4105.62702,4360,7338,43989,8559,-3496,3755,8581,50877,52548,40493,47744,52570
21123,KY,7020,16670,4457,8554,5728,3916,4806,15754,4009.775806,4360,8422,43482,8274,-3781,3338,8296,51151,51756,39701,46820,51778
21125,KY,7008,16670,4457,8554,5728,3916,4805,17170,3865.998984,4360,7342,43662,8559,-3496,3755,8581,51138,52221,40166,47417,52243
21127,KY,6780,16670,4457,8554,5728,3916,4772,16670,4105.62702,4360,8554,44386,8559,-3496,3755,8581,50877,52945,40890,48141,52967
21129,KY,6780,16670,4457,8554,5728,3916,4772,16670,4009.775806,4360,8554,44290,8559,-3496,3755,8581,50877,52849,40794,48045,52871
21131,KY,6912,16670,4457,8554,5728,3916,4791,16670,4185.503032,4360,8554,44598,8559,-3496,3755,8581,51028,53157,41102,48353,53179
21133,KY,6780,16670,4457,8554,5728,3916,4772,16670,4217.453437,4360,8554,44497,8559,-3496,3755,8581,50877,53056,41001,48252,53078
21135,KY,6780,16670,4457,8554,5728,3916,4772,16670,4041.726211,4360,8554,44322,8559,-3496,3755,8581,50877,52881,40826,48077,52903
21137,KY,6780,16670,4457,8554,5728,3916,4772,16045,3993.800604,4360,7568,42663,8274,-3781,3338,8296,50877,50937,38882,46001,50959
21139,KY,6780,16670,4457,8554,5728,3916,4772,15476,4009.775806,4360,8088,42630,8274,-3781,3338,8296,50877,50904,38849,45968,50926
21141,KY,7332,16670,4457,8554,5728,3916,4852,16670,4025.751008,4360,8554,44858,8843,-3212,4171,8865,51509,53701,41646,49029,53723
21143,KY,6780,16670,4457,8554,5728,3916,4772,16670,4329.279854,4360,8554,44609,8559,-3496,3755,8581,50877,53168,41113,48364,53190
21145,KY,7380,16670,4457,8554,5728,3916,4859,16523,3929.899794,4360,8029,44138,8559,-3496,3755,8581,51564,52697,40642,47893,52719
21147,KY,6780,16670,4457,8554,5728,3916,4772,16670,3977.825401,4360,8554,44258,8559,-3496,3755,8581,50877,52817,40762,48013,52839
21149,KY,7512,16670,4457,8554,5728,3916,4878,15474,4185.503032,4360,8277,43724,8274,-3781,3338,8296,51715,51998,39943,47062,52020
21151,KY,7248,16670,4457,8554,5728,3916,4839,17769,4249.403842,4360,8101,45644,8843,-3212,4171,8865,51412,54487,42432,49815,54509
21153,KY,6780,16670,4457,8554,5728,3916,4772,16670,4265.379045,4360,8554,44545,8559,-3496,3755,8581,50877,53104,41049,48300,53126
21155,KY,7092,16670,4457,8554,5728,3916,4817,16670,3977.825401,4360,8554,44570,8843,-3212,4171,8865,51234,53413,41358,48741,53435
21157,KY,7476,16670,4457,8554,5728,3916,4873,16670,4329.279854,4360,8554,45305,8843,-3212,4171,8865,51674,54148,42093,49476,54170
21159,KY,6780,16670,4457,8554,5728,3916,4772,16670,4233.42864,4360,8554,44513,8559,-3496,3755,8581,50877,53072,41017,48268,53094
21161,KY,6912,16670,4457,8554,5728,3916,4791,16181,4105.62702,4360,8182,43657,8559,-3496,3755,8581,51028,52216,40161,47412,52238
21163,KY,7632,16670,4457,8554,5728,3916,4895,17782,4153.552628,4360,8418,46262,9128,-2927,4588,9150,51852,55390,43335,50850,55412
21165,KY,6780,16670,4457,8554,5728,3916,4772,15537,4185.503032,4360,7593,42372,7990,-4065,2922,8012,50877,50362,38307,45294,50384
21167,KY,7152,16670,4457,8554,5728,3916,4826,16670,4121.602223,4360,8554,44774,8843,-3212,4171,8865,51303,53617,41562,48945,53639
21169,KY,7248,16670,4457,8554,5728,3916,4839,15112,4121.602223,4360,7750,42507,7990,-4065,2922,8012,51412,50497,38442,45429,50519
21171,KY,6780,16670,4457,8554,5728,3916,4772,16670,4217.453437,4360,8554,44497,8559,-3496,3755,8581,50877,53056,41001,48252,53078
21173,KY,6948,16670,4457,8554,5728,3916,4796,16898,4169.52783,4360,7532,43823,8559,-3496,3755,8581,51069,52382,40327,47578,52404
21175,KY,6780,16670,4457,8554,5728,3916,4772,16670,4169.52783,4360,8554,44450,8559,-3496,3755,8581,50877,53009,40954,48205,53031
21177,KY,6780,16670,4457,8554,5728,3916,4772,16670,4137.577425,4360,8554,44418,8559,-3496,3755,8581,50877,52977,40922,48173,52999
21179,KY,7344,16670,4457,8554,5728,3916,4853,16022,4297.329449,4360,8294,44233,8559,-3496,3755,8581,51522,52792,40737,47988,52814
21181,KY,6780,16670,4457,8554,5728,3916,4772,16670,4185.503032,4360,8554,44466,8559,-3496,3755,8581,50877,53025,40970,48221,53047
21183,KY,6780,16670,4457,8554,5728,3916,4772,16670,4041.726211,4360,8554,44322,8559,-3496,3755,8581,50877,52881,40826,48077,52903
21185,KY,8460,16670,4457,8554,5728,3916,5015,19187,4425.131069,4360,8412,48760,9697,-2358,5421,9719,52800,58457,46402,54181,58479
21187,KY,7296,16670,4457,8554,5728,3916,4846,16670,4329.279854,4360,8554,45125,8843,-3212,4171,8865,51467,53968,41913,49296,53990
21189,KY,6780,16670,4457,8554,5728,3916,4772,16670,4233.42864,4360,8554,44513,8559,-3496,3755,8581,50877,53072,41017,48268,53094
21191,KY,8820,16670,4457,8554,5728,3916,5068,16934,4329.279854,4360,8573,46932,9412,-2643,5004,9434,53213,56344,44289,51936,56366
21193,KY,6780,16670,4457,8554,5728,3916,4772,16670,4313.304652,4360,8554,44593,8559,-3496,3755,8581,50877,53152,41097,48348,53174
21195,KY,8520,16670,4457,8554,5728,3916,5024,16670,4265.379045,4360,8554,46285,9128,-2927,4588,9150,52869,55413,43358,50873,55435
21197,KY,6780,16670,4457,8554,5728,3916,4772,16670,4201.478235,4360,8554,44481,8559,-3496,3755,8581,50877,53040,40985,48236,53062
21199,KY,6912,16670,4457,8554,5728,3916,4791,16369,3834.048579,4360,7467,42857,8274,-3781,3338,8296,51028,51131,39076,46195,51153
21201,KY,8940,16670,4457,8554,5728,3916,5085,16670,4105.62702,4360,8554,46546,9128,-2927,4588,9150,53350,55674,43619,51134,55696
21203,KY,6780,16670,4457,8554,5728,3916,4772,16051,3945.874996,4360,8141,43195,8274,-3781,3338,8296,50877,51469,39414,46533,51491
21205,KY,6888,16670,4457,8554,5728,3916,4787,16670,4233.42864,4360,8554,44621,8559,-3496,3755,8581,51000,53180,41125,48376,53202
21207,KY,6780,16670,4457,8554,5728,3916,4772,16670,3929.899794,4360,8554,44210,8559,-3496,3755,8581,50877,52769,40714,47965,52791
21209,KY,8604,16670,4457,8554,5728,3916,5036,17431,4441.106271,4360,8384,47136,9412,-2643,5004,9434,52965,56548,44493,52140,56570
21211,KY,8280,16670,4457,8554,5728,3916,4989,17599,4297.329449,4360,8401,46853,9412,-2643,5004,9434,52594,56265,44210,51857,56287
21213,KY,7500,16670,4457,8554,5728,3916,4876,16670,4217.453437,4360,8554,45217,8843,-3212,4171,8865,51701,54060,42005,49388,54082
21215,KY,8460,16670,4457,8554,5728,3916,5015,16806,4297.329449,4360,8409,46248,9128,-2927,4588,9150,52800,55376,43321,50836,55398
21217,KY,7272,16670,4457,8554,5728,3916,4843,15113,4009.775806,4360,7558,42228,7990,-4065,2922,8012,51440,50218,38163,45150,50240
21219,KY,7008,16670,4457,8554,5728,3916,4805,16670,4105.62702,4360,8554,44614,8559,-3496,3755,8581,51138,53173,41118,48369,53195
21221,KY,9204,16670,4457,8554,5728,3916,5124,16108,4185.503032,4360,8416,46190,9128,-2927,4588,9150,53653,55318,43263,50778,55340
21223,KY,8460,16670,4457,8554,5728,3916,5015,16820,3993.800604,4360,8406,45956,9128,-2927,4588,9150,52800,55084,43029,50544,55106
21225,KY,6780,16670,4457,8554,5728,3916,4772,16670,4121.602223,4360,8554,44402,8559,-3496,3755,8581,50877,52961,40906,48157,52983
21227,KY,7932,16670,4457,8554,5728,3916,4939,17141,4089.651818,4360,8144,45583,8843,-3212,4171,8865,52196,54426,42371,49754,54448
21229,KY,6780,16670,4457,8554,5728,3916,4772,16670,4009.775806,4360,8554,44290,8559,-3496,3755,8581,50877,52849,40794,48045,52871
21231,KY,6780,16670,4457,8554,5728,3916,4772,16670,4025.751008,4360,8554,44306,8559,-3496,3755,8581,50877,52865,40810,48061,52887
21233,KY,8868,16670,4457,8554,5728,3916,5075,16670,4313.304652,4360,8554,46681,9128,-2927,4588,9150,53268,55809,43754,51269,55831
21235,KY,7164,16670,4457,8554,5728,3916,4827,16645,4233.42864,4360,7354,43673,8274,-3781,3338,8296,51316,51947,39892,47011,51969
21237,KY,7596,16670,4457,8554,5728,3916,4890,16670,4041.726211,4360,8554,45138,8843,-3212,4171,8865,51811,53981,41926,49309,54003
21239,KY,8604,16670,4457,8554,5728,3916,5036,16641,4680.734307,4360,8392,46594,9128,-2927,4588,9150,52965,55722,43667,51182,55744
22001,LA,7644,9153,4457,8554,6451,3916,5553,8235,4520.982283,6100,8452,38868,5823,-6239,430,5838,45728,44691,32629,39298,44706
22003,LA,7644,9153,4457,8554,6451,3916,5553,9153,4281.354247,6100,8554,39648,6280,-5782,828,6295,45728,45928,33866,40476,45943
22005,LA,9588,9153,4457,8554,6451,3916,5854,10147,4760.610319,6100,8609,43121,7099,-4963,2024,7114,47973,50220,38158,45145,50235
22007,LA,7872,9153,4457,8554,6451,3916,5588,9153,4632.8087,6100,8554,40228,6566,-5496,1227,6581,45991,46794,34732,41455,46809
22009,LA,7980,9153,4457,8554,6451,3916,5605,9153,4233.42864,6100,8554,39936,6566,-5496,1227,6581,46116,46502,34440,41163,46517
22011,LA,8064,9153,4457,8554,6451,3916,5618,9157,4281.354247,6100,8327,39846,6566,-5496,1227,6581,46213,46412,34350,41073,46427
22013,LA,7644,9153,4457,8554,6451,3916,5553,9153,4457.081474,6100,8554,39824,6280,-5782,828,6295,45728,46104,34042,40652,46119
22015,LA,9084,9153,4457,8554,6451,3916,5776,10166,4552.932688,6100,8270,42088,6832,-5230,1625,6847,47391,48920,36858,43713,48935
22017,LA,9084,9153,4457,8554,6451,3916,5776,9425,4473.056676,6100,8263,41261,6832,-5230,1625,6847,47391,48093,36031,42886,48108
22019,LA,8748,9153,4457,8554,6451,3916,5724,9223,4281.354247,6100,8289,40557,6566,-5496,1227,6581,47003,47123,35061,41784,47138
22021,LA,7644,9153,4457,8554,6451,3916,5553,9153,4265.379045,6100,8554,39632,6280,-5782,828,6295,45728,45912,33850,40460,45927
22023,LA,8748,9153,4457,8554,6451,3916,5724,9051,4105.62702,6100,8306,40227,6566,-5496,1227,6581,47003,46793,34731,41454,46808
22025,LA,7644,9153,4457,8554,6451,3916,5553,9153,4249.403842,6100,8554,39616,6280,-5782,828,6295,45728,45896,33834,40444,45911
22027,LA,7644,9153,4457,8554,6451,3916,5553,9153,4425.131069,6100,8554,39792,6280,-5782,828,6295,45728,46072,34010,40620,46087
22029,LA,7644,9153,4457,8554,6451,3916,5553,8182,4441.106271,6100,7158,37442,5366,-6696,31,5381,45728,42808,30746,37473,42823
22031,LA,9084,9153,4457,8554,6451,3916,5776,9537,4345.255057,6100,8275,41257,6832,-5230,1625,6847,47391,48089,36027,42882,48104
22033,LA,9588,9153,4457,8554,6451,3916,5854,10247,4648.783903,6100,8617,43117,7099,-4963,2024,7114,47973,50216,38154,45141,50231
22035,LA,7644,9153,4457,8554,6451,3916,5553,9153,4313.304652,6100,8554,39680,6280,-5782,828,6295,45728,45960,33898,40508,45975
22037,LA,9588,9153,4457,8554,6451,3916,5854,9166,4744.635117,6100,8604,42119,6832,-5230,1625,6847,47973,48951,36889,43744,48966
22039,LA,7644,9153,4457,8554,6451,3916,5553,9153,4297.329449,6100,8554,39664,6280,-5782,828,6295,45728,45944,33882,40492,45959
22041,LA,7644,9153,4457,8554,6451,3916,5553,9153,4105.62702,6100,8554,39473,6280,-5782,828,6295,45728,45753,33691,40301,45768
22043,LA,7872,9153,4457,8554,6451,3916,5588,9096,4536.957486,6100,8164,39685,6280,-5782,828,6295,45991,45965,33903,40513,45980
22045,LA,8484,9153,4457,8554,6451,3916,5683,9173,4313.304652,6100,8446,40433,6566,-5496,1227,6581,46698,46999,34937,41660,47014
22047,LA,7644,9153,4457,8554,6451,3916,5553,8701,4648.783903,6100,8607,39617,6280,-5782,828,6295,45728,45897,33835,40445,45912
22049,LA,7644,9153,4457,8554,6451,3916,5553,9153,4329.279854,6100,8554,39696,6280,-5782,828,6295,45728,45976,33914,40524,45991
22051,LA,11376,9153,4457,8554,6451,3916,6132,10729,4696.70951,6100,8367,45185,7632,-4430,2821,7647,50039,52817,40755,48006,52832
22053,LA,7644,9153,4457,8554,6451,3916,5553,9153,4393.180664,6100,8554,39760,6280,-5782,828,6295,45728,46040,33978,40588,46055
22055,LA,9492,9153,4457,8554,6451,3916,5839,10150,4760.610319,6100,8461,42880,7099,-4963,2024,7114,47862,49979,37917,44904,49994
22057,LA,9276,9153,4457,8554,6451,3916,5806,9367,4632.8087,6100,8608,41900,6832,-5230,1625,6847,47613,48732,36670,43525,48747
22059,LA,7644,9153,4457,8554,6451,3916,5553,9153,4137.577425,6100,8554,39505,6280,-5782,828,6295,45728,45785,33723,40333,45800
22061,LA,9108,9153,4457,8554,6451,3916,5780,9624,4520.982283,6100,7736,41005,6566,-5496,1227,6581,47419,47571,35509,42232,47586
22063,LA,9588,9153,4457,8554,6451,3916,5854,10112,4361.230259,6100,8608,42685,7099,-4963,2024,7114,47973,49784,37722,44709,49799
22065,LA,7908,9153,4457,8554,6451,3916,5594,9153,4281.354247,6100,8554,39912,6566,-5496,1227,6581,46033,46478,34416,41139,46493
22067,LA,8292,9153,4457,8554,6451,3916,5653,8034,4121.602223,6100,7307,37770,5823,-6239,430,5838,46476,43593,31531,38200,43608
22069,LA,8724,9153,4457,8554,6451,3916,5720,9442,4536.957486,6100,7619,40338,6566,-5496,1227,6581,46975,46904,34842,41565,46919
22071,LA,11376,9153,4457,8554,6451,3916,6132,12230,5144.015177,6100,8343,47110,8165,-3897,3618,8180,50039,55275,43213,50728,55290
22073,LA,8316,9153,4457,8554,6451,3916,5657,9143,4313.304652,6100,7779,39568,6280,-5782,828,6295,46504,45848,33786,40396,45863
22075,LA,11376,9153,4457,8554,6451,3916,6132,12277,4105.62702,6100,8382,46157,8165,-3897,3618,8180,50039,54322,42260,49775,54337
22077,LA,9588,9153,4457,8554,6451,3916,5854,9275,4680.734307,6100,8605,42165,6832,-5230,1625,6847,47973,48997,36935,43790,49012
22079,LA,7872,9153,4457,8554,6451,3916,5588,9218,4089.651818,6100,8129,39324,6280,-5782,828,6295,45991,45604,33542,40152,45619
22081,LA,7644,9153,4457,8554,6451,3916,5553,9153,4473.056676,6100,8554,39840,6280,-5782,828,6295,45728,46120,34058,40668,46135
22083,LA,7644,9153,4457,8554,6451,3916,5553,9153,4249.403842,6100,8554,39616,6280,-5782,828,6295,45728,45896,33834,40444,45911
22085,LA,7644,9153,4457,8554,6451,3916,5553,9153,4425.131069,6100,8554,39792,6280,-5782,828,6295,45728,46072,34010,40620,46087
22087,LA,11376,9153,4457,8554,6451,3916,6132,9133,4505.007081,6100,8383,43413,7365,-4697,2422,7380,50039,50778,38716,45835,50793
22089,LA,11376,9153,4457,8554,6451,3916,6132,10422,4920.362344,6100,8378,45112,7632,-4430,2821,7647,50039,52744,40682,47933,52759
22091,LA,9588,9153,4457,8554,6451,3916,5854,9289,4584.883093,6100,8604,42082,6832,-5230,1625,6847,47973,48914,36852,43707,48929
22093,LA,7644,9153,4457,8554,6451,3916,5553,9215,4904.387141,6100,8378,40157,6280,-5782,828,6295,45728,46437,34375,40985,46452
22095,LA,11376,9153,4457,8554,6451,3916,6132,9409,4632.8087,6100,8369,43803,7365,-4697,2422,7380,50039,51168,39106,46225,51183
22097,LA,7644,9153,4457,8554,6451,3916,5553,8432,4265.379045,6100,7655,38012,5823,-6239,430,5838,45728,43835,31773,38442,43850
22099,LA,9492,9153,4457,8554,6451,3916,5839,9009,4616.833498,6100,8458,41591,6832,-5230,1625,6847,47862,48423,36361,43216,48438
22101,LA,8352,9153,4457,8554,6451,3916,5663,9092,4552.932688,6100,8149,40162,6566,-5496,1227,6581,46546,46728,34666,41389,46743
22103,LA,11376,9153,4457,8554,6451,3916,6132,10717,4856.461534,6100,8372,45338,7632,-4430,2821,7647,50039,52970,40908,48159,52985
22105,LA,9864,9153,4457,8554,6451,3916,5897,9974,4648.783903,6100,8247,42750,7099,-4963,2024,7114,48292,49849,37787,44774,49864
22107,LA,7644,9153,4457,8554,6451,3916,5553,9153,4297.329449,6100,8554,39664,6280,-5782,828,6295,45728,45944,33882,40492,45959
22109,LA,9276,9153,4457,8554,6451,3916,5806,9597,4297.329449,6100,8613,41799,6832,-5230,1625,6847,47613,48631,36569,43424,48646
22111,LA,8316,9153,4457,8554,6451,3916,5657,8995,4361.230259,6100,7843,39531,6280,-5782,828,6295,46504,45811,33749,40359,45826
22113,LA,7884,9153,4457,8554,6451,3916,5590,8770,4361.230259,6100,8453,39485,6280,-5782,828,6295,46005,45765,33703,40313,45780
22115,LA,10980,9153,4457,8554,6451,3916,6070,10211,4185.503032,6100,8539,43931,7632,-4430,2821,7647,49581,51563,39501,46752,51578
22117,LA,7884,9153,4457,8554,6451,3916,5590,8493,4568.90789,6100,7330,38292,5823,-6239,430,5838,46005,44115,32053,38722,44130
22119,LA,7644,9153,4457,8554,6451,3916,5553,8698,4393.180664,6100,8257,39009,6280,-5782,828,6295,45728,45289,33227,39837,45304
22121,LA,9588,9153,4457,8554,6451,3916,5854,9696,4728.659915,6100,8611,42639,7099,-4963,2024,7114,47973,49738,37676,44663,49753
22123,LA,7644,9153,4457,8554,6451,3916,5553,9153,4201.478235,6100,8554,39568,6280,-5782,828,6295,45728,45848,33786,40396,45863
22125,LA,9588,9153,4457,8554,6451,3916,5854,10399,4552.932688,6100,8604,43160,7365,-4697,2422,7380,47973,50525,38463,45582,50540
22127,LA,7644,9153,4457,8554,6451,3916,5553,9153,4217.453437,6100,8554,39584,6280,-5782,828,6295,45728,45864,33802,40412,45879
23001,ME,9024,8693,5176,6855,6616,3644,7391,7383,5825.425483,5331,6544,37752,4490,-7587,-860,4490,47399,42242,30165,36892,42242
23003,ME,7644,8693,5176,6855,6616,3644,7123,8693,5472.931584,5331,6855,37640,4490,-7587,-860,4490,45751,42130,30053,36780,42130
23005,ME,11871,8693,5176,6855,6616,3644,7946,10550,6196.471692,5331,6833,44425,6369,-5708,1411,6369,50801,50794,38717,45836,50794
23007,ME,7956,8693,5176,6855,6616,3644,7183,8693,5918.187035,5331,6855,38397,4490,-7587,-860,4490,46123,42887,30810,37537,42887
23009,ME,9876,8693,5176,6855,6616,3644,7557,8693,6307.785555,5331,6855,40707,5364,-6713,-103,5364,48417,46071,33994,40604,46071
23011,ME,9264,8693,5176,6855,6616,3644,7438,10534,5751.216241,5331,6506,41030,5630,-6447,276,5630,47686,46660,34583,41306,46660
23013,ME,10608,8693,5176,6855,6616,3644,7700,8693,6623.174832,5331,6855,41754,5630,-6447,276,5630,49292,47384,35307,42030,47384
23015,ME,11016,8693,5176,6855,6616,3644,7779,8693,6882.907179,5331,6855,42422,5630,-6447,276,5630,49779,48052,35975,42698,48052
23017,ME,8364,8693,5176,6855,6616,3644,7263,8693,5695.55931,5331,6855,38583,4927,-7150,-481,4927,46611,43510,31433,38102,43510
23019,ME,9486,8693,5176,6855,6616,3644,7481,9282,5658.454689,5331,6517,39919,5364,-6713,-103,5364,47951,45283,33206,39816,45283
23021,ME,7800,8693,5176,6855,6616,3644,7153,8693,5973.843966,5331,6855,38297,4490,-7587,-860,4490,45937,42787,30710,37437,42787
23023,ME,10344,8693,5176,6855,6616,3644,7648,9829,6808.697937,5331,6840,42797,5876,-6201,654,5876,48976,48673,36596,43451,48673
23025,ME,8472,8693,5176,6855,6616,3644,7284,8693,5417.274653,5331,6855,38412,4927,-7150,-481,4927,46740,43339,31262,37931,43339
23027,ME,8832,8693,5176,6855,6616,3644,7354,8693,6474.756349,5331,6855,39830,4927,-7150,-481,4927,47170,44757,32680,39349,44757
23029,ME,7968,8693,5176,6855,6616,3644,7186,8693,5806.873172,5331,6855,38298,4490,-7587,-860,4490,46138,42788,30711,37438,42788
23031,ME,11168,8693,5176,6855,6616,3644,7809,8061,6177.919381,5331,6839,41220,5630,-6447,276,5630,49961,46850,34773,41496,46850
24001,MD,7644,14318,4457,8554,6356,3916,5649,12950,4680.734307,4720,7507,41418,3469,-4904,1951,7173,50894,44887,36514,43369,48591
24003,MD,15024,14318,4457,8554,6356,3916,6721,15970,4744.635117,4720,9234,53609,6484,-1890,6417,10187,59346,60093,51719,60026,63796
24005,MD,15024,14318,4457,8554,6356,3916,6721,15865,4632.8087,4720,9277,53435,6484,-1890,6417,10187,59346,59919,51545,59852,63622
24009,MD,17628,14318,4457,8554,6356,3916,7099,18284,5431.568821,4720,9679,59659,8128,323,8853,11831,62328,67787,59982,68512,71490
24011,MD,10692,14318,4457,8554,6356,3916,6092,14318,4520.982283,4720,8554,46721,4840,-3534,3981,8543,54385,51561,43187,50702,55264
24013,MD,15024,14318,4457,8554,6356,3916,6721,18455,5159.99038,4720,9224,56499,7032,-1342,7229,10735,59346,63531,55157,63728,67234
24015,MD,13620,14318,4457,8554,6356,3916,6517,16543,4425.131069,4720,9008,52232,6484,-1890,6417,10187,57738,58716,50342,58649,62419
24017,MD,17628,14318,4457,8554,6356,3916,7099,15277,4712.684712,4720,9724,55978,7032,-1342,7229,10735,62328,63010,54636,63207,66713
24019,MD,10164,14318,4457,8554,6356,3916,6015,15113,4361.230259,4720,8147,46421,4840,-3534,3981,8543,53780,51261,42887,50402,54964
24021,MD,17628,14318,4457,8554,6356,3916,7099,12626,4696.70951,4720,9770,53357,6484,-1890,6417,10187,62328,59841,51467,59774,63544
24023,MD,8292,14318,4457,8554,6356,3916,5743,14318,4377.205461,4720,8554,44177,4292,-4082,3169,7995,51636,48469,40095,47346,52172
24025,MD,15024,14318,4457,8554,6356,3916,6721,14294,4792.560724,4720,9219,51965,5936,-2438,5605,9639,59346,57901,49527,57570,61604
24027,MD,15024,14318,4457,8554,6356,3916,6721,13931,5319.742404,4720,9243,52154,5936,-2438,5605,9639,59346,58090,49716,57759,61793
24028,MD,18672,14318,4457,8554,6356,3916,7250,14318,4457,4720,8554,54637,7032,-1342,7229,10735,63523,61669,53295,61866,65372
24029,MD,11328,14318,4457,8554,6356,3916,6184,14318,5048.163963,4720,8554,47884,5113,-3260,4387,8817,55113,52997,44624,52271,56701
24031,MD,17628,14318,4457,8554,6356,3916,7099,13233,5399.618416,4720,9966,54862,6484,-1890,6417,10187,62328,61346,52972,61279,65049
24033,MD,17628,14318,4457,8554,6356,3916,7099,14270,4568.90789,4720,9936,55038,7032,-1342,7229,10735,62328,62070,53696,62267,65773
24035,MD,15024,14318,4457,8554,6356,3916,6721,15680,5830.948881,4720,9179,54350,6484,-1890,6417,10187,59346,60834,52460,60767,64537
24037,MD,14592,14318,4457,8554,6356,3916,6658,14544,4728.659915,4720,9672,52173,5936,-2438,5605,9639,58851,58109,49735,57778,61812
24039,MD,8352,14318,4457,8554,6356,3916,5752,13437,4297.329449,4720,8413,43136,4017,-4356,2763,7721,51705,47153,38780,45899,50857
24041,MD,12720,14318,4457,8554,6356,3916,6386,14876,5303.767201,4720,8658,50194,5661,-2712,5199,9365,56707,55855,47482,55393,59559
24043,MD,11616,14318,4457,8554,6356,3916,6226,15789,4425.131069,4720,8499,48965,5388,-2986,4793,9091,55443,54353,45979,53758,58056
24045,MD,10500,14318,4457,8554,6356,3916,6064,16445,4409.155866,4720,8404,48394,5388,-2986,4793,9091,54165,53782,45408,53187,57485
24047,MD,10656,14318,4457,8554,6356,3916,6086,13614,4984.263153,4720,8412,46302,4565,-3808,3575,8269,54343,50867,42494,49877,54571
24510,MD,15024,14318,4457,8554,6356,3916,6721,13921,4952.312748,4720,9411,51945,5936,-2438,5605,9639,59346,57881,49507,57550,61584
25001,MA,14112,5932,5176,6855,6416,3644,7746,6266,6641.727143,5223,6812,42699,7530,-4289,2566,7788,49881,50229,38410,45265,50487
25003,MA,9648,5932,5176,6855,6416,3644,7000,6604,6344.890175,5223,6481,37945,2653,-6269,517,5808,44671,40598,31676,38462,43753
25005,MA,11262,5932,5176,6855,6416,3644,7269,5759,5547.140826,5223,6858,38293,6018,-5801,926,6276,46554,44311,32492,39219,44569
25007,MA,15648,5932,5176,6855,6416,3644,8003,5864,5992.396277,5223,7420,43791,7809,-4010,2977,8067,51674,51600,39781,46768,51858
25009,MA,15798,5932,5176,6855,6416,3644,8028,6002,5788.320862,5223,7458,43913,8086,-3733,3386,8344,51849,51999,40180,47299,52257
25011,MA,11423,5932,5176,6855,6416,3644,7296,6312,5936.739345,5223,6718,39257,6487,-5332,1337,6745,46742,45744,33925,40594,46002
25013,MA,11412,5932,5176,6855,6416,3644,7295,5328,5305.96079,5223,6693,37606,6018,-5801,926,6276,46730,43624,31805,38532,43882
25015,MA,11412,5932,5176,6855,6416,3644,7295,7609,6103.71014,5223,6706,40698,6955,-4864,1746,7213,46730,47653,35834,42444,47911
25017,MA,16742,5932,5176,6855,6416,3644,8186,7572,5992.396277,5223,7483,46657,8642,-3177,4206,8900,52951,55299,43480,50863,55557
25019,MA,21588,5932,5176,6855,6416,3644,8996,5932,5899.634725,5223,6855,49142,9477,-2342,5437,9735,58607,58619,46800,54579,58877
25021,MA,17424,5932,5176,6855,6416,3644,8300,6828,5825.425483,5223,7466,46410,8642,-3177,4206,8900,53747,55052,43233,50616,55310
25023,MA,15676,5932,5176,6855,6416,3644,8007,6891,6177.919381,5223,7415,45027,8365,-3454,3797,8623,51706,53392,41573,48824,53650
25025,MA,17448,5932,5176,6855,6416,3644,8304,6526,6344.890175,5223,7656,46842,8642,-3177,4206,8900,53775,55484,43665,51048,55742
25027,MA,11371,5932,5176,6855,6416,3644,7288,7233,5639.902378,5223,7300,40411,6955,-4864,1746,7213,46682,47366,35547,42157,47624
26001,MI,7644,4756,4553,8320,5800,3699,5774,4756,4357.251692,4480,8320,33256,3935,-8142,-1181,3935,40546,37191,25114,32075,37191
26003,MI,7644,4756,4553,8320,5800,3699,5774,4756,4602.041113,4480,8320,33501,3935,-8142,-1181,3935,40546,37436,25359,32320,37436
26005,MI,8328,4756,4553,8320,5800,3699,5882,5102,4422.528871,4480,8288,34319,4395,-7682,-779,4395,41338,38714,26637,33540,38714
26007,MI,7644,4756,4553,8320,5800,3699,5774,4386,4406.209576,4480,7219,31835,1520,-10557,-3479,1520,40546,33355,21278,28356,33355
26009,MI,7776,4756,4553,8320,5800,3699,5794,4756,4944.746302,4480,8320,33976,3935,-8142,-1181,3935,40698,37911,25834,32795,37911
26011,MI,7644,4756,4553,8320,5800,3699,5774,4756,4226.697334,4480,8320,33126,3935,-8142,-1181,3935,40546,37061,24984,31945,37061
26013,MI,7644,4756,4553,8320,5800,3699,5774,4756,4667.318291,4480,8320,33566,3935,-8142,-1181,3935,40546,37501,25424,32385,37501
26015,MI,8160,4756,4553,8320,5800,3699,5855,4813,4275.655218,4480,8349,33777,4395,-7682,-779,4395,41143,38172,26095,32998,38172
26017,MI,7896,4756,4553,8320,5800,3699,5813,4736,4096.142976,4480,7871,32778,3935,-8142,-1181,3935,40837,36713,24636,31597,36713
26019,MI,8208,4756,4553,8320,5800,3699,5863,4531,4569.402523,4480,8061,33548,3935,-8142,-1181,3935,41199,37483,25406,32367,37483
26021,MI,8328,4756,4553,8320,5800,3699,5882,4749,4161.420155,4480,7910,33328,3935,-8142,-1181,3935,41338,37263,25186,32147,37263
26023,MI,7944,4756,4553,8320,5800,3699,5821,4594,3786.076376,4480,7855,32358,3935,-8142,-1181,3935,40893,36293,24216,31177,36293
26025,MI,8268,4756,4553,8320,5800,3699,5872,4805,4145.10086,4480,7834,33231,3935,-8142,-1181,3935,41268,37166,25089,32050,37166
26027,MI,7644,4756,4553,8320,5800,3699,5774,4553,4520.444639,4480,8030,32926,3476,-8601,-1581,3476,40546,36402,24325,31345,36402
26029,MI,8244,4756,4553,8320,5800,3699,5868,4756,4993.704186,4480,8320,34493,4395,-7682,-779,4395,41240,38888,26811,33714,38888
26031,MI,7644,4756,4553,8320,5800,3699,5774,4756,4357.251692,4480,8320,33256,3935,-8142,-1181,3935,40546,37191,25114,32075,37191
26033,MI,7728,4756,4553,8320,5800,3699,5787,4738,4471.486755,4480,7582,32698,3476,-8601,-1581,3476,40643,36174,24097,31117,36174
26035,MI,7644,4756,4553,8320,5800,3699,5774,4756,3900.311439,4480,8320,32799,3935,-8142,-1181,3935,40546,36734,24657,31618,36734
26037,MI,9144,4756,4553,8320,5800,3699,6010,5336,4569.402523,4480,8112,35340,4854,-7223,-379,4854,42282,40194,28117,34961,40194
26039,MI,8256,4756,4553,8320,5800,3699,5870,4756,4406.209576,4480,8320,33917,4395,-7682,-779,4395,41254,38312,26235,33138,38312
26041,MI,7644,4756,4553,8320,5800,3699,5774,4459,4504.125344,4480,7685,32470,3476,-8601,-1581,3476,40546,35946,23869,30889,35946
26043,MI,7644,4756,4553,8320,5800,3699,5774,4275,4536.763934,4480,7752,32387,3476,-8601,-1581,3476,40546,35863,23786,30806,35863
26045,MI,9144,4756,4553,8320,5800,3699,6010,5425,4259.335923,4480,8101,35108,4854,-7223,-379,4854,42282,39962,27885,34729,39962
26047,MI,9228,4756,4553,8320,5800,3699,6023,4756,4814.191944,4480,8320,35297,4854,-7223,-379,4854,42379,40151,28074,34918,40151
26049,MI,8520,4756,4553,8320,5800,3699,5912,4990,4226.697334,4480,7699,33615,3935,-8142,-1181,3935,41560,37550,25473,32434,37550
26051,MI,7644,4756,4553,8320,5800,3699,5774,4756,4667.318291,4480,8320,33566,3935,-8142,-1181,3935,40546,37501,25424,32385,37501
26053,MI,7644,4756,4553,8320,5800,3699,5774,4756,4259.335923,4480,8320,33158,3935,-8142,-1181,3935,40546,37093,25016,31977,37093
26055,MI,9780,4756,4553,8320,5800,3699,6111,5359,4748.914765,4480,8038,36105,4854,-7223,-379,4854,43019,40959,28882,35726,40959
26057,MI,7644,4756,4553,8320,5800,3699,5774,4592,4145.10086,4480,7608,32168,3476,-8601,-1581,3476,40546,35644,23567,30587,35644
26059,MI,7932,4756,4553,8320,5800,3699,5819,4608,4014.546502,4480,7823,32556,3935,-8142,-1181,3935,40879,36491,24414,31375,36491
26061,MI,7764,4756,4553,8320,5800,3699,5793,4471,4683.637586,4480,7338,32435,3476,-8601,-1581,3476,40685,35911,23834,30854,35911
26063,MI,7644,4756,4553,8320,5800,3699,5774,4756,4226.697334,4480,8320,33126,3935,-8142,-1181,3935,40546,37061,24984,31945,37061
26065,MI,9144,4756,4553,8320,5800,3699,6010,5583,4471.486755,4480,8083,35460,4854,-7223,-379,4854,42282,40314,28237,35081,40314
26067,MI,8112,4756,4553,8320,5800,3699,5847,5002,4177.73945,4480,8076,33546,3935,-8142,-1181,3935,41087,37481,25404,32365,37481
26069,MI,7644,4756,4553,8320,5800,3699,5774,4756,4504.125344,4480,8320,33403,3935,-8142,-1181,3935,40546,37338,25261,32222,37338
26071,MI,7644,4756,4553,8320,5800,3699,5774,4756,4308.293808,4480,8320,33207,3935,-8142,-1181,3935,40546,37142,25065,32026,37142
26073,MI,8328,4756,4553,8320,5800,3699,5882,5368,4275.655218,4480,7597,33748,4395,-7682,-779,4395,41338,38143,26066,32969,38143
26075,MI,9264,4756,4553,8320,5800,3699,6029,4928,4063.504387,4480,7928,34362,4395,-7682,-779,4395,42421,38757,26680,33583,38757
26077,MI,8616,4756,4553,8320,5800,3699,5927,5401,4340.932397,4480,8021,34558,4395,-7682,-779,4395,41671,38953,26876,33779,38953
26079,MI,8604,4756,4553,8320,5800,3699,5925,4540,4553.083228,4480,8044,33920,3935,-8142,-1181,3935,41657,37855,25778,32739,37855
26081,MI,8880,4756,4553,8320,5800,3699,5969,5528,4275.655218,4480,8356,35218,4854,-7223,-379,4854,41977,40072,27995,34839,40072
26083,MI,7716,4756,4553,8320,5800,3699,5785,4027,4667.318291,4480,7431,32020,1520,-10557,-3479,1520,40629,33540,21463,28541,33540
26085,MI,7644,4756,4553,8320,5800,3699,5774,4756,4112.462271,4480,8320,33011,3935,-8142,-1181,3935,40546,36946,24869,31830,36946
26087,MI,10116,4756,4553,8320,5800,3699,6164,5040,4406.209576,4480,8158,35899,5314,-6763,23,5314,43408,41213,29136,35922,41213
26089,MI,9612,4756,4553,8320,5800,3699,6084,5183,7474.236984,4480,8069,38517,4854,-7223,-379,4854,42824,43371,31294,38138,43371
26091,MI,8388,4756,4553,8320,5800,3699,5891,4871,3916.630734,4480,7997,33351,3935,-8142,-1181,3935,41407,37286,25209,32170,37286
26093,MI,10656,4756,4553,8320,5800,3699,6249,5778,4406.209576,4480,8151,37170,5773,-6304,423,5773,44033,42943,30866,37593,42943
26095,MI,7644,4756,4553,8320,5800,3699,5774,4756,4602.041113,4480,8320,33501,3935,-8142,-1181,3935,40546,37436,25359,32320,37436
26097,MI,7836,4756,4553,8320,5800,3699,5804,4756,4569.402523,4480,8320,33660,3935,-8142,-1181,3935,40768,37595,25518,32479,37595
26099,MI,10116,4756,4553,8320,5800,3699,6164,5654,4422.528871,4480,8132,36504,5314,-6763,23,5314,43408,41818,29741,36527,41818
26101,MI,7680,4756,4553,8320,5800,3699,5779,4756,4585.721818,4480,8320,33521,3935,-8142,-1181,3935,40587,37456,25379,32340,37456
26103,MI,8340,4756,4553,8320,5800,3699,5883,4793,4716.276176,4480,7909,33937,3935,-8142,-1181,3935,41351,37872,25795,32756,37872
26105,MI,8040,4756,4553,8320,5800,3699,5836,4836,4177.73945,4480,7604,32837,3935,-8142,-1181,3935,41004,36772,24695,31656,36772
26107,MI,7644,4756,4553,8320,5800,3699,5774,4879,4145.10086,4480,7510,32357,3476,-8601,-1581,3476,40546,35833,23756,30776,35833
26109,MI,7644,4756,4553,8320,5800,3699,5774,4253,5287.451491,4480,7587,32950,3476,-8601,-1581,3476,40546,36426,24349,31369,36426
26111,MI,8928,4756,4553,8320,5800,3699,5976,5167,4585.721818,4480,8109,34969,4395,-7682,-779,4395,42032,39364,27287,34190,39364
26113,MI,7644,4756,4553,8320,5800,3699,5774,4388,4471.486755,4480,7849,32531,3476,-8601,-1581,3476,40546,36007,23930,30950,36007
26115,MI,10116,4756,4553,8320,5800,3699,6164,5275,4324.613102,4480,8222,36116,5314,-6763,23,5314,43408,41430,29353,36139,41430
26117,MI,7812,4756,4553,8320,5800,3699,5800,4599,4112.462271,4480,8349,33051,3935,-8142,-1181,3935,40740,36986,24909,31870,36986
26119,MI,7992,4756,4553,8320,5800,3699,5829,4756,4422.528871,4480,8320,33670,3935,-8142,-1181,3935,40949,37605,25528,32489,37605
26121,MI,7656,4756,4553,8320,5800,3699,5776,4647,4079.823681,4480,7745,32307,3476,-8601,-1581,3476,40560,35783,23706,30726,35783
26123,MI,7644,4756,4553,8320,5800,3699,5774,4756,4014.546502,4480,8320,32914,3935,-8142,-1181,3935,40546,36849,24772,31733,36849
26125,MI,10116,4756,4553,8320,5800,3699,6164,6292,4504.125344,4480,8134,37225,5773,-6304,423,5773,43408,42998,30921,37648,42998
26127,MI,7764,4756,4553,8320,5800,3699,5793,4756,4357.251692,4480,8320,33376,3935,-8142,-1181,3935,40685,37311,25234,32195,37311
26129,MI,7656,4756,4553,8320,5800,3699,5776,4756,4226.697334,4480,8320,33138,3935,-8142,-1181,3935,40560,37073,24996,31957,37073
26131,MI,7644,4756,4553,8320,5800,3699,5774,4756,4324.613102,4480,8320,33224,3935,-8142,-1181,3935,40546,37159,25082,32043,37159
26133,MI,7644,4756,4553,8320,5800,3699,5774,4756,3492.329071,4480,8320,32391,3935,-8142,-1181,3935,40546,36326,24249,31210,36326
26135,MI,8220,4756,4553,8320,5800,3699,5865,4756,4406.209576,4480,8320,33881,4395,-7682,-779,4395,41213,38276,26199,33102,38276
26137,MI,7956,4756,4553,8320,5800,3699,5823,4756,4487.80605,4480,8320,33699,3935,-8142,-1181,3935,40907,37634,25557,32518,37634
26139,MI,9444,4756,4553,8320,5800,3699,6058,5411,4161.420155,4480,8353,35548,4854,-7223,-379,4854,42630,40402,28325,35169,40402
26141,MI,7644,4756,4553,8320,5800,3699,5774,4756,4536.763934,4480,8320,33436,3935,-8142,-1181,3935,40546,37371,25294,32255,37371
26143,MI,7644,4756,4553,8320,5800,3699,5774,4756,4291.974513,4480,8320,33191,3935,-8142,-1181,3935,40546,37126,25049,32010,37126
26145,MI,8508,4756,4553,8320,5800,3699,5910,4761,4112.462271,4480,7802,33363,3935,-8142,-1181,3935,41546,37298,25221,32182,37298
26147,MI,10116,4756,4553,8320,5800,3699,6164,5074,4226.697334,4480,8149,35745,5314,-6763,23,5314,43408,41059,28982,35768,41059
26149,MI,7884,4756,4553,8320,5800,3699,5812,4545,4145.10086,4480,8020,32773,3935,-8142,-1181,3935,40824,36708,24631,31592,36708
26151,MI,7644,4756,4553,8320,5800,3699,5774,4756,4112.462271,4480,8320,33011,3935,-8142,-1181,3935,40546,36946,24869,31830,36946
26153,MI,7644,4756,4553,8320,5800,3699,5774,4756,4487.80605,4480,8320,33387,3935,-8142,-1181,3935,40546,37322,25245,32206,37322
26155,MI,8100,4756,4553,8320,5800,3699,5846,4750,3916.630734,4480,7955,32900,3935,-8142,-1181,3935,41074,36835,24758,31719,36835
26157,MI,7644,4756,4553,8320,5800,3699,5774,4756,4079.823681,4480,8320,32979,3935,-8142,-1181,3935,40546,36914,24837,31798,36914
26159,MI,8616,4756,4553,8320,5800,3699,5927,4909,4340.932397,4480,8027,34072,4395,-7682,-779,4395,41671,38467,26390,33293,38467
26161,MI,11424,4756,4553,8320,5800,3699,6370,6599,4618.360407,4480,8289,39110,6692,-5385,1225,6692,44922,45802,33725,40335,45802
26163,MI,10116,4756,4553,8320,5800,3699,6164,5302,4308.293808,4480,8125,36030,5314,-6763,23,5314,43408,41344,29267,36053,41344
26165,MI,7788,4756,4553,8320,5800,3699,5796,4768,4161.420155,4480,7821,32717,3935,-8142,-1181,3935,40712,36652,24575,31536,36652
27001,MN,8472,17079,4553,8320,6048,3699,7122,17079,4455.16746,4636,8320,46661,8327,-3459,4056,8618,55293,54988,43202,50717,55279
27003,MN,11352,17079,4553,8320,6048,3699,7657,19396,4357.251692,4636,8943,52383,10109,-1677,6630,10400,58708,62492,50706,59013,62783
27005,MN,7644,17079,4553,8320,6048,3699,6968,17079,4471.486755,4636,8320,45849,8029,-3756,3627,8321,54311,53878,42093,49476,54170
27007,MN,8088,17079,4553,8320,6048,3699,7051,16867,4406.209576,4636,7993,45689,8029,-3756,3627,8321,54838,53718,41933,49316,54010
27009,MN,9024,17079,4553,8320,6048,3699,7224,17784,4944.746302,4636,8399,48487,8921,-2865,4914,9212,55947,57408,45622,53401,57699
27011,MN,7644,17079,4553,8320,6048,3699,6968,17079,4455.16746,4636,8320,45833,8029,-3756,3627,8321,54311,53862,42077,49460,54154
27013,MN,8448,17079,4553,8320,6048,3699,7118,17762,4373.570986,4636,8466,47384,8623,-3162,4485,8915,55265,56007,44222,51869,56299
27015,MN,7644,17079,4553,8320,6048,3699,6968,14877,4650.998997,4636,7993,43500,7435,-4350,2769,7727,54311,50935,39150,46269,51227
27017,MN,8304,17079,4553,8320,6048,3699,7091,15709,4667.318291,4636,7910,44926,7733,-4053,3198,8024,55094,52659,40873,48124,52950
27019,MN,11352,17079,4553,8320,6048,3699,7657,21566,5940.22328,4636,8926,56119,10703,-1083,7488,10994,58708,66822,55036,63607,67113
27021,MN,8580,17079,4553,8320,6048,3699,7142,15254,4259.335923,4636,7801,44230,7733,-4053,3198,8024,55421,51963,40177,47428,52254
27023,MN,7752,17079,4553,8320,6048,3699,6988,17079,4569.402523,4636,8320,46055,8327,-3459,4056,8618,54439,54382,42596,50111,54673
27025,MN,11352,17079,4553,8320,6048,3699,7657,17935,4846.830533,4636,8916,51385,9515,-2271,5772,9806,58708,60900,49114,57157,61191
27027,MN,8208,17079,4553,8320,6048,3699,7073,17783,4781.553355,4636,8345,47452,8623,-3162,4485,8915,54980,56075,44290,51937,56367
27029,MN,7644,17079,4553,8320,6048,3699,6968,17079,4471.486755,4636,8320,45849,8029,-3756,3627,8321,54311,53878,42093,49476,54170
27031,MN,9504,17079,4553,8320,6048,3699,7314,17079,4553.083228,4636,8320,47791,8623,-3162,4485,8915,56517,56414,44629,52276,56706
27033,MN,7644,17079,4553,8320,6048,3699,6968,17079,4471.486755,4636,8320,45849,8029,-3756,3627,8321,54311,53878,42093,49476,54170
27035,MN,8652,17079,4553,8320,6048,3699,7155,16028,4308.293808,4636,7758,45081,8029,-3756,3627,8321,55506,53110,41325,48708,53402
27037,MN,11352,17079,4553,8320,6048,3699,7657,21738,4765.23406,4636,8959,55150,10703,-1083,7488,10994,58708,65853,54067,62638,66144
27039,MN,10356,17079,4553,8320,6048,3699,7472,16716,4487.80605,4636,8846,48741,8921,-2865,4914,9212,57527,57662,45876,53655,57953
27041,MN,7644,17079,4553,8320,6048,3699,6968,16430,4569.402523,4636,8043,45022,8029,-3756,3627,8321,54311,53051,41266,48649,53343
27043,MN,7644,17079,4553,8320,6048,3699,6968,17079,4438.848165,4636,8320,45817,8029,-3756,3627,8321,54311,53846,42061,49444,54138
27045,MN,7644,17079,4553,8320,6048,3699,6968,15007,4422.528871,4636,8835,44243,7733,-4053,3198,8024,54311,51976,40190,47441,52267
27047,MN,7644,17079,4553,8320,6048,3699,6968,14703,4765.23406,4636,7928,43375,7435,-4350,2769,7727,54311,50810,39025,46144,51102
27049,MN,8940,17079,4553,8320,6048,3699,7209,18263,4977.384891,4636,8330,48845,8921,-2865,4914,9212,55848,57766,45980,53759,58057
27051,MN,7644,17079,4553,8320,6048,3699,6968,17079,4569.402523,4636,8320,45947,8029,-3756,3627,8321,54311,53976,42191,49574,54268
27053,MN,11352,17079,4553,8320,6048,3699,7657,22011,4814.191944,4636,8998,55510,10703,-1083,7488,10994,58708,66213,54427,62998,66504
27055,MN,8388,17079,4553,8320,6048,3699,7106,15248,4389.890281,4636,8292,44652,7733,-4053,3198,8024,55193,52385,40599,47850,52676
27057,MN,7644,17079,4553,8320,6048,3699,6968,17079,4536.763934,4636,8320,45915,8029,-3756,3627,8321,54311,53944,42159,49542,54236
27059,MN,11352,17079,4553,8320,6048,3699,7657,17605,4667.318291,4636,8922,50881,9515,-2271,5772,9806,58708,60396,48610,56653,60687
27061,MN,8964,17079,4553,8320,6048,3699,7213,17079,4487.80605,4636,8320,47186,8623,-3162,4485,8915,55876,55809,44024,51671,56101
27063,MN,7644,17079,4553,8320,6048,3699,6968,17079,4389.890281,4636,8320,45768,8029,-3756,3627,8321,54311,53797,42012,49395,54089
27065,MN,9240,17079,4553,8320,6048,3699,7265,17079,4487.80605,4636,8320,47462,8623,-3162,4485,8915,56204,56085,44300,51947,56377
27067,MN,7848,17079,4553,8320,6048,3699,7006,16615,4553.083228,4636,8215,45566,8029,-3756,3627,8321,54553,53595,41810,49193,53887
27069,MN,7644,17079,4553,8320,6048,3699,6968,17079,4553.083228,4636,8320,45931,8029,-3756,3627,8321,54311,53960,42175,49558,54252
27071,MN,7644,17079,4553,8320,6048,3699,6968,17079,4455.16746,4636,8320,45833,8029,-3756,3627,8321,54311,53862,42077,49460,54154
27073,MN,7644,17079,4553,8320,6048,3699,6968,17079,4553.083228,4636,8320,45931,8029,-3756,3627,8321,54311,53960,42175,49558,54252
27075,MN,7752,17079,4553,8320,6048,3699,6988,17079,4585.721818,4636,8320,46072,8327,-3459,4056,8618,54439,54399,42613,50128,54690
27077,MN,7644,17079,4553,8320,6048,3699,6968,17079,4455.16746,4636,8320,45833,8029,-3756,3627,8321,54311,53862,42077,49460,54154
27079,MN,8544,17079,4553,8320,6048,3699,7135,16542,4438.848165,4636,8916,46776,8327,-3459,4056,8618,55378,55103,43317,50832,55394
27081,MN,7644,17079,4553,8320,6048,3699,6968,17079,4716.276176,4636,8320,46094,8029,-3756,3627,8321,54311,54123,42338,49721,54415
27083,MN,7644,17079,4553,8320,6048,3699,6968,15878,4667.318291,4636,8255,44779,7733,-4053,3198,8024,54311,52512,40726,47977,52803
27085,MN,8052,17079,4553,8320,6048,3699,7044,17279,4716.276176,4636,8335,46717,8327,-3459,4056,8618,54795,55044,43258,50773,55335
27087,MN,7644,17079,4553,8320,6048,3699,6968,17079,4569.402523,4636,8320,45947,8029,-3756,3627,8321,54311,53976,42191,49574,54268
27089,MN,7644,17079,4553,8320,6048,3699,6968,17079,4487.80605,4636,8320,45866,8029,-3756,3627,8321,54311,53895,42110,49493,54187
27091,MN,7980,17079,4553,8320,6048,3699,7031,17079,4602.041113,4636,8320,46316,8327,-3459,4056,8618,54710,54643,42857,50372,54934
27093,MN,9012,17079,4553,8320,6048,3699,7222,17079,4667.318291,4636,8320,47413,8623,-3162,4485,8915,55933,56036,44251,51898,56328
27095,MN,8712,17079,4553,8320,6048,3699,7167,16670,4471.486755,4636,8916,47104,8623,-3162,4485,8915,55578,55727,43942,51589,56019
27097,MN,7656,17079,4553,8320,6048,3699,6970,17079,4569.402523,4636,8320,45959,8029,-3756,3627,8321,54325,53988,42203,49586,54280
27099,MN,8376,17079,4553,8320,6048,3699,7104,15071,3965.588618,4636,8075,43822,7733,-4053,3198,8024,55179,51555,39769,47020,51846
27101,MN,7644,17079,4553,8320,6048,3699,6968,17079,4406.209576,4636,8320,45784,8029,-3756,3627,8321,54311,53813,42028,49411,54105
27103,MN,8448,17079,4553,8320,6048,3699,7118,17832,5091.619954,4636,8464,48170,8623,-3162,4485,8915,55265,56793,45008,52655,57085
27105,MN,7644,17079,4553,8320,6048,3699,6968,14957,4128.781566,4636,8341,43406,7435,-4350,2769,7727,54311,50841,39056,46175,51133
27107,MN,7644,17079,4553,8320,6048,3699,6968,17079,4585.721818,4636,8320,45964,8029,-3756,3627,8321,54311,53993,42208,49591,54285
27109,MN,10356,17079,4553,8320,6048,3699,7472,18710,4487.80605,4636,8865,50754,9515,-2271,5772,9806,57527,60269,48483,56526,60560
27111,MN,7644,17079,4553,8320,6048,3699,6968,15714,4585.721818,4636,7971,44250,7733,-4053,3198,8024,54311,51983,40197,47448,52274
27113,MN,7644,17079,4553,8320,6048,3699,6968,17079,4487.80605,4636,8320,45866,8029,-3756,3627,8321,54311,53895,42110,49493,54187
27115,MN,8664,17079,4553,8320,6048,3699,7158,17079,4618.360407,4636,8320,47016,8327,-3459,4056,8618,55521,55343,43557,51072,55634
27117,MN,7644,17079,4553,8320,6048,3699,6968,17079,4422.528871,4636,8320,45801,8029,-3756,3627,8321,54311,53830,42045,49428,54122
27119,MN,8700,17079,4553,8320,6048,3699,7164,15958,4650.998997,4636,8168,45812,8029,-3756,3627,8321,55563,53841,42056,49439,54133
27121,MN,8376,17079,4553,8320,6048,3699,7104,17079,4553.083228,4636,8320,46663,8327,-3459,4056,8618,55179,54990,43204,50719,55281
27123,MN,11352,17079,4553,8320,6048,3699,7657,20831,4765.23406,4636,9001,54283,10703,-1083,7488,10994,58708,64986,53200,61771,65277
27125,MN,7644,17079,4553,8320,6048,3699,6968,17079,4634.679702,4636,8320,46013,8029,-3756,3627,8321,54311,54042,42257,49640,54334
27127,MN,7644,17079,4553,8320,6048,3699,6968,17079,4602.041113,4636,8320,45980,8029,-3756,3627,8321,54311,54009,42224,49607,54301
27129,MN,7644,17079,4553,8320,6048,3699,6968,17079,4634.679702,4636,8320,46013,8029,-3756,3627,8321,54311,54042,42257,49640,54334
27131,MN,10188,17079,4553,8320,6048,3699,7441,18330,4406.209576,4636,8359,49618,9217,-2568,5343,9509,57328,58835,47050,54961,59127
27133,MN,7644,17079,4553,8320,6048,3699,6968,17079,4389.890281,4636,8320,45768,8029,-3756,3627,8321,54311,53797,42012,49395,54089
27135,MN,7644,17079,4553,8320,6048,3699,6968,17079,4487.80605,4636,8320,45866,8029,-3756,3627,8321,54311,53895,42110,49493,54187
27137,MN,8304,17079,4553,8320,6048,3699,7091,16240,4569.402523,4636,7875,45323,8029,-3756,3627,8321,55094,53352,41567,48950,53644
27139,MN,11352,17079,4553,8320,6048,3699,7657,21399,4471.486755,4636,8927,54484,10703,-1083,7488,10994,58708,65187,53401,61972,65478
27141,MN,11352,17079,4553,8320,6048,3699,7657,18008,4275.655218,4636,8897,50867,9515,-2271,5772,9806,58708,60382,48596,56639,60673
27143,MN,7644,17079,4553,8320,6048,3699,6968,15323,4683.637586,4636,8909,44895,7733,-4053,3198,8024,54311,52628,40842,48093,52919
27145,MN,9024,17079,4553,8320,6048,3699,7224,16984,4569.402523,4636,8398,47310,8623,-3162,4485,8915,55947,55933,44148,51795,56225
27147,MN,8868,17079,4553,8320,6048,3699,7196,17025,4797.872649,4636,8441,47467,8623,-3162,4485,8915,55763,56090,44305,51952,56382
27149,MN,7644,17079,4553,8320,6048,3699,6968,17079,4536.763934,4636,8320,45915,8029,-3756,3627,8321,54311,53944,42159,49542,54236
27151,MN,7644,17079,4553,8320,6048,3699,6968,17079,4536.763934,4636,8320,45915,8029,-3756,3627,8321,54311,53944,42159,49542,54236
27153,MN,8580,17079,4553,8320,6048,3699,7142,17079,4553.083228,4636,8320,46867,8327,-3459,4056,8618,55421,55194,43408,50923,55485
27155,MN,7644,17079,4553,8320,6048,3699,6968,17079,4569.402523,4636,8320,45947,8029,-3756,3627,8321,54311,53976,42191,49574,54268
27157,MN,7644,17079,4553,8320,6048,3699,6968,16665,4797.872649,4636,8849,46290,8327,-3459,4056,8618,54311,54617,42831,50346,54908
27159,MN,7644,17079,4553,8320,6048,3699,6968,17079,4406.209576,4636,8320,45784,8029,-3756,3627,8321,54311,53813,42028,49411,54105
27161,MN,7740,17079,4553,8320,6048,3699,6986,17079,4487.80605,4636,8320,45962,8327,-3459,4056,8618,54425,54289,42503,50018,54580
27163,MN,11352,17079,4553,8320,6048,3699,7657,21029,4748.914765,4636,8929,54394,10703,-1083,7488,10994,58708,65097,53311,61882,65388
27165,MN,7644,17079,4553,8320,6048,3699,6968,17079,4455.16746,4636,8320,45833,8029,-3756,3627,8321,54311,53862,42077,49460,54154
27167,MN,7644,17079,4553,8320,6048,3699,6968,14148,4602.041113,4636,8163,42892,7139,-4647,2340,7430,54311,50031,38245,45232,50322
27169,MN,7692,17079,4553,8320,6048,3699,6977,16794,5026.342775,4636,8307,46155,8029,-3756,3627,8321,54368,54184,42399,49782,54476
27171,MN,11352,17079,4553,8320,6048,3699,7657,18836,5058.981365,4636,8921,52503,9515,-2271,5772,9806,58708,62018,50232,58275,62309
27173,MN,7644,17079,4553,8320,6048,3699,6968,17079,4602.041113,4636,8320,45980,8029,-3756,3627,8321,54311,54009,42224,49607,54301
28001,MS,7368,6648,4457,8554,6217,3916,5418,6405,4568.90789,5188,8554,36000,4647,-7430,-586,4647,42578,40647,28570,35414,40647
28003,MS,7368,6648,4457,8554,6217,3916,5418,6449,4616.833498,5188,8554,36092,4647,-7430,-586,4647,42578,40739,28662,35506,40739
28005,MS,7368,6648,4457,8554,6217,3916,5418,6644,4728.659915,5188,8554,36399,5114,-6963,-177,5114,42578,41513,29436,36222,41513
28007,MS,7368,6648,4457,8554,6217,3916,5418,6648,4936.337546,5188,8554,36610,5114,-6963,-177,5114,42578,41724,29647,36433,41724
28009,MS,7368,6648,4457,8554,6217,3916,5418,6273,4616.833498,5188,8554,35916,4647,-7430,-586,4647,42578,40563,28486,35330,40563
28011,MS,7464,6648,4457,8554,6217,3916,5433,6461,4712.684712,5188,8554,36295,5114,-6963,-177,5114,42689,41409,29332,36118,41409
28013,MS,7368,6648,4457,8554,6217,3916,5418,6648,4728.659915,5188,8554,36403,5114,-6963,-177,5114,42578,41517,29440,36226,41517
28015,MS,10656,6648,4457,8554,6217,3916,5928,6703,4696.70951,5188,8554,39713,6515,-5562,1048,6515,46376,46228,34151,40761,46228
28017,MS,7368,6648,4457,8554,6217,3916,5418,6648,4584.883093,5188,8554,36259,5114,-6963,-177,5114,42578,41373,29296,36082,41373
28019,MS,7368,6648,4457,8554,6217,3916,5418,6648,4776.585522,5188,8554,36451,5114,-6963,-177,5114,42578,41565,29488,36274,41565
28021,MS,7368,6648,4457,8554,6217,3916,5418,6599,4568.90789,5188,8554,36194,5114,-6963,-177,5114,42578,41308,29231,36017,41308
28023,MS,7368,6648,4457,8554,6217,3916,5418,6631,4520.982283,5188,8554,36178,5114,-6963,-177,5114,42578,41292,29215,36001,41292
28025,MS,7896,6648,4457,8554,6217,3916,5500,6648,4536.957486,5188,8554,36739,5114,-6963,-177,5114,43188,41853,29776,36562,41853
28027,MS,7680,6648,4457,8554,6217,3916,5466,6393,4584.883093,5188,8554,36315,5114,-6963,-177,5114,42938,41429,29352,36138,41429
28029,MS,9252,6648,4457,8554,6217,3916,5710,6711,4457.081474,5188,8554,38078,6048,-6029,640,6048,44754,44126,32049,38718,44126
28031,MS,7368,6648,4457,8554,6217,3916,5418,6648,4520.982283,5188,8554,36195,5114,-6963,-177,5114,42578,41309,29232,36018,41309
28033,MS,9360,6648,4457,8554,6217,3916,5727,7256,4425.131069,5188,8554,38699,6048,-6029,640,6048,44879,44747,32670,39339,44747
28035,MS,8616,6648,4457,8554,6217,3916,5612,7223,4712.684712,5188,8554,38209,5581,-6496,231,5581,44020,43790,31713,38440,43790
28037,MS,7368,6648,4457,8554,6217,3916,5418,6648,4489.031878,5188,8554,36163,5114,-6963,-177,5114,42578,41277,29200,35986,41277
28039,MS,9816,6648,4457,8554,6217,3916,5798,6648,4536.957486,5188,8554,38659,6048,-6029,640,6048,45406,44707,32630,39299,44707
28041,MS,7368,6648,4457,8554,6217,3916,5418,6648,4760.610319,5188,8554,36435,5114,-6963,-177,5114,42578,41549,29472,36258,41549
28043,MS,7368,6648,4457,8554,6217,3916,5418,6326,4760.610319,5188,8554,36112,4647,-7430,-586,4647,42578,40759,28682,35526,40759
28045,MS,9936,6648,4457,8554,6217,3916,5817,7401,4808.535927,5188,8554,39803,6515,-5562,1048,6515,45545,46318,34241,40851,46318
28047,MS,9936,6648,4457,8554,6217,3916,5817,7859,4632.8087,5188,8554,40086,6515,-5562,1048,6515,45545,46601,34524,41134,46601
28049,MS,9252,6648,4457,8554,6217,3916,5710,7022,4600.858295,5188,8554,38533,6048,-6029,640,6048,44754,44581,32504,39173,44581
28051,MS,7368,6648,4457,8554,6217,3916,5418,6648,5064.139165,5188,8554,36738,5114,-6963,-177,5114,42578,41852,29775,36561,41852
28053,MS,7368,6648,4457,8554,6217,3916,5418,6648,4632.8087,5188,8554,36307,5114,-6963,-177,5114,42578,41421,29344,36130,41421
28055,MS,11640,6648,4457,8554,6217,3916,6081,6648,4600.858295,5188,8554,40547,6811,-5266,1457,6811,47513,47358,35281,42004,47358
28057,MS,7368,6648,4457,8554,6217,3916,5418,6421,4489.031878,5188,8554,35936,4647,-7430,-586,4647,42578,40583,28506,35350,40583
28059,MS,9816,6648,4457,8554,6217,3916,5798,7417,4904.387141,5188,8554,39795,6515,-5562,1048,6515,45406,46310,34233,40843,46310
28061,MS,7368,6648,4457,8554,6217,3916,5418,6514,4505.007081,5188,8554,36045,4647,-7430,-586,4647,42578,40692,28615,35459,40692
28063,MS,7368,6648,4457,8554,6217,3916,5418,6648,4584.883093,5188,8554,36259,5114,-6963,-177,5114,42578,41373,29296,36082,41373
28065,MS,7368,6648,4457,8554,6217,3916,5418,6648,4473.056676,5188,8554,36147,5114,-6963,-177,5114,42578,41261,29184,35970,41261
28067,MS,9852,6648,4457,8554,6217,3916,5804,6807,4489.031878,5188,8554,38806,6048,-6029,640,6048,45448,44854,32777,39446,44854
28069,MS,7716,6648,4457,8554,6217,3916,5472,5872,4616.833498,5188,8554,35863,4647,-7430,-586,4647,42980,40510,28433,35277,40510
28071,MS,9792,6648,4457,8554,6217,3916,5794,7867,5367.668011,5188,8554,40685,6515,-5562,1048,6515,45378,47200,35123,41733,47200
28073,MS,8616,6648,4457,8554,6217,3916,5612,7804,4489.031878,5188,8554,38567,6048,-6029,640,6048,44020,44615,32538,39207,44615
28075,MS,7368,6648,4457,8554,6217,3916,5418,7231,4520.982283,5188,8554,36778,5114,-6963,-177,5114,42578,41892,29815,36601,41892
28077,MS,8052,6648,4457,8554,6217,3916,5524,6648,4552.932688,5188,8554,36911,5114,-6963,-177,5114,43368,42025,29948,36734,42025
28079,MS,7440,6648,4457,8554,6217,3916,5429,6648,4377.205461,5188,8554,36123,5114,-6963,-177,5114,42661,41237,29160,35946,41237
28081,MS,7368,6648,4457,8554,6217,3916,5418,6925,4441.106271,5188,8554,36392,5114,-6963,-177,5114,42578,41506,29429,36215,41506
28083,MS,7368,6648,4457,8554,6217,3916,5418,6189,4792.560724,5188,8554,36008,4647,-7430,-586,4647,42578,40655,28578,35422,40655
28085,MS,7368,6648,4457,8554,6217,3916,5418,7249,4648.783903,5188,8554,36923,5114,-6963,-177,5114,42578,42037,29960,36746,42037
28087,MS,7944,6648,4457,8554,6217,3916,5507,6928,4744.635117,5188,8554,37275,5114,-6963,-177,5114,43243,42389,30312,37098,42389
28089,MS,9252,6648,4457,8554,6217,3916,5710,8081,5287.791999,5188,8554,40279,6515,-5562,1048,6515,44754,46794,34717,41327,46794
28091,MS,7368,6648,4457,8554,6217,3916,5418,6648,4520.982283,5188,8554,36195,5114,-6963,-177,5114,42578,41309,29232,36018,41309
28093,MS,7368,6648,4457,8554,6217,3916,5418,7347,4552.932688,5188,8554,36926,5114,-6963,-177,5114,42578,42040,29963,36749,42040
28095,MS,7512,6648,4457,8554,6217,3916,5440,6648,4425.131069,5188,8554,36243,5114,-6963,-177,5114,42744,41357,29280,36066,41357
28097,MS,7368,6648,4457,8554,6217,3916,5418,6648,4680.734307,5188,8554,36355,5114,-6963,-177,5114,42578,41469,29392,36178,41469
28099,MS,7368,6648,4457,8554,6217,3916,5418,6648,4520.982283,5188,8554,36195,5114,-6963,-177,5114,42578,41309,29232,36018,41309
28101,MS,7872,6648,4457,8554,6217,3916,5496,6648,4536.957486,5188,8554,36715,5114,-6963,-177,5114,43160,41829,29752,36538,41829
28103,MS,7368,6648,4457,8554,6217,3916,5418,6648,4712.684712,5188,8554,36387,5114,-6963,-177,5114,42578,41501,29424,36210,41501
28105,MS,8592,6648,4457,8554,6217,3916,5608,7888,4888.411939,5188,8554,39026,6048,-6029,640,6048,43992,45074,32997,39666,45074
28107,MS,7536,6648,4457,8554,6217,3916,5444,6648,4648.783903,5188,8554,36491,5114,-6963,-177,5114,42772,41605,29528,36314,41605
28109,MS,8124,6648,4457,8554,6217,3916,5535,7099,4648.783903,5188,8554,37529,5581,-6496,231,5581,43451,43110,31033,37760,43110
28111,MS,8616,6648,4457,8554,6217,3916,5612,7081,4520.982283,5188,8554,37876,5581,-6496,231,5581,44020,43457,31380,38107,43457
28113,MS,7836,6648,4457,8554,6217,3916,5491,7037,4377.205461,5188,8554,36909,5114,-6963,-177,5114,43119,42023,29946,36732,42023
28115,MS,7368,6648,4457,8554,6217,3916,5418,6735,4712.684712,5188,8554,36474,5114,-6963,-177,5114,42578,41588,29511,36297,41588
28117,MS,7368,6648,4457,8554,6217,3916,5418,6648,4441.106271,5188,8554,36115,5114,-6963,-177,5114,42578,41229,29152,35938,41229
28119,MS,7368,6648,4457,8554,6217,3916,5418,6648,4536.957486,5188,8554,36211,5114,-6963,-177,5114,42578,41325,29248,36034,41325
28121,MS,9252,6648,4457,8554,6217,3916,5710,7604,4632.8087,5188,8554,39147,6048,-6029,640,6048,44754,45195,33118,39787,45195
28123,MS,7944,6648,4457,8554,6217,3916,5507,6648,4473.056676,5188,8554,36723,5114,-6963,-177,5114,43243,41837,29760,36546,41837
28125,MS,7368,6648,4457,8554,6217,3916,5418,6648,4600.858295,5188,8554,36275,5114,-6963,-177,5114,42578,41389,29312,36098,41389
28127,MS,7368,6648,4457,8554,6217,3916,5418,6964,4568.90789,5188,8554,36559,5114,-6963,-177,5114,42578,41673,29596,36382,41673
28129,MS,8412,6648,4457,8554,6217,3916,5580,6648,4584.883093,5188,8554,37303,5581,-6496,231,5581,43784,42884,30807,37534,42884
28131,MS,9936,6648,4457,8554,6217,3916,5817,6648,4808.535927,5188,8554,39051,6048,-6029,640,6048,45545,45099,33022,39691,45099
28133,MS,7368,6648,4457,8554,6217,3916,5418,5775,4776.585522,5188,8554,35577,4647,-7430,-586,4647,42578,40224,28147,34991,40224
28135,MS,7368,6648,4457,8554,6217,3916,5418,6648,4696.70951,5188,8554,36371,5114,-6963,-177,5114,42578,41485,29408,36194,41485
28137,MS,8520,6648,4457,8554,6217,3916,5597,7421,4377.205461,5188,8554,37976,6048,-6029,640,6048,43909,44024,31947,38616,44024
28139,MS,7368,6648,4457,8554,6217,3916,5418,6648,4744.635117,5188,8554,36419,5114,-6963,-177,5114,42578,41533,29456,36242,41533
28141,MS,7368,6648,4457,8554,6217,3916,5418,6648,4409.155866,5188,8554,36083,5114,-6963,-177,5114,42578,41197,29120,35906,41197
28143,MS,8328,6648,4457,8554,6217,3916,5567,7370,4457.081474,5188,8554,37813,5581,-6496,231,5581,43687,43394,31317,38044,43394
28145,MS,7368,6648,4457,8554,6217,3916,5418,6648,4505.007081,5188,8554,36179,5114,-6963,-177,5114,42578,41293,29216,36002,41293
28147,MS,9192,6648,4457,8554,6217,3916,5701,6648,4568.90789,5188,8554,38067,5581,-6496,231,5581,44685,43648,31571,38298,43648
28149,MS,8196,6648,4457,8554,6217,3916,5547,7159,4648.783903,5188,8554,37662,5581,-6496,231,5581,43535,43243,31166,37893,43243
28151,MS,7392,6648,4457,8554,6217,3916,5422,6451,4536.957486,5188,8554,36038,4647,-7430,-586,4647,42606,40685,28608,35452,40685
28153,MS,7368,6648,4457,8554,6217,3916,5418,6648,4744.635117,5188,8554,36419,5114,-6963,-177,5114,42578,41533,29456,36242,41533
28155,MS,7368,6648,4457,8554,6217,3916,5418,6648,4776.585522,5188,8554,36451,5114,-6963,-177,5114,42578,41565,29488,36274,41565
28157,MS,7440,6648,4457,8554,6217,3916,5429,6648,4712.684712,5188,8554,36459,5114,-6963,-177,5114,42661,41573,29496,36282,41573
28159,MS,7368,6648,4457,8554,6217,3916,5418,6648,4680.734307,5188,8554,36355,5114,-6963,-177,5114,42578,41469,29392,36178,41469
28161,MS,7368,6648,4457,8554,6217,3916,5418,6648,4920.362344,5188,8554,36594,5114,-6963,-177,5114,42578,41708,29631,36417,41708
28163,MS,8028,6648,4457,8554,6217,3916,5521,7049,4952.312748,5188,8554,37687,5581,-6496,231,5581,43341,43268,31191,37918,43268
29001,MO,7152,11710,4553,8320,6298,3699,4736,11228,3965.588618,5500,7261,38806,6381,-5665,945,6412,46468,45187,33141,39751,45218
29003,MO,8940,11710,4553,8320,6298,3699,4978,11795,4145.10086,5500,8120,42199,7287,-4759,2228,7318,48498,49486,37440,44427,49517
29005,MO,7152,11710,4553,8320,6298,3699,4736,11710,4455.16746,5500,8320,40836,6696,-5350,1373,6727,46468,47532,35486,42209,47563
29007,MO,7884,11710,4553,8320,6298,3699,4835,10557,3835.03426,5500,7928,39403,6696,-5350,1373,6727,47299,46099,34053,40776,46130
29009,MO,7152,11710,4553,8320,6298,3699,4736,11710,4422.528871,5500,8320,40804,6696,-5350,1373,6727,46468,47500,35454,42177,47531
29011,MO,7152,11710,4553,8320,6298,3699,4736,11710,4096.142976,5500,8320,40477,6696,-5350,1373,6727,46468,47173,35127,41850,47204
29013,MO,7752,11710,4553,8320,6298,3699,4818,11247,4324.613102,5500,8400,40923,6991,-5055,1800,7022,47150,47914,35868,42723,47945
29015,MO,7260,11710,4553,8320,6298,3699,4751,11710,4177.73945,5500,8320,40667,6991,-5055,1800,7022,46591,47658,35612,42467,47689
29017,MO,8148,11710,4553,8320,6298,3699,4871,10688,4357.251692,5500,8038,40430,6696,-5350,1373,6727,47599,47126,35080,41803,47157
29019,MO,8292,11710,4553,8320,6298,3699,4891,13283,4716.276176,5500,8202,43692,7582,-4464,2655,7613,47763,51274,39228,46347,51305
29021,MO,8940,11710,4553,8320,6298,3699,4978,11698,4030.865797,5500,8102,41970,7287,-4759,2228,7318,48498,49257,37211,44198,49288
29023,MO,7260,11710,4553,8320,6298,3699,4751,10816,3949.269324,5500,7355,38579,6381,-5665,945,6412,46591,44960,32914,39524,44991
29025,MO,10224,11710,4553,8320,6298,3699,5152,11179,4520.444639,5500,8398,43521,7582,-4464,2655,7613,49956,51103,39057,46176,51134
29027,MO,7416,11710,4553,8320,6298,3699,4772,11613,4602.041113,5500,8202,41032,6696,-5350,1373,6727,46768,47728,35682,42405,47759
29029,MO,7500,11710,4553,8320,6298,3699,4783,11710,4814.191944,5500,8320,41543,6991,-5055,1800,7022,46863,48534,36488,43343,48565
29031,MO,8148,11710,4553,8320,6298,3699,4871,11808,4243.016629,5500,7998,41396,6991,-5055,1800,7022,47599,48387,36341,43196,48418
29033,MO,7152,11710,4553,8320,6298,3699,4736,11710,4096.142976,5500,8320,40477,6696,-5350,1373,6727,46468,47173,35127,41850,47204
29035,MO,7152,11710,4553,8320,6298,3699,4736,11710,3965.588618,5500,8320,40347,6696,-5350,1373,6727,46468,47043,34997,41720,47074
29037,MO,10224,11710,4553,8320,6298,3699,5152,13130,4389.890281,5500,8403,45347,8173,-3873,3510,8204,49956,53520,41474,48857,53551
29039,MO,7152,11710,4553,8320,6298,3699,4736,11710,4112.462271,5500,8320,40493,6696,-5350,1373,6727,46468,47189,35143,41866,47220
29041,MO,7152,11710,4553,8320,6298,3699,4736,11710,4014.546502,5500,8320,40396,6696,-5350,1373,6727,46468,47092,35046,41769,47123
29043,MO,7800,11710,4553,8320,6298,3699,4824,11953,4699.956881,5500,7919,41570,6991,-5055,1800,7022,47204,48561,36515,43370,48592
29045,MO,7152,11710,4553,8320,6298,3699,4736,10372,3835.03426,5500,7895,38453,6381,-5665,945,6412,46468,44834,32788,39398,44865
29047,MO,10224,11710,4553,8320,6298,3699,5152,13357,4455.16746,5500,8401,45636,8173,-3873,3510,8204,49956,53809,41763,49146,53840
29049,MO,10224,11710,4553,8320,6298,3699,5152,12086,4781.553355,5500,8400,44691,7878,-4168,3083,7909,49956,52569,40523,47774,52600
29051,MO,7668,11710,4553,8320,6298,3699,4806,12039,4373.570986,5500,8194,41473,6991,-5055,1800,7022,47054,48464,36418,43273,48495
29053,MO,7152,11710,4553,8320,6298,3699,4736,11710,4357.251692,5500,8320,40738,6696,-5350,1373,6727,46468,47434,35388,42111,47465
29055,MO,7152,11710,4553,8320,6298,3699,4736,11710,4765.23406,5500,8320,41146,6696,-5350,1373,6727,46468,47842,35796,42519,47873
29056,MO,9768,11710,4553,8320,6298,3699,5090,11710,4553,5500,8320,43550,7582,-4464,2655,7613,49438,51132,39086,46205,51163
29057,MO,7152,11710,4553,8320,6298,3699,4736,11710,4291.974513,5500,8320,40673,6696,-5350,1373,6727,46468,47369,35323,42046,47400
29059,MO,7152,11710,4553,8320,6298,3699,4736,10646,4340.932397,5500,7934,39272,6381,-5665,945,6412,46468,45653,33607,40217,45684
29061,MO,7152,11710,4553,8320,6298,3699,4736,11710,4438.848165,5500,8320,40820,6696,-5350,1373,6727,46468,47516,35470,42193,47547
29063,MO,8940,11710,4553,8320,6298,3699,4978,11742,4096.142976,5500,8103,42080,7287,-4759,2228,7318,48498,49367,37321,44308,49398
29065,MO,7152,11710,4553,8320,6298,3699,4736,11710,4259.335923,5500,8320,40640,6696,-5350,1373,6727,46468,47336,35290,42013,47367
29067,MO,7152,11710,4553,8320,6298,3699,4736,11710,4389.890281,5500,8320,40771,6696,-5350,1373,6727,46468,47467,35421,42144,47498
29069,MO,7152,11710,4553,8320,6298,3699,4736,9931,3769.757082,5500,7088,37140,5409,-6637,90,5440,46468,42549,30503,37230,42580
29071,MO,9768,11710,4553,8320,6298,3699,5090,12261,4047.185092,5500,8275,43550,7878,-4168,3083,7909,49438,51428,39382,46633,51459
29073,MO,7152,11710,4553,8320,6298,3699,4736,11710,4128.781566,5500,8320,40510,6696,-5350,1373,6727,46468,47206,35160,41883,47237
29075,MO,7152,11710,4553,8320,6298,3699,4736,11710,4128.781566,5500,8320,40510,6696,-5350,1373,6727,46468,47206,35160,41883,47237
29077,MO,7800,11710,4553,8320,6298,3699,4824,11578,4389.890281,5500,7898,40865,6991,-5055,1800,7022,47204,47856,35810,42665,47887
29079,MO,7152,11710,4553,8320,6298,3699,4736,11710,4406.209576,5500,8320,40787,6696,-5350,1373,6727,46468,47483,35437,42160,47514
29081,MO,7200,11710,4553,8320,6298,3699,4743,11710,4438.848165,5500,8320,40868,6696,-5350,1373,6727,46523,47564,35518,42241,47595
29083,MO,7596,11710,4553,8320,6298,3699,4796,11710,3753.437787,5500,8320,40578,6991,-5055,1800,7022,46972,47569,35523,42378,47600
29085,MO,7152,11710,4553,8320,6298,3699,4736,11710,4063.504387,5500,8320,40445,6696,-5350,1373,6727,46468,47141,35095,41818,47172
29087,MO,7152,11710,4553,8320,6298,3699,4736,11710,4210.378039,5500,8320,40591,6696,-5350,1373,6727,46468,47287,35241,41964,47318
29089,MO,8292,11710,4553,8320,6298,3699,4891,11710,4504.125344,5500,8320,42025,7287,-4759,2228,7318,47763,49312,37266,44253,49343
29091,MO,7152,11710,4553,8320,6298,3699,4736,10920,3900.311439,5500,7295,38467,6381,-5665,945,6412,46468,44848,32802,39412,44879
29093,MO,7152,11710,4553,8320,6298,3699,4736,11710,4259.335923,5500,8320,40640,6696,-5350,1373,6727,46468,47336,35290,42013,47367
29095,MO,10224,11710,4553,8320,6298,3699,5152,12919,4291.974513,5500,8405,45039,8173,-3873,3510,8204,49956,53212,41166,48549,53243
29097,MO,7404,11710,4553,8320,6298,3699,4770,10947,4063.504387,5500,7969,39583,6696,-5350,1373,6727,46754,46279,34233,40956,46310
29099,MO,9768,11710,4553,8320,6298,3699,5090,12670,4520.444639,5500,8273,44430,7878,-4168,3083,7909,49438,52308,40262,47513,52339
29101,MO,8088,11710,4553,8320,6298,3699,4863,12624,4112.462271,5500,8134,42158,7287,-4759,2228,7318,47531,49445,37399,44386,49476
29103,MO,7152,11710,4553,8320,6298,3699,4736,11710,4014.546502,5500,8320,40396,6696,-5350,1373,6727,46468,47092,35046,41769,47123
29105,MO,7152,11710,4553,8320,6298,3699,4736,11555,3802.395671,5500,7568,39277,6696,-5350,1373,6727,46468,45973,33927,40650,46004
29107,MO,10224,11710,4553,8320,6298,3699,5152,11510,4928.427007,5500,8402,44263,7582,-4464,2655,7613,49956,51845,39799,46918,51876
29109,MO,7152,11710,4553,8320,6298,3699,4736,11710,4455.16746,5500,8320,40836,6696,-5350,1373,6727,46468,47532,35486,42209,47563
29111,MO,7152,11710,4553,8320,6298,3699,4736,10821,4014.546502,5500,8040,39227,6381,-5665,945,6412,46468,45608,33562,40172,45639
29113,MO,9768,11710,4553,8320,6298,3699,5090,12499,4063.504387,5500,8276,43805,7878,-4168,3083,7909,49438,51683,39637,46888,51714
29115,MO,7152,11710,4553,8320,6298,3699,4736,11710,4063.504387,5500,8320,40445,6696,-5350,1373,6727,46468,47141,35095,41818,47172
29117,MO,7704,11710,4553,8320,6298,3699,4811,11710,4422.528871,5500,8320,41356,6991,-5055,1800,7022,47095,48347,36301,43156,48378
29119,MO,7152,11710,4553,8320,6298,3699,4736,11322,4716.276176,5500,8233,40622,6696,-5350,1373,6727,46468,47318,35272,41995,47349
29121,MO,7152,11710,4553,8320,6298,3699,4736,11710,3981.907913,5500,8320,40363,6696,-5350,1373,6727,46468,47059,35013,41736,47090
29123,MO,7500,11710,4553,8320,6298,3699,4783,11710,4308.293808,5500,8320,41037,6991,-5055,1800,7022,46863,48028,35982,42837,48059
29125,MO,7152,11710,4553,8320,6298,3699,4736,11710,4340.932397,5500,8320,40722,6696,-5350,1373,6727,46468,47418,35372,42095,47449
29127,MO,7440,11710,4553,8320,6298,3699,4775,10861,3883.992145,5500,7931,39316,6381,-5665,945,6412,46795,45697,33651,40261,45728
29129,MO,7152,11710,4553,8320,6298,3699,4736,11710,4014.546502,5500,8320,40396,6696,-5350,1373,6727,46468,47092,35046,41769,47123
29131,MO,7320,11710,4553,8320,6298,3699,4759,11710,4863.149828,5500,8320,41412,6991,-5055,1800,7022,46659,48403,36357,43212,48434
29133,MO,7152,11710,4553,8320,6298,3699,4736,11710,4063.504387,5500,8320,40445,6696,-5350,1373,6727,46468,47141,35095,41818,47172
29135,MO,7848,11710,4553,8320,6298,3699,4831,10994,4569.402523,5500,8206,40817,6696,-5350,1373,6727,47259,47513,35467,42190,47544
29137,MO,7152,11710,4553,8320,6298,3699,4736,11710,3851.353555,5500,8320,40232,6696,-5350,1373,6727,46468,46928,34882,41605,46959
29139,MO,7524,11710,4553,8320,6298,3699,4787,11710,4030.865797,5500,8320,40784,6991,-5055,1800,7022,46891,47775,35729,42584,47806
29141,MO,7416,11710,4553,8320,6298,3699,4772,11710,4536.763934,5500,8320,41182,6991,-5055,1800,7022,46768,48173,36127,42982,48204
29143,MO,7152,11710,4553,8320,6298,3699,4736,11710,4128.781566,5500,8320,40510,6696,-5350,1373,6727,46468,47206,35160,41883,47237
29145,MO,7404,11710,4553,8320,6298,3699,4770,11171,3998.227208,5500,7990,39762,6696,-5350,1373,6727,46754,46458,34412,41135,46489
29147,MO,7152,11710,4553,8320,6298,3699,4736,11413,4569.402523,5500,7548,39882,6381,-5665,945,6412,46468,46263,34217,40827,46294
29149,MO,7152,11710,4553,8320,6298,3699,4736,11710,4063.504387,5500,8320,40445,6696,-5350,1373,6727,46468,47141,35095,41818,47172
29151,MO,7668,11710,4553,8320,6298,3699,4806,10612,4536.763934,5500,8210,40226,6696,-5350,1373,6727,47054,46922,34876,41599,46953
29153,MO,7152,11710,4553,8320,6298,3699,4736,11710,4422.528871,5500,8320,40804,6696,-5350,1373,6727,46468,47500,35454,42177,47531
29155,MO,7152,11710,4553,8320,6298,3699,4736,11710,4079.823681,5500,8320,40461,6696,-5350,1373,6727,46468,47157,35111,41834,47188
29157,MO,7284,11710,4553,8320,6298,3699,4754,11710,4275.655218,5500,8320,40789,6991,-5055,1800,7022,46618,47780,35734,42589,47811
29159,MO,7944,11710,4553,8320,6298,3699,4843,10918,3932.950029,5500,7631,39625,6696,-5350,1373,6727,47367,46321,34275,40998,46352
29161,MO,7608,11710,4553,8320,6298,3699,4798,11915,4047.185092,5500,7835,40604,6991,-5055,1800,7022,46986,47595,35549,42404,47626
29163,MO,7152,11710,4553,8320,6298,3699,4736,11710,4030.865797,5500,8320,40412,6696,-5350,1373,6727,46468,47108,35062,41785,47139
29165,MO,10224,11710,4553,8320,6298,3699,5152,14642,5401.686554,5500,8400,47867,8764,-3282,4365,8795,49956,56631,44585,52232,56662
29167,MO,7152,11710,4553,8320,6298,3699,4736,10665,3851.353555,5500,7925,38793,6381,-5665,945,6412,46468,45174,33128,39738,45205
29169,MO,8880,11710,4553,8320,6298,3699,4970,13037,4455.16746,5500,8105,43677,7582,-4464,2655,7613,48430,51259,39213,46332,51290
29171,MO,7656,11710,4553,8320,6298,3699,4805,11710,3867.67285,5500,8320,40753,6991,-5055,1800,7022,47041,47744,35698,42553,47775
29173,MO,7152,11710,4553,8320,6298,3699,4736,10856,4047.185092,5500,7967,39221,6381,-5665,945,6412,46468,45602,33556,40166,45633
29175,MO,7536,11710,4553,8320,6298,3699,4788,10920,3818.714966,5500,7453,38927,6381,-5665,945,6412,46904,45308,33262,39872,45339
29177,MO,10224,11710,4553,8320,6298,3699,5152,11550,4504.125344,5500,8399,43876,7582,-4464,2655,7613,49956,51458,39412,46531,51489
29179,MO,7152,11710,4553,8320,6298,3699,4736,11710,4389.890281,5500,8320,40771,6696,-5350,1373,6727,46468,47467,35421,42144,47498
29181,MO,7152,11710,4553,8320,6298,3699,4736,11710,4063.504387,5500,8320,40445,6696,-5350,1373,6727,46468,47141,35095,41818,47172
29183,MO,9768,11710,4553,8320,6298,3699,5090,14163,4585.721818,5500,8269,45985,8173,-3873,3510,8204,49438,54158,42112,49495,54189
29185,MO,7152,11710,4553,8320,6298,3699,4736,11710,3965.588618,5500,8320,40347,6696,-5350,1373,6727,46468,47043,34997,41720,47074
29186,MO,7236,11710,4553,8320,6298,3699,4748,11710,4438.848165,5500,8320,40904,6991,-5055,1800,7022,46564,47895,35849,42704,47926
29187,MO,7896,11710,4553,8320,6298,3699,4837,11386,4194.058744,5500,7190,39866,6696,-5350,1373,6727,47313,46562,34516,41239,46593
29189,MO,9768,11710,4553,8320,6298,3699,5090,14195,4667.318291,5500,8264,46094,8173,-3873,3510,8204,49438,54267,42221,49604,54298
29195,MO,7152,11710,4553,8320,6298,3699,4736,10431,3737.118492,5500,7599,38119,5895,-6151,518,5926,46468,44014,31968,38637,44045
29197,MO,7152,11710,4553,8320,6298,3699,4736,9948,3932.950029,5500,7358,37590,5895,-6151,518,5926,46468,43485,31439,38108,43516
29199,MO,7152,11710,4553,8320,6298,3699,4736,11710,4210.378039,5500,8320,40591,6696,-5350,1373,6727,46468,47287,35241,41964,47318
29201,MO,7392,11710,4553,8320,6298,3699,4769,10717,4814.191944,5500,7963,40085,6381,-5665,945,6412,46741,46466,34420,41030,46497
29203,MO,7152,11710,4553,8320,6298,3699,4736,11710,4030.865797,5500,8320,40412,6696,-5350,1373,6727,46468,47108,35062,41785,47139
29205,MO,7152,11710,4553,8320,6298,3699,4736,11710,3883.992145,5500,8320,40265,6696,-5350,1373,6727,46468,46961,34915,41638,46992
29207,MO,7152,11710,4553,8320,6298,3699,4736,11710,4634.679702,5500,8320,41016,6696,-5350,1373,6727,46468,47712,35666,42389,47743
29209,MO,7980,11710,4553,8320,6298,3699,4848,11923,4618.360407,5500,7442,41162,6991,-5055,1800,7022,47408,48153,36107,42962,48184
29211,MO,7536,11710,4553,8320,6298,3699,4788,11710,4194.058744,5500,8320,40959,6991,-5055,1800,7022,46904,47950,35904,42759,47981
29213,MO,7920,11710,4553,8320,6298,3699,4840,12830,4797.872649,5500,7410,42156,6991,-5055,1800,7022,47340,49147,37101,43956,49178
29215,MO,7152,11710,4553,8320,6298,3699,4736,11710,4504.125344,5500,8320,40885,6696,-5350,1373,6727,46468,47581,35535,42258,47612
29217,MO,7500,11710,4553,8320,6298,3699,4783,11710,4504.125344,5500,8320,41233,6991,-5055,1800,7022,46863,48224,36178,43033,48255
29219,MO,9768,11710,4553,8320,6298,3699,5090,12550,3900.311439,5500,8276,43694,7878,-4168,3083,7909,49438,51572,39526,46777,51603
29221,MO,7152,11710,4553,8320,6298,3699,4736,11710,4602.041113,5500,8320,40983,6696,-5350,1373,6727,46468,47679,35633,42356,47710
29223,MO,7152,11710,4553,8320,6298,3699,4736,11710,4145.10086,5500,8320,40526,6696,-5350,1373,6727,46468,47222,35176,41899,47253
29225,MO,7800,11710,4553,8320,6298,3699,4824,10835,4455.16746,5500,7919,40207,6696,-5350,1373,6727,47204,46903,34857,41580,46934
29227,MO,7152,11710,4553,8320,6298,3699,4736,11710,4471.486755,5500,8320,40852,6696,-5350,1373,6727,46468,47548,35502,42225,47579
29229,MO,7152,11710,4553,8320,6298,3699,4736,11710,4096.142976,5500,8320,40477,6696,-5350,1373,6727,46468,47173,35127,41850,47204
29510,MO,9768,11710,4553,8320,6298,3699,5090,13836,4471.486755,5500,8253,45527,8173,-3873,3510,8204,49438,53700,41654,49037,53731
30001,MT,7644,14216,5319,7382,5316,3971,4940,14216,5490.681012,5925,7382,44629,7872,-4073,3178,8004,48788,52501,40556,47807,52633
30003,MT,7644,14216,5319,7382,5316,3971,4940,14216,5338.162095,5925,7382,44476,7872,-4073,3178,8004,48788,52348,40403,47654,52480
30005,MT,7644,14216,5319,7382,5316,3971,4940,14216,5547.875606,5925,7382,44686,7872,-4073,3178,8004,48788,52558,40613,47864,52690
30007,MT,7872,14216,5319,7382,5316,3971,4971,14216,5452.551283,5925,7382,44819,7872,-4073,3178,8004,49047,52691,40746,47997,52823
30009,MT,8388,14216,5319,7382,5316,3971,5040,14869,5319.097231,5925,7306,45778,8167,-3778,3605,8299,49632,53945,42000,49383,54077
30011,MT,7644,14216,5319,7382,5316,3971,4940,14216,5547.875606,5925,7382,44686,7872,-4073,3178,8004,48788,52558,40613,47864,52690
30013,MT,7644,14216,5319,7382,5316,3971,4940,15993,5147.513449,5925,7073,45754,8167,-3778,3605,8299,48788,53921,41976,49359,54053
30015,MT,7644,14216,5319,7382,5316,3971,4940,14216,5223.772908,5925,7382,44362,7872,-4073,3178,8004,48788,52234,40289,47540,52366
30017,MT,7644,14216,5319,7382,5316,3971,4940,14216,5376.291825,5925,7382,44514,7872,-4073,3178,8004,48788,52386,40441,47692,52518
30019,MT,7644,14216,5319,7382,5316,3971,4940,14216,6043.562087,5925,7382,45182,7872,-4073,3178,8004,48788,53054,41109,48360,53186
30021,MT,7644,14216,5319,7382,5316,3971,4940,14216,5833.848576,5925,7382,44972,7872,-4073,3178,8004,48788,52844,40899,48150,52976
30023,MT,7644,14216,5319,7382,5316,3971,4940,14216,5547.875606,5925,7382,44686,7872,-4073,3178,8004,48788,52558,40613,47864,52690
30025,MT,7644,14216,5319,7382,5316,3971,4940,14216,5700.394523,5925,7382,44838,7872,-4073,3178,8004,48788,52710,40765,48016,52842
30027,MT,7644,14216,5319,7382,5316,3971,4940,14216,5376.291825,5925,7382,44514,7872,-4073,3178,8004,48788,52386,40441,47692,52518
30029,MT,8832,14216,5319,7382,5316,3971,5100,17126,5242.837772,5925,7084,48181,9054,-2891,4888,9186,50136,57235,45290,53069,57367
30031,MT,8964,14216,5319,7382,5316,3971,5118,20150,5433.486419,5925,7316,51759,9645,-2300,5743,9777,50286,61404,49459,57502,61536
30033,MT,7644,14216,5319,7382,5316,3971,4940,14216,5319.097231,5925,7382,44457,7872,-4073,3178,8004,48788,52329,40384,47635,52461
30035,MT,7644,14216,5319,7382,5316,3971,4940,14216,5338.162095,5925,7382,44476,7872,-4073,3178,8004,48788,52348,40403,47654,52480
30037,MT,7704,14216,5319,7382,5316,3971,4948,13474,5300.032366,5925,7313,43687,7576,-4369,2750,7708,48856,51263,39318,46437,51395
30039,MT,7680,14216,5319,7382,5316,3971,4945,14216,5547.875606,5925,7382,44722,7872,-4073,3178,8004,48829,52594,40649,47900,52726
30041,MT,7644,14216,5319,7382,5316,3971,4940,14216,5471.616148,5925,7382,44610,7872,-4073,3178,8004,48788,52482,40537,47788,52614
30043,MT,8844,14216,5319,7382,5316,3971,5102,15755,5452.551283,5925,7347,47295,8758,-3187,4460,8890,50150,56053,44108,51755,56185
30045,MT,7644,14216,5319,7382,5316,3971,4940,14216,5300.032366,5925,7382,44438,7872,-4073,3178,8004,48788,52310,40365,47616,52442
30047,MT,7644,14216,5319,7382,5316,3971,4940,14216,6177.016139,5925,7382,45315,7872,-4073,3178,8004,48788,53187,41242,48493,53319
30049,MT,8388,14216,5319,7382,5316,3971,5040,17530,5395.356689,5925,7340,48549,9054,-2891,4888,9186,49632,57603,45658,53437,57735
30051,MT,7644,14216,5319,7382,5316,3971,4940,14216,5204.708043,5925,7382,44343,7872,-4073,3178,8004,48788,52215,40270,47521,52347
30053,MT,7644,14216,5319,7382,5316,3971,4940,14216,5319.097231,5925,7382,44457,7872,-4073,3178,8004,48788,52329,40384,47635,52461
30055,MT,7644,14216,5319,7382,5316,3971,4940,14216,5814.783711,5925,7382,44953,7872,-4073,3178,8004,48788,52825,40880,48131,52957
30057,MT,8364,14216,5319,7382,5316,3971,5037,14216,5509.745877,5925,7382,45368,8167,-3778,3605,8299,49605,53535,41590,48973,53667
30059,MT,7644,14216,5319,7382,5316,3971,4940,14216,5414.421554,5925,7382,44552,7872,-4073,3178,8004,48788,52424,40479,47730,52556
30061,MT,7644,14216,5319,7382,5316,3971,4940,14216,5357.22696,5925,7382,44495,7872,-4073,3178,8004,48788,52367,40422,47673,52499
30063,MT,10140,14216,5319,7382,5316,3971,5277,18370,5509.745877,5925,7160,51075,9645,-2300,5743,9777,51621,60720,48775,56818,60852
30065,MT,7644,14216,5319,7382,5316,3971,4940,14216,5261.902637,5925,7382,44400,7872,-4073,3178,8004,48788,52272,40327,47578,52404
30067,MT,8988,14216,5319,7382,5316,3971,5121,14216,5357.22696,5925,7382,45839,8167,-3778,3605,8299,50313,54006,42061,49444,54138
30069,MT,7644,14216,5319,7382,5316,3971,4940,14216,5261.902637,5925,7382,44400,7872,-4073,3178,8004,48788,52272,40327,47578,52404
30071,MT,7644,14216,5319,7382,5316,3971,4940,14216,5586.005336,5925,7382,44724,7872,-4073,3178,8004,48788,52596,40651,47902,52728
30073,MT,7644,14216,5319,7382,5316,3971,4940,14216,5204.708043,5925,7382,44343,7872,-4073,3178,8004,48788,52215,40270,47521,52347
30075,MT,7644,14216,5319,7382,5316,3971,4940,14216,5605.0702,5925,7382,44743,7872,-4073,3178,8004,48788,52615,40670,47921,52747
30077,MT,7644,14216,5319,7382,5316,3971,4940,14216,5433.486419,5925,7382,44571,7872,-4073,3178,8004,48788,52443,40498,47749,52575
30079,MT,7644,14216,5319,7382,5316,3971,4940,14216,5814.783711,5925,7382,44953,7872,-4073,3178,8004,48788,52825,40880,48131,52957
30081,MT,8244,14216,5319,7382,5316,3971,5021,14216,6482.053973,5925,7382,46220,8167,-3778,3605,8299,49469,54387,42442,49825,54519
30083,MT,7644,14216,5319,7382,5316,3971,4940,14216,6081.691816,5925,7382,45220,7872,-4073,3178,8004,48788,53092,41147,48398,53224
30085,MT,7644,14216,5319,7382,5316,3971,4940,14216,6253.275598,5925,7382,45391,7872,-4073,3178,8004,48788,53263,41318,48569,53395
30087,MT,7644,14216,5319,7382,5316,3971,4940,14216,5338.162095,5925,7382,44476,7872,-4073,3178,8004,48788,52348,40403,47654,52480
30089,MT,7644,14216,5319,7382,5316,3971,4940,14216,5357.22696,5925,7382,44495,7872,-4073,3178,8004,48788,52367,40422,47673,52499
30091,MT,7644,14216,5319,7382,5316,3971,4940,14216,6272.340462,5925,7382,45410,7872,-4073,3178,8004,48788,53282,41337,48588,53414
30093,MT,7644,14216,5319,7382,5316,3971,4940,13158,5776.653982,5925,6550,43024,7281,-4664,2323,7413,48788,50305,38360,45347,50437
30095,MT,7644,14216,5319,7382,5316,3971,4940,14216,5319.097231,5925,7382,44457,7872,-4073,3178,8004,48788,52329,40384,47635,52461
30097,MT,7704,14216,5319,7382,5316,3971,4948,14216,5338.162095,5925,7382,44536,7872,-4073,3178,8004,48856,52408,40463,47714,52540
30099,MT,7644,14216,5319,7382,5316,3971,4940,14216,5376.291825,5925,7382,44514,7872,-4073,3178,8004,48788,52386,40441,47692,52518
30101,MT,7644,14216,5319,7382,5316,3971,4940,14216,5204.708043,5925,7382,44343,7872,-4073,3178,8004,48788,52215,40270,47521,52347
30103,MT,7644,14216,5319,7382,5316,3971,4940,14216,5261.902637,5925,7382,44400,7872,-4073,3178,8004,48788,52272,40327,47578,52404
30105,MT,7644,14216,5319,7382,5316,3971,4940,14216,6043.562087,5925,7382,45182,7872,-4073,3178,8004,48788,53054,41109,48360,53186
30107,MT,7644,14216,5319,7382,5316,3971,4940,14216,5338.162095,5925,7382,44476,7872,-4073,3178,8004,48788,52348,40403,47654,52480
30109,MT,7644,14216,5319,7382,5316,3971,4940,14216,6100.75668,5925,7382,45239,7872,-4073,3178,8004,48788,53111,41166,48417,53243
30111,MT,8388,14216,5319,7382,5316,3971,5040,17063,5242.837772,5925,7296,47886,8758,-3187,4460,8890,49632,56644,44699,52346,56776
31001,NE,7044,11250,4553,8320,6320,3699,5498,9811,4324.613102,5932,8126,38937,6082,-5995,615,6082,46684,45019,32942,39552,45019
31003,NE,7044,11250,4553,8320,6320,3699,5498,11250,4389.890281,5932,8320,40635,6386,-5691,1032,6386,46684,47021,34944,41667,47021
31005,NE,7080,11250,4553,8320,6320,3699,5504,11250,4618.360407,5932,8320,40899,6386,-5691,1032,6386,46726,47285,35208,41931,47285
31007,NE,7044,11250,4553,8320,6320,3699,5498,10639,4618.360407,5932,8095,40027,6082,-5995,615,6082,46684,46109,34032,40642,46109
31009,NE,7080,11250,4553,8320,6320,3699,5504,11250,4357.251692,5932,8320,40638,6386,-5691,1032,6386,46726,47024,34947,41670,47024
31011,NE,7044,11250,4553,8320,6320,3699,5498,11250,4291.974513,5932,8320,40537,6386,-5691,1032,6386,46684,46923,34846,41569,46923
31013,NE,7044,11250,4553,8320,6320,3699,5498,11250,4618.360407,5932,8320,40863,6386,-5691,1032,6386,46684,47249,35172,41895,47249
31015,NE,7044,11250,4553,8320,6320,3699,5498,11250,4373.570986,5932,8320,40619,6386,-5691,1032,6386,46684,47005,34928,41651,47005
31017,NE,7044,11250,4553,8320,6320,3699,5498,11250,4243.016629,5932,8320,40488,6386,-5691,1032,6386,46684,46874,34797,41520,46874
31019,NE,7764,11250,4553,8320,6320,3699,5607,9789,4602.041113,5932,8474,40260,6386,-5691,1032,6386,47513,46646,34569,41292,46646
31021,NE,7044,11250,4553,8320,6320,3699,5498,11250,4389.890281,5932,8320,40635,6386,-5691,1032,6386,46684,47021,34944,41667,47021
31023,NE,7044,11250,4553,8320,6320,3699,5498,11250,4553.083228,5932,8320,40798,6386,-5691,1032,6386,46684,47184,35107,41830,47184
31025,NE,9480,11250,4553,8320,6320,3699,5864,9789,4683.637586,5932,8515,42098,6669,-5408,1447,6669,49486,48767,36690,43545,48767
31027,NE,7044,11250,4553,8320,6320,3699,5498,11250,4357.251692,5932,8320,40602,6386,-5691,1032,6386,46684,46988,34911,41634,46988
31029,NE,7044,11250,4553,8320,6320,3699,5498,11250,4553.083228,5932,8320,40798,6386,-5691,1032,6386,46684,47184,35107,41830,47184
31031,NE,7548,11250,4553,8320,6320,3699,5574,11250,4471.486755,5932,8320,41220,6669,-5408,1447,6669,47264,47889,35812,42667,47889
31033,NE,7044,11250,4553,8320,6320,3699,5498,11250,4683.637586,5932,8320,40929,6386,-5691,1032,6386,46684,47315,35238,41961,47315
31035,NE,7044,11250,4553,8320,6320,3699,5498,11250,4243.016629,5932,8320,40488,6386,-5691,1032,6386,46684,46874,34797,41520,46874
31037,NE,7044,11250,4553,8320,6320,3699,5498,11250,4373.570986,5932,8320,40619,6386,-5691,1032,6386,46684,47005,34928,41651,47005
31039,NE,7164,11250,4553,8320,6320,3699,5516,11250,4373.570986,5932,8320,40739,6386,-5691,1032,6386,46822,47125,35048,41771,47125
31041,NE,7044,11250,4553,8320,6320,3699,5498,11250,4357.251692,5932,8320,40602,6386,-5691,1032,6386,46684,46988,34911,41634,46988
31043,NE,8352,11250,4553,8320,6320,3699,5695,9891,4145.10086,5932,8370,40389,6386,-5691,1032,6386,48189,46775,34698,41421,46775
31045,NE,7044,11250,4553,8320,6320,3699,5498,11250,4602.041113,5932,8320,40847,6386,-5691,1032,6386,46684,47233,35156,41879,47233
31047,NE,7212,11250,4553,8320,6320,3699,5524,10904,4194.058744,5932,8370,40311,6386,-5691,1032,6386,46878,46697,34620,41343,46697
31049,NE,7044,11250,4553,8320,6320,3699,5498,11250,4699.956881,5932,8320,40945,6386,-5691,1032,6386,46684,47331,35254,41977,47331
31051,NE,8352,11250,4553,8320,6320,3699,5695,12419,4324.613102,5932,8359,43086,7237,-4840,2279,7237,48189,50323,38246,45365,50323
31053,NE,7848,11250,4553,8320,6320,3699,5619,9812,4324.613102,5932,8089,39705,6082,-5995,615,6082,47609,45787,33710,40320,45787
31055,NE,9480,11250,4553,8320,6320,3699,5864,9374,4422.528871,5932,8535,41443,6669,-5408,1447,6669,49486,48112,36035,42890,48112
31057,NE,7044,11250,4553,8320,6320,3699,5498,11250,4406.209576,5932,8320,40651,6386,-5691,1032,6386,46684,47037,34960,41683,47037
31059,NE,7044,11250,4553,8320,6320,3699,5498,11250,4373.570986,5932,8320,40619,6386,-5691,1032,6386,46684,47005,34928,41651,47005
31061,NE,7044,11250,4553,8320,6320,3699,5498,11250,4504.125344,5932,8320,40749,6386,-5691,1032,6386,46684,47135,35058,41781,47135
31063,NE,7872,11250,4553,8320,6320,3699,5623,11250,4389.890281,5932,8320,41463,6669,-5408,1447,6669,47637,48132,36055,42910,48132
31065,NE,7044,11250,4553,8320,6320,3699,5498,11250,4471.486755,5932,8320,40716,6386,-5691,1032,6386,46684,47102,35025,41748,47102
31067,NE,7320,11250,4553,8320,6320,3699,5540,9685,4357.251692,5932,8070,39064,6082,-5995,615,6082,47002,45146,33069,39679,45146
31069,NE,7044,11250,4553,8320,6320,3699,5498,11250,4618.360407,5932,8320,40863,6386,-5691,1032,6386,46684,47249,35172,41895,47249
31071,NE,7044,11250,4553,8320,6320,3699,5498,11250,4259.335923,5932,8320,40504,6386,-5691,1032,6386,46684,46890,34813,41536,46890
31073,NE,7272,11250,4553,8320,6320,3699,5533,9349,4487.80605,5932,8365,39104,6082,-5995,615,6082,46947,45186,33109,39719,45186
31075,NE,7044,11250,4553,8320,6320,3699,5498,11250,4602.041113,5932,8320,40847,6386,-5691,1032,6386,46684,47233,35156,41879,47233
31077,NE,7044,11250,4553,8320,6320,3699,5498,11250,4504.125344,5932,8320,40749,6386,-5691,1032,6386,46684,47135,35058,41781,47135
31079,NE,7644,11250,4553,8320,6320,3699,5589,9530,4194.058744,5932,8390,39389,6082,-5995,615,6082,47375,45471,33394,40004,45471
31081,NE,7044,11250,4553,8320,6320,3699,5498,10238,4243.016629,5932,8379,39535,6082,-5995,615,6082,46684,45617,33540,40150,45617
31083,NE,7044,11250,4553,8320,6320,3699,5498,11250,4520.444639,5932,8320,40765,6386,-5691,1032,6386,46684,47151,35074,41797,47151
31085,NE,7080,11250,4553,8320,6320,3699,5504,11250,4536.763934,5932,8320,40818,6386,-5691,1032,6386,46726,47204,35127,41850,47204
31087,NE,7044,11250,4553,8320,6320,3699,5498,11250,4406.209576,5932,8320,40651,6386,-5691,1032,6386,46684,47037,34960,41683,47037
31089,NE,7044,11250,4553,8320,6320,3699,5498,11250,4455.16746,5932,8320,40700,6386,-5691,1032,6386,46684,47086,35009,41732,47086
31091,NE,7080,11250,4553,8320,6320,3699,5504,11250,4585.721818,5932,8320,40867,6386,-5691,1032,6386,46726,47253,35176,41899,47253
31093,NE,7044,11250,4553,8320,6320,3699,5498,10370,4324.613102,5932,8378,39747,6082,-5995,615,6082,46684,45829,33752,40362,45829
31095,NE,7044,11250,4553,8320,6320,3699,5498,11250,4308.293808,5932,8320,40553,6386,-5691,1032,6386,46684,46939,34862,41585,46939
31097,NE,7044,11250,4553,8320,6320,3699,5498,11250,4569.402523,5932,8320,40814,6386,-5691,1032,6386,46684,47200,35123,41846,47200
31099,NE,7044,11250,4553,8320,6320,3699,5498,9917,4520.444639,5932,8454,39567,6082,-5995,615,6082,46684,45649,33572,40182,45649
31101,NE,7044,11250,4553,8320,6320,3699,5498,11250,4585.721818,5932,8320,40831,6386,-5691,1032,6386,46684,47217,35140,41863,47217
31103,NE,7044,11250,4553,8320,6320,3699,5498,11250,4243.016629,5932,8320,40488,6386,-5691,1032,6386,46684,46874,34797,41520,46874
31105,NE,7308,11250,4553,8320,6320,3699,5538,11250,4699.956881,5932,8320,41209,6669,-5408,1447,6669,46988,47878,35801,42656,47878
31107,NE,7044,11250,4553,8320,6320,3699,5498,11250,4487.80605,5932,8320,40733,6386,-5691,1032,6386,46684,47119,35042,41765,47119
31109,NE,8400,11250,4553,8320,6320,3699,5702,11624,4650.998997,5932,8330,42637,6954,-5123,1864,6954,48244,49591,37514,44501,49591
31111,NE,7536,11250,4553,8320,6320,3699,5572,10138,4487.80605,5932,8006,39798,6082,-5995,615,6082,47250,45880,33803,40413,45880
31113,NE,8544,11250,4553,8320,6320,3699,5724,9454,4373.570986,5932,8072,40075,6386,-5691,1032,6386,48410,46461,34384,41107,46461
31115,NE,7044,11250,4553,8320,6320,3699,5498,11250,4324.613102,5932,8320,40570,6386,-5691,1032,6386,46684,46956,34879,41602,46956
31117,NE,7080,11250,4553,8320,6320,3699,5504,9853,4585.721818,5932,8076,39226,6082,-5995,615,6082,46726,45308,33231,39841,45308
31119,NE,7164,11250,4553,8320,6320,3699,5516,9618,4389.890281,5932,8240,39042,6082,-5995,615,6082,46822,45124,33047,39657,45124
31121,NE,7044,11250,4553,8320,6320,3699,5498,9592,4275.655218,5932,8380,38922,6082,-5995,615,6082,46684,45004,32927,39537,45004
31123,NE,7044,11250,4553,8320,6320,3699,5498,11250,4650.998997,5932,8320,40896,6386,-5691,1032,6386,46684,47282,35205,41928,47282
31125,NE,7044,11250,4553,8320,6320,3699,5498,11250,4438.848165,5932,8320,40684,6386,-5691,1032,6386,46684,47070,34993,41716,47070
31127,NE,7044,11250,4553,8320,6320,3699,5498,11250,4210.378039,5932,8320,40455,6386,-5691,1032,6386,46684,46841,34764,41487,46841
31129,NE,7044,11250,4553,8320,6320,3699,5498,11250,4291.974513,5932,8320,40537,6386,-5691,1032,6386,46684,46923,34846,41569,46923
31131,NE,7164,11250,4553,8320,6320,3699,5516,11250,4422.528871,5932,8320,40788,6386,-5691,1032,6386,46822,47174,35097,41820,47174
31133,NE,7044,11250,4553,8320,6320,3699,5498,11250,4340.932397,5932,8320,40586,6386,-5691,1032,6386,46684,46972,34895,41618,46972
31135,NE,7044,11250,4553,8320,6320,3699,5498,11250,4585.721818,5932,8320,40831,6386,-5691,1032,6386,46684,47217,35140,41863,47217
31137,NE,7044,11250,4553,8320,6320,3699,5498,11250,4487.80605,5932,8320,40733,6386,-5691,1032,6386,46684,47119,35042,41765,47119
31139,NE,7044,11250,4553,8320,6320,3699,5498,10349,4373.570986,5932,8252,39650,6082,-5995,615,6082,46684,45732,33655,40265,45732
31141,NE,7044,11250,4553,8320,6320,3699,5498,13132,4455.16746,5932,8443,42705,6954,-5123,1864,6954,46684,49659,37582,44569,49659
31143,NE,7044,11250,4553,8320,6320,3699,5498,11250,4455.16746,5932,8320,40700,6386,-5691,1032,6386,46684,47086,35009,41732,47086
31145,NE,7044,11250,4553,8320,6320,3699,5498,11250,4275.655218,5932,8320,40521,6386,-5691,1032,6386,46684,46907,34830,41553,46907
31147,NE,7044,11250,4553,8320,6320,3699,5498,11250,4373.570986,5932,8320,40619,6386,-5691,1032,6386,46684,47005,34928,41651,47005
31149,NE,7092,11250,4553,8320,6320,3699,5506,11250,4210.378039,5932,8320,40503,6386,-5691,1032,6386,46740,46889,34812,41535,46889
31151,NE,8292,11250,4553,8320,6320,3699,5686,11250,4569.402523,5932,8320,42062,6954,-5123,1864,6954,48120,49016,36939,43926,49016
31153,NE,9480,11250,4553,8320,6320,3699,5864,9733,4471.486755,5932,8525,41840,6669,-5408,1447,6669,49486,48509,36432,43287,48509
31155,NE,8796,11250,4553,8320,6320,3699,5762,9706,4667.318291,5932,8510,41311,6669,-5408,1447,6669,48700,47980,35903,42758,47980
31157,NE,7560,11250,4553,8320,6320,3699,5576,10164,4504.125344,5932,8033,39892,6082,-5995,615,6082,47278,45974,33897,40507,45974
31159,NE,7044,11250,4553,8320,6320,3699,5498,10067,4602.041113,5932,8329,39673,6082,-5995,615,6082,46684,45755,33678,40288,45755
31161,NE,7044,11250,4553,8320,6320,3699,5498,11250,4748.914765,5932,8320,40994,6386,-5691,1032,6386,46684,47380,35303,42026,47380
31163,NE,7044,11250,4553,8320,6320,3699,5498,11250,4340.932397,5932,8320,40586,6386,-5691,1032,6386,46684,46972,34895,41618,46972
31165,NE,7044,11250,4553,8320,6320,3699,5498,12949,4618.360407,5932,8096,42339,6954,-5123,1864,6954,46684,49293,37216,44203,49293
31167,NE,7044,11250,4553,8320,6320,3699,5498,13739,4406.209576,5932,8250,43070,7237,-4840,2279,7237,46684,50307,38230,45349,50307
31169,NE,7044,11250,4553,8320,6320,3699,5498,11250,4243.016629,5932,8320,40488,6386,-5691,1032,6386,46684,46874,34797,41520,46874
31171,NE,7188,11250,4553,8320,6320,3699,5520,11250,4438.848165,5932,8320,40828,6386,-5691,1032,6386,46850,47214,35137,41860,47214
31173,NE,7044,11250,4553,8320,6320,3699,5498,11250,4291.974513,5932,8320,40537,6386,-5691,1032,6386,46684,46923,34846,41569,46923
31175,NE,7044,11250,4553,8320,6320,3699,5498,11250,4324.613102,5932,8320,40570,6386,-5691,1032,6386,46684,46956,34879,41602,46956
31177,NE,9480,11250,4553,8320,6320,3699,5864,9666,4487.80605,5932,8515,41779,6669,-5408,1447,6669,49486,48448,36371,43226,48448
31179,NE,7044,11250,4553,8320,6320,3699,5498,11250,4340.932397,5932,8320,40586,6386,-5691,1032,6386,46684,46972,34895,41618,46972
31181,NE,7044,11250,4553,8320,6320,3699,5498,11250,4324.613102,5932,8320,40570,6386,-5691,1032,6386,46684,46956,34879,41602,46956
31183,NE,7044,11250,4553,8320,6320,3699,5498,11250,4389.890281,5932,8320,40635,6386,-5691,1032,6386,46684,47021,34944,41667,47021
31185,NE,7200,11250,4553,8320,6320,3699,5522,11250,4243.016629,5932,8320,40644,6386,-5691,1032,6386,46864,47030,34953,41676,47030
32001,NV,9780,9716,5319,7382,6401,3971,4710,11237,5852.91344,4905,7241,42986,2520,-5836,1151,6241,47279,45506,37150,44137,49227
32003,NV,12456,9716,5319,7382,6401,3971,5018,11429,5433.486419,4905,7526,45721,3236,-5120,2263,6957,50263,48957,40601,47984,52678
32005,NV,11688,9716,5319,7382,6401,3971,4929,12824,5376.291825,4905,7446,46210,3475,-4881,2634,7196,49406,49685,41329,48844,53406
32007,NV,10560,9716,5319,7382,6401,3971,4799,8948,5852.91344,4905,8139,42377,2281,-6075,780,6002,48148,44658,36302,43157,48379
32009,NV,7644,9716,5319,7382,6401,3971,4464,9716,6577.378296,4905,7382,40195,1356,-7000,-331,5077,44897,41551,33195,39864,45272
32011,NV,9936,9716,5319,7382,6401,3971,4728,11035,5662.264794,4905,8059,43569,2759,-5597,1522,6480,47453,46328,37972,45091,50049
32013,NV,8328,9716,5319,7382,6401,3971,4542,9864,5280.967502,4905,7493,39841,1785,-6571,39,5506,45659,41626,33270,39880,45347
32015,NV,9036,9716,5319,7382,6401,3971,4624,9716,5700.394523,4905,7382,40710,2043,-6313,410,5764,46449,42753,34397,41120,46474
32017,NV,9384,9716,5319,7382,6401,3971,4664,9716,5395.356689,4905,7382,40753,2043,-6313,410,5764,46837,42796,34440,41163,46517
32019,NV,9420,9716,5319,7382,6401,3971,4668,11173,5338.162095,4905,7053,41860,2281,-6075,780,6002,46877,44141,35785,42640,47862
32021,NV,10668,9716,5319,7382,6401,3971,4812,9716,5586.005336,4905,7382,42228,2281,-6075,780,6002,48269,44509,36153,43008,48230
32023,NV,9816,9716,5319,7382,6401,3971,4714,9416,5280.967502,4905,6402,39791,1785,-6571,39,5506,47319,41576,33220,39830,45297
32027,NV,7644,9716,5319,7382,6401,3971,4464,9716,5509.745877,4905,7382,39128,1356,-7000,-331,5077,44897,40484,32128,38797,44205
32029,NV,11052,9716,5319,7382,6401,3971,4856,11183,5528.810742,4905,7376,44016,2759,-5597,1522,6480,48697,46775,38419,45538,50496
32031,NV,11052,9716,5319,7382,6401,3971,4856,11291,5509.745877,4905,7375,44103,2759,-5597,1522,6480,48697,46862,38506,45625,50583
32033,NV,9120,9716,5319,7382,6401,3971,4634,9716,5185.643178,4905,7382,40280,2043,-6313,410,5764,46543,42323,33967,40690,46044
32510,NV,10428,9716,5319,7382,6401,3971,4784,10183,6138.88641,4905,7127,42752,2281,-6075,780,6002,48001,45033,36677,43532,48754
33001,NH,11352,7670,5176,6855,6438,3644,6931,6735,5881.082414,4923,6842,39377,2712,-5996,673,6081,48066,42089,33381,40050,45458
33003,NH,12156,7670,5176,6855,6438,3644,7064,7670,6660.279453,4923,6855,41908,3496,-5212,1511,6865,49003,45404,36696,43419,48773
33005,NH,11664,7670,5176,6855,6438,3644,6982,6904,5658.454689,4923,6766,39559,3182,-5526,1084,6551,48429,42741,34033,40643,46110
33007,NH,7884,7670,5176,6855,6438,3644,6358,6900,5769.768551,4923,6241,35361,844,-7864,-961,4213,44025,36205,27497,34400,39574
33009,NH,12192,7670,5176,6855,6438,3644,7070,8313,6010.948587,4923,6714,41797,3496,-5212,1511,6865,49045,45293,36585,43308,48662
33011,NH,13414,7670,5176,6855,6438,3644,7271,6507,5565.693136,4923,7416,41470,3790,-4917,1938,7160,50468,45260,36553,43408,48630
33013,NH,12024,7670,5176,6855,6438,3644,7042,6634,5695.55931,4923,7248,40168,3182,-5526,1084,6551,48849,43350,34642,41252,46719
33015,NH,13506,7670,5176,6855,6438,3644,7287,6751,5732.66393,4923,7417,41974,3790,-4917,1938,7160,50576,45764,37057,43912,49134
33017,NH,12780,7670,5176,6855,6438,3644,7167,8828,5621.350068,4923,7435,43232,4086,-4622,2365,7455,49730,47318,38610,45597,50687
33019,NH,11004,7670,5176,6855,6438,3644,6873,9483,5287.40848,4923,6714,41055,3496,-5212,1511,6865,47660,44551,35843,42566,47920
34001,NJ,13668,6903,5176,6855,6330,3644,5792,7075,5491.483895,6075,6920,42874,5801,-6174,813,5903,48368,48675,36700,43687,48777
34003,NJ,16824,6903,5176,6855,6330,3644,6211,9040,6140.81476,6075,7482,49206,7160,-4815,2964,7262,51943,56366,44391,52170,56468
34005,NJ,13620,6903,5176,6855,6330,3644,5786,8626,5231.751548,6075,7233,44430,6254,-5721,1530,6356,48314,50684,38709,45960,50786
34007,NJ,13620,6903,5176,6855,6330,3644,5786,6144,5584.245447,6075,7252,42319,5574,-6401,454,5676,48314,47893,35918,42773,47995
34009,NJ,12300,6903,5176,6855,6330,3644,5611,7113,6289.233244,6075,6529,41951,5348,-6627,96,5450,46819,47299,35324,42047,47401
34011,NJ,12852,6903,5176,6855,6330,3644,5684,6892,4990.571512,6075,6840,41293,5574,-6401,454,5676,47444,46867,34892,41747,46969
34013,NJ,15180,6903,5176,6855,6330,3644,5993,6353,6456.204038,6075,7528,45237,6027,-5948,1171,6129,50081,51264,39289,46408,51366
34015,NJ,13620,6903,5176,6855,6330,3644,5786,6178,5157.542306,6075,7230,41905,5574,-6401,454,5676,48314,47479,35504,42359,47581
34017,NJ,15492,6903,5176,6855,6330,3644,6034,6156,5510.036205,6075,7699,44576,6254,-5721,1530,6356,50434,50830,38855,46106,50932
34019,NJ,17496,6903,5176,6855,6330,3644,6300,7945,6567.517901,6075,7372,49100,6933,-5042,2605,7035,52704,56033,44058,51705,56135
34021,NJ,14700,6903,5176,6855,6330,3644,5929,6226,5621.350068,6075,7488,43755,6027,-5948,1171,6129,49537,49782,37807,44926,49884
34023,NJ,17496,6903,5176,6855,6330,3644,6300,7233,5361.617721,6075,7432,47242,6933,-5042,2605,7035,52704,54175,42200,49847,54277
34025,NJ,16140,6903,5176,6855,6330,3644,6120,7112,5658.454689,6075,7403,46033,6480,-5495,1888,6582,51168,52513,40538,47921,52615
34027,NJ,15180,6903,5176,6855,6330,3644,5993,6572,5955.291656,6075,7400,44826,6254,-5721,1530,6356,50081,51080,39105,46356,51182
34029,NJ,16140,6903,5176,6855,6330,3644,6120,6181,5454.379274,6075,7385,44880,6254,-5721,1530,6356,51168,51134,39159,46410,51236
34031,NJ,16824,6903,5176,6855,6330,3644,6211,6151,5380.170032,6075,7474,45549,6480,-5495,1888,6582,51943,52029,40054,47437,52131
34033,NJ,13620,6903,5176,6855,6330,3644,5786,9098,6029.500898,6075,7217,45684,6254,-5721,1530,6356,48314,51938,39963,47214,52040
34035,NJ,17496,6903,5176,6855,6330,3644,6300,5979,5881.082414,6075,7402,46478,6480,-5495,1888,6582,52704,52958,40983,48366,53060
34037,NJ,15180,6903,5176,6855,6330,3644,5993,6328,6215.024002,6075,7371,44813,6027,-5948,1171,6129,50081,50840,38865,45984,50942
34039,NJ,15180,6903,5176,6855,6330,3644,5993,6088,5287.40848,6075,7470,43744,6027,-5948,1171,6129,50081,49771,37796,44915,49873
34041,NJ,14052,6903,5176,6855,6330,3644,5843,6415,6066.605519,6075,6902,43154,5801,-6174,813,5903,48803,48955,36980,43967,49057
35001,NM,9624,20608,5319,7382,5842,3971,5604,25432,5147.513449,3609,7238,55022,10926,-875,7696,11202,58350,65948,54147,62718,66224
35003,NM,7644,20608,5319,7382,5842,3971,5312,20608,5300.032366,3609,7382,48514,9267,-2534,5245,9543,56078,57781,45980,53759,58057
35005,NM,7740,20608,5319,7382,5842,3971,5327,24199,5033.124261,3609,6781,51333,9820,-1981,6062,10096,56189,61153,49352,57395,61429
35006,NM,7644,20608,5319,7382,5842,3971,5312,20961,4994.994532,3609,6855,48035,9267,-2534,5245,9543,56078,57302,45501,53280,57578
35007,NM,8136,20608,5319,7382,5842,3971,5385,20608,6005.432357,3609,7382,49711,9543,-2258,5653,9819,56643,59254,47453,55364,59530
35009,NM,8028,20608,5319,7382,5842,3971,5369,22253,5490.681012,3609,6954,50305,9820,-1981,6062,10096,56519,60125,48324,56367,60401
35011,NM,7644,20608,5319,7382,5842,3971,5312,20608,5280.967502,3609,7382,48495,9267,-2534,5245,9543,56078,57762,45961,53740,58038
35013,NM,8832,20608,5319,7382,5842,3971,5487,20069,5223.772908,3609,6906,48611,9267,-2534,5245,9543,57441,57878,46077,53856,58154
35015,NM,8844,20608,5319,7382,5842,3971,5489,23720,5605.0702,3609,7360,53109,10373,-1428,6879,10649,57455,63482,51681,59988,63758
35017,NM,7644,20608,5319,7382,5842,3971,5312,24846,5471.616148,3609,6365,51907,9820,-1981,6062,10096,56078,61727,49926,57969,62003
35019,NM,7644,20608,5319,7382,5842,3971,5312,20608,5223.772908,3609,7382,48438,9267,-2534,5245,9543,56078,57705,45904,53683,57981
35021,NM,7644,20608,5319,7382,5842,3971,5312,20608,5833.848576,3609,7382,49048,9267,-2534,5245,9543,56078,58315,46514,54293,58591
35023,NM,7644,20608,5319,7382,5842,3971,5312,20608,5319.097231,3609,7382,48533,9267,-2534,5245,9543,56078,57800,45999,53778,58076
35025,NM,9492,20608,5319,7382,5842,3971,5585,21657,5605.0702,3609,7559,51893,9820,-1981,6062,10096,58199,61713,49912,57955,61989
35027,NM,10668,20608,5319,7382,5842,3971,5758,20608,5414.421554,3609,7382,51652,9820,-1981,6062,10096,59548,61472,49671,57714,61748
35028,NM,13104,20608,5319,7382,5842,3971,6116,23901,5547.875606,3609,8971,59103,12032,800,9330,12308,62342,71135,59903,68433,71411
35029,NM,7644,20608,5319,7382,5842,3971,5312,20229,5204.708043,3609,6390,47048,8990,-2811,4836,9266,56078,56038,44237,51884,56314
35031,NM,7644,20608,5319,7382,5842,3971,5312,23172,5014.059397,3609,7145,50555,9820,-1981,6062,10096,56078,60375,48574,56617,60651
35033,NM,8028,20608,5319,7382,5842,3971,5369,20608,5624.135065,3609,7382,49222,9267,-2534,5245,9543,56519,58489,46688,54467,58765
35035,NM,7644,20608,5319,7382,5842,3971,5312,22997,5452.551283,3609,6658,50332,9820,-1981,6062,10096,56078,60152,48351,56394,60428
35037,NM,8112,20608,5319,7382,5842,3971,5381,20608,5242.837772,3609,7382,48925,9543,-2258,5653,9819,56615,58468,46667,54578,58744
35039,NM,8880,20608,5319,7382,5842,3971,5494,23744,5300.032366,3609,7062,52566,10373,-1428,6879,10649,57496,62939,51138,59445,63215
35041,NM,8532,20608,5319,7382,5842,3971,5443,24502,5128.448585,3609,6863,52606,10373,-1428,6879,10649,57097,62979,51178,59485,63255
35043,NM,9624,20608,5319,7382,5842,3971,5604,20707,5586.005336,3609,7259,50756,9820,-1981,6062,10096,58350,60576,48775,56818,60852
35045,NM,8820,20608,5319,7382,5842,3971,5486,21647,5128.448585,3609,7534,50710,9820,-1981,6062,10096,57428,60530,48729,56772,60806
35047,NM,7908,20608,5319,7382,5842,3971,5351,25408,5509.745877,3609,6098,52503,10373,-1428,6879,10649,56381,62876,51075,59382,63152
35049,NM,11484,20608,5319,7382,5842,3971,5878,21062,5490.681012,3609,7101,52718,10373,-1428,6879,10649,60484,63091,51290,59597,63367
35051,NM,8004,20608,5319,7382,5842,3971,5365,20608,4975.929668,3609,7382,48550,9267,-2534,5245,9543,56491,57817,46016,53795,58093
35053,NM,7644,20608,5319,7382,5842,3971,5312,20608,5185.643178,3609,7382,48400,9267,-2534,5245,9543,56078,57667,45866,53645,57943
35055,NM,10824,20608,5319,7382,5842,3971,5781,22243,6501.118838,3609,6372,53520,10373,-1428,6879,10649,59727,63893,52092,60399,64169
35057,NM,9624,20608,5319,7382,5842,3971,5604,22173,5223.772908,3609,7260,51860,9820,-1981,6062,10096,58350,61680,49879,57922,61956
35059,NM,8004,20608,5319,7382,5842,3971,5365,20608,5376.291825,3609,7382,48950,9267,-2534,5245,9543,56491,58217,46416,54195,58493
35061,NM,9624,20608,5319,7382,5842,3971,5604,20703,5109.38372,3609,7260,50276,9820,-1981,6062,10096,58350,60096,48295,56338,60372
36001,NY,11148,6545,5176,6855,6070,3644,6900,6962,5973.843966,6735,7116,41579,6081,-5996,727,6081,46338,47660,35583,42306,47660
36003,NY,7644,6545,5176,6855,6070,3644,6338,6545,5751.216241,6735,6855,37174,4470,-7607,-821,4470,42272,41644,29567,36353,41644
36005,NY,17280,6545,5176,6855,6070,3644,7882,7055,5806.873172,6735,7815,48335,7911,-4166,3481,7911,53452,56246,44169,51816,56246
36007,NY,8304,6545,5176,6855,6070,3644,6444,7037,5027.676133,6735,6552,37300,4904,-7173,-446,4904,43038,42204,30127,36854,42204
36009,NY,7944,6545,5176,6855,6070,3644,6386,7258,4749.391476,6735,6432,36762,4904,-7173,-446,4904,42620,41666,29589,36316,41666
36011,NY,8952,6545,5176,6855,6070,3644,6548,6836,4897.80996,6735,6672,37737,5348,-6729,-60,5348,43790,43085,31008,37677,43085
36013,NY,7644,6545,5176,6855,6070,3644,6338,7138,4786.496097,6735,6348,36296,4470,-7607,-821,4470,42272,40766,28689,35475,40766
36015,NY,9444,6545,5176,6855,6070,3644,6627,8199,4600.972993,6735,6495,39118,5800,-6277,333,5800,44361,44918,32841,39451,44918
36017,NY,7644,6545,5176,6855,6070,3644,6338,6545,5547.140826,6735,6855,36970,4470,-7607,-821,4470,42272,41440,29363,36149,41440
36019,NY,9768,6545,5176,6855,6070,3644,6679,7335,5064.780754,6735,6508,39055,5800,-6277,333,5800,44737,44855,32778,39388,44855
36021,NY,10752,6545,5176,6855,6070,3644,6836,7304,5176.094617,6735,6722,40333,6081,-5996,727,6081,45878,46414,34337,41060,46414
36023,NY,8988,6545,5176,6855,6070,3644,6554,8220,4916.36227,6735,6680,39183,5800,-6277,333,5800,43832,44983,32906,39516,44983
36025,NY,8004,6545,5176,6855,6070,3644,6396,6545,6344.890175,6735,6855,38128,4470,-7607,-821,4470,42690,42598,30521,37307,42598
36027,NY,15096,6545,5176,6855,6070,3644,7532,6668,5751.216241,6735,7372,45266,7127,-4950,2301,7127,50918,52393,40316,47567,52393
36029,NY,8520,6545,5176,6855,6070,3644,6479,7701,5120.437685,6735,6595,38316,5348,-6729,-60,5348,43289,43664,31587,38256,43664
36031,NY,9804,6545,5176,6855,6070,3644,6684,6545,4972.019202,6735,6855,38555,5348,-6729,-60,5348,44778,43903,31826,38495,43903
36033,NY,8592,6545,5176,6855,6070,3644,6490,8696,4452.554509,6735,6320,38440,5800,-6277,333,5800,43372,44240,32163,38773,44240
36035,NY,8496,6545,5176,6855,6070,3644,6475,7670,4916.36227,6735,6415,37876,5348,-6729,-60,5348,43261,43224,31147,37816,43224
36037,NY,9180,6545,5176,6855,6070,3644,6584,7737,4842.153029,6735,6768,38906,5800,-6277,333,5800,44054,44706,32629,39239,44706
36039,NY,9372,6545,5176,6855,6070,3644,6615,6545,5881.082414,6735,6855,39032,5348,-6729,-60,5348,44277,44380,32303,38972,44380
36041,NY,7800,6545,5176,6855,6070,3644,6363,6545,5398.722342,6735,6855,36978,4470,-7607,-821,4470,42453,41448,29371,36157,41448
36043,NY,9348,6545,5176,6855,6070,3644,6611,7721,4730.839166,6735,6546,38724,5800,-6277,333,5800,44249,44524,32447,39057,44524
36045,NY,12144,6545,5176,6855,6070,3644,7059,7656,4842.153029,6735,6628,41648,6342,-5735,1120,6342,47493,47990,35913,42768,47990
36047,NY,17280,6545,5176,6855,6070,3644,7882,6970,5806.873172,6735,7887,48323,7911,-4166,3481,7911,53452,56234,44157,51804,56234
36049,NY,7980,6545,5176,6855,6070,3644,6392,6545,5231.751548,6735,6855,36991,4470,-7607,-821,4470,42662,41461,29384,36170,41461
36051,NY,10008,6545,5176,6855,6070,3644,6717,7888,4972.019202,6735,6738,39985,6081,-5996,727,6081,45015,46066,33989,40712,46066
36053,NY,9612,6545,5176,6855,6070,3644,6654,6917,5101.885375,6735,6748,38758,5348,-6729,-60,5348,44556,44106,32029,38698,44106
36055,NY,10008,6545,5176,6855,6070,3644,6717,6549,5120.437685,6735,6714,38771,5348,-6729,-60,5348,45015,44119,32042,38711,44119
36057,NY,8880,6545,5176,6855,6070,3644,6536,7338,4990.571512,6735,6501,38088,5348,-6729,-60,5348,43706,43436,31359,38028,43436
36059,NY,19356,6545,5176,6855,6070,3644,8215,6644,6159.367071,6735,7439,49977,8173,-3904,3875,8173,55861,58150,46073,53852,58150
36061,NY,17280,6545,5176,6855,6070,3644,7882,6879,8107.359669,6735,8394,51039,8173,-3904,3875,8173,53452,59212,47135,54914,59212
36063,NY,8520,6545,5176,6855,6070,3644,6479,6657,4823.600718,6735,6620,36999,4904,-7173,-446,4904,43289,41903,29826,36553,41903
36065,NY,9348,6545,5176,6855,6070,3644,6611,7019,5064.780754,6735,6525,38336,5348,-6729,-60,5348,44249,43684,31607,38276,43684
36067,NY,9612,6545,5176,6855,6070,3644,6654,6710,5064.780754,6735,6728,38493,5348,-6729,-60,5348,44556,43841,31764,38433,43841
36069,NY,10008,6545,5176,6855,6070,3644,6717,6888,4953.466891,6735,6731,38960,5800,-6277,333,5800,45015,44760,32683,39293,44760
36071,NY,15096,6545,5176,6855,6070,3644,7532,6908,5472.931584,6735,7375,45232,7127,-4950,2301,7127,50918,52359,40282,47533,52359
36073,NY,10008,6545,5176,6855,6070,3644,6717,6736,4415.449888,6735,6735,38274,5800,-6277,333,5800,45015,44074,31997,38607,44074
36075,NY,9612,6545,5176,6855,6070,3644,6654,7045,4656.629924,6735,6742,38434,5348,-6729,-60,5348,44556,43782,31705,38374,43782
36077,NY,10128,6545,5176,6855,6070,3644,6736,7440,5213.199238,6735,6533,39693,5800,-6277,333,5800,45154,45493,33416,40026,45493
36079,NY,17280,6545,5176,6855,6070,3644,7882,7128,6697.384074,6735,7357,48842,7911,-4166,3481,7911,53452,56753,44676,52323,56753
36081,NY,17280,6545,5176,6855,6070,3644,7882,8384,5677.006999,6735,7711,49431,8173,-3904,3875,8173,53452,57604,45527,53306,57604
36083,NY,11148,6545,5176,6855,6070,3644,6900,7539,5806.873172,6735,7110,41984,6342,-5735,1120,6342,46338,48326,36249,43104,48326
36085,NY,17280,6545,5176,6855,6070,3644,7882,7333,5918.187035,6735,7520,48430,7911,-4166,3481,7911,53452,56341,44264,51911,56341
36087,NY,17280,6545,5176,6855,6070,3644,7882,6921,5454.379274,6735,7400,47434,7911,-4166,3481,7911,53452,55345,43268,50915,55345
36089,NY,8688,6545,5176,6855,6070,3644,6506,7312,4786.496097,6735,6355,37521,4904,-7173,-446,4904,43484,42425,30348,37075,42425
36091,NY,11148,6545,5176,6855,6070,3644,6900,6915,5955.291656,6735,7106,41503,6081,-5996,727,6081,46338,47584,35507,42230,47584
36093,NY,11148,6545,5176,6855,6070,3644,6900,7931,5528.588515,6735,7116,42102,6342,-5735,1120,6342,46338,48444,36367,43222,48444
36095,NY,11148,6545,5176,6855,6070,3644,6900,8185,5510.036205,6735,7116,42337,6604,-5473,1514,6604,46338,48941,36864,43851,48941
36097,NY,7716,6545,5176,6855,6070,3644,6350,6545,4860.705339,6735,6855,36356,4470,-7607,-821,4470,42356,40826,28749,35535,40826
36099,NY,8520,6545,5176,6855,6070,3644,6479,7995,4359.792957,6735,6529,37783,5348,-6729,-60,5348,43289,43131,31054,37723,43131
36101,NY,8124,6545,5176,6855,6070,3644,6415,6159,4712.286855,6735,6480,35854,4470,-7607,-821,4470,42829,40324,28247,35033,40324
36103,NY,19356,6545,5176,6855,6070,3644,8215,7442,5955.291656,6735,7388,50520,8434,-3643,4268,8434,55861,58954,46877,54788,58954
36105,NY,10884,6545,5176,6855,6070,3644,6857,6545,4656.629924,6735,6855,39320,5800,-6277,333,5800,46031,45120,33043,39653,45120
36107,NY,8304,6545,5176,6855,6070,3644,6444,6469,5769.768551,6735,6577,37498,4470,-7607,-821,4470,43038,41968,29891,36677,41968
36109,NY,13560,6545,5176,6855,6070,3644,7286,6259,5658.454689,6735,6576,42433,6342,-5735,1120,6342,49136,48775,36698,43553,48775
36111,NY,12744,6545,5176,6855,6070,3644,7155,6787,5565.693136,6735,6778,42253,6342,-5735,1120,6342,48189,48595,36518,43373,48595
36113,NY,12180,6545,5176,6855,6070,3644,7065,5710,5472.931584,6735,6664,40406,6081,-5996,727,6081,47535,46487,34410,41133,46487
36115,NY,12180,6545,5176,6855,6070,3644,7065,7249,6344.890175,6735,6672,42825,6342,-5735,1120,6342,47535,49167,37090,43945,49167
36117,NY,10008,6545,5176,6855,6070,3644,6717,6869,4749.391476,6735,6736,38741,5800,-6277,333,5800,45015,44541,32464,39074,44541
36119,NY,17388,6545,5176,6855,6070,3644,7899,7796,5955.291656,6735,7451,48969,8173,-3904,3875,8173,53577,57142,45065,52844,57142
36121,NY,8124,6545,5176,6855,6070,3644,6415,6545,5769.768551,6735,6855,37673,4904,-7173,-446,4904,42829,42577,30500,37227,42577
36123,NY,7908,6545,5176,6855,6070,3644,6381,7214,4174.269852,6735,6736,36410,4904,-7173,-446,4904,42579,41314,29237,35964,41314
37001,NC,8208,10739,4457,8554,6533,3916,6521,9570,4457.081474,7372,8137,41660,5187,-6890,-35,5187,48928,46847,34770,41625,46847
37003,NC,7644,10739,4457,8554,6533,3916,6424,9530,4457.081474,7372,8118,41037,5187,-6890,-35,5187,48267,46224,34147,41002,46224
37005,NC,7644,10739,4457,8554,6533,3916,6424,10739,4409.155866,7372,8554,42634,5365,-6712,275,5365,48267,47999,35922,42909,47999
37007,NC,7644,10739,4457,8554,6533,3916,6424,10739,4329.279854,7372,8554,42554,5365,-6712,275,5365,48267,47919,35842,42829,47919
37009,NC,7644,10739,4457,8554,6533,3916,6424,10739,4441.106271,7372,8554,42666,5365,-6712,275,5365,48267,48031,35954,42941,48031
37011,NC,8436,10739,4457,8554,6533,3916,6561,10739,4441.106271,7372,8554,43458,5542,-6535,584,5542,49196,49000,36923,44042,49000
37013,NC,7644,10739,4457,8554,6533,3916,6424,10149,4520.982283,7372,7925,41527,5187,-6890,-35,5187,48267,46714,34637,41492,46714
37015,NC,7644,10739,4457,8554,6533,3916,6424,10739,4153.552628,7372,8554,42379,5365,-6712,275,5365,48267,47744,35667,42654,47744
37017,NC,7644,10739,4457,8554,6533,3916,6424,10739,4441.106271,7372,8554,42666,5365,-6712,275,5365,48267,48031,35954,42941,48031
37019,NC,9816,10739,4457,8554,6533,3916,6800,10016,4952.312748,7372,8022,44094,5542,-6535,584,5542,50815,49636,37559,44678,49636
37021,NC,8628,10739,4457,8554,6533,3916,6594,9804,4345.255057,7372,7978,42043,5365,-6712,275,5365,49421,47408,35331,42318,47408
37023,NC,7644,10739,4457,8554,6533,3916,6424,9517,3897.949389,7372,8115,40462,5187,-6890,-35,5187,48267,45649,33572,40427,45649
37025,NC,9756,10739,4457,8554,6533,3916,6789,9169,4345.255057,7372,8540,43098,5542,-6535,584,5542,50744,48640,36563,43682,48640
37027,NC,7644,10739,4457,8554,6533,3916,6424,9684,4041.726211,7372,8111,40769,5187,-6890,-35,5187,48267,45956,33879,40734,45956
37029,NC,9684,10739,4457,8554,6533,3916,6777,10466,4696.70951,7372,8387,44521,5720,-6357,894,5720,50660,50241,38164,45415,50241
37031,NC,8292,10739,4457,8554,6533,3916,6536,9557,5144.015177,7372,8020,42301,5187,-6890,-35,5187,49027,47488,35411,42266,47488
37033,NC,7644,10739,4457,8554,6533,3916,6424,10739,3929.899794,7372,8554,42155,5365,-6712,275,5365,48267,47520,35443,42430,47520
37035,NC,7644,10739,4457,8554,6533,3916,6424,9176,4281.354247,7372,8140,40530,5010,-7067,-344,5010,48267,45540,33463,40186,45540
37037,NC,10116,10739,4457,8554,6533,3916,6852,9874,4952.312748,7372,8387,44617,5720,-6357,894,5720,51167,50337,38260,45511,50337
37039,NC,7644,10739,4457,8554,6533,3916,6424,10739,4632.8087,7372,8554,42858,5365,-6712,275,5365,48267,48223,36146,43133,48223
37041,NC,7644,10739,4457,8554,6533,3916,6424,10739,4393.180664,7372,8554,42618,5365,-6712,275,5365,48267,47983,35906,42893,47983
37043,NC,7644,10739,4457,8554,6533,3916,6424,10739,4696.70951,7372,8554,42922,5365,-6712,275,5365,48267,48287,36210,43197,48287
37045,NC,7728,10739,4457,8554,6533,3916,6438,9541,3961.850199,7372,7757,40276,5010,-7067,-344,5010,48365,45286,33209,39932,45286
37047,NC,7644,10739,4457,8554,6533,3916,6424,10739,4313.304652,7372,8554,42538,5365,-6712,275,5365,48267,47903,35826,42813,47903
37049,NC,9480,10739,4457,8554,6533,3916,6742,9506,4728.659915,7372,8159,43161,5365,-6712,275,5365,50421,48526,36449,43436,48526
37051,NC,9792,10739,4457,8554,6533,3916,6796,9412,4361.230259,7372,8339,43193,5542,-6535,584,5542,50787,48735,36658,43777,48735
37053,NC,13560,10739,4457,8554,6533,3916,7448,10476,5128.039975,7372,8764,49217,6430,-5647,2132,6430,55207,55647,43570,51349,55647
37055,NC,11208,10739,4457,8554,6533,3916,7041,9925,5559.37044,7372,8420,46400,5897,-6180,1203,5897,52448,52297,40220,47603,52297
37057,NC,7644,10739,4457,8554,6533,3916,6424,9186,4009.775806,7372,8189,40317,5010,-7067,-344,5010,48267,45327,33250,39973,45327
37059,NC,8316,10739,4457,8554,6533,3916,6540,9298,4489.031878,7372,8194,41585,5187,-6890,-35,5187,49055,46772,34695,41550,46772
37061,NC,7644,10739,4457,8554,6533,3916,6424,10739,4393.180664,7372,8554,42618,5365,-6712,275,5365,48267,47983,35906,42893,47983
37063,NC,10116,10739,4457,8554,6533,3916,6852,9677,4536.957486,7372,8356,43974,5542,-6535,584,5542,51167,49516,37439,44558,49516
37065,NC,8076,10739,4457,8554,6533,3916,6498,9216,4265.379045,7372,7731,40576,5010,-7067,-344,5010,48773,45586,33509,40232,45586
37067,NC,8316,10739,4457,8554,6533,3916,6540,9184,4393.180664,7372,8175,41356,5187,-6890,-35,5187,49055,46543,34466,41321,46543
37069,NC,10272,10739,4457,8554,6533,3916,6879,9684,4217.453437,7372,9063,44524,5720,-6357,894,5720,51350,50244,38167,45418,50244
37071,NC,9756,10739,4457,8554,6533,3916,6789,10523,4153.552628,7372,8540,44260,5720,-6357,894,5720,50744,49980,37903,45154,49980
37073,NC,7644,10739,4457,8554,6533,3916,6424,9967,4552.932688,7372,8762,42214,5365,-6712,275,5365,48267,47579,35502,42489,47579
37075,NC,7644,10739,4457,8554,6533,3916,6424,10739,4664.759105,7372,8554,42890,5365,-6712,275,5365,48267,48255,36178,43165,48255
37077,NC,8784,10739,4457,8554,6533,3916,6621,9787,4249.403842,7372,8433,42541,5365,-6712,275,5365,49604,47906,35829,42816,47906
37079,NC,7644,10739,4457,8554,6533,3916,6424,10739,4089.651818,7372,8554,42315,5365,-6712,275,5365,48267,47680,35603,42590,47680
37081,NC,8508,10739,4457,8554,6533,3916,6573,9837,4473.056676,7372,8172,42277,5365,-6712,275,5365,49280,47642,35565,42552,47642
37083,NC,7644,10739,4457,8554,6533,3916,6424,9148,4201.478235,7372,7255,39537,4813,-7264,-654,4813,48267,44350,32273,38883,44350
37085,NC,8508,10739,4457,8554,6533,3916,6573,9271,4505.007081,7372,8437,42010,5187,-6890,-35,5187,49280,47197,35120,41975,47197
37087,NC,8028,10739,4457,8554,6533,3916,6490,10147,4680.734307,7372,7978,42122,5187,-6890,-35,5187,48717,47309,35232,42087,47309
37089,NC,8628,10739,4457,8554,6533,3916,6594,10296,4393.180664,7372,7977,42582,5365,-6712,275,5365,49421,47947,35870,42857,47947
37091,NC,7644,10739,4457,8554,6533,3916,6424,10739,4153.552628,7372,8554,42379,5365,-6712,275,5365,48267,47744,35667,42654,47744
37093,NC,7956,10739,4457,8554,6533,3916,6478,11041,4520.982283,7372,8351,43157,5542,-6535,584,5542,48633,48699,36622,43741,48699
37095,NC,9588,10739,4457,8554,6533,3916,6760,10739,4824.511129,7372,8554,44994,5720,-6357,894,5720,50547,50714,38637,45888,50714
37097,NC,9288,10739,4457,8554,6533,3916,6708,10987,4473.056676,7372,8538,44574,5720,-6357,894,5720,50195,50294,38217,45468,50294
37099,NC,8112,10739,4457,8554,6533,3916,6505,10648,4600.858295,7372,7585,42233,5365,-6712,275,5365,48816,47598,35521,42508,47598
37101,NC,10272,10739,4457,8554,6533,3916,6879,10241,4616.833498,7372,9074,45491,5897,-6180,1203,5897,51350,51388,39311,46694,51388
37103,NC,8208,10739,4457,8554,6533,3916,6521,10463,4552.932688,7372,8196,42708,5365,-6712,275,5365,48928,48073,35996,42983,48073
37105,NC,8772,10739,4457,8554,6533,3916,6619,10449,4584.883093,7372,8408,43503,5542,-6535,584,5542,49590,49045,36968,44087,49045
37107,NC,7800,10739,4457,8554,6533,3916,6451,10719,3865.998984,7372,7547,41220,5187,-6890,-35,5187,48450,46407,34330,41185,46407
37109,NC,7644,10739,4457,8554,6533,3916,6424,10786,4137.577425,7372,8538,42393,5365,-6712,275,5365,48267,47758,35681,42668,47758
37111,NC,7644,10739,4457,8554,6533,3916,6424,11120,4552.932688,7372,7559,42164,5365,-6712,275,5365,48267,47529,35452,42439,47529
37113,NC,8556,10739,4457,8554,6533,3916,6582,10739,4792.560724,7372,8554,43930,5542,-6535,584,5542,49337,49472,37395,44514,49472
37115,NC,8628,10739,4457,8554,6533,3916,6594,10955,4680.734307,7372,8013,43565,5542,-6535,584,5542,49421,49107,37030,44149,49107
37117,NC,7644,10739,4457,8554,6533,3916,6424,10739,4345.255057,7372,8554,42570,5365,-6712,275,5365,48267,47935,35858,42845,47935
37119,NC,9756,10739,4457,8554,6533,3916,6789,10930,4696.70951,7372,8537,45208,5720,-6357,894,5720,50744,50928,38851,46102,50928
37121,NC,7644,10739,4457,8554,6533,3916,6424,10739,4648.783903,7372,8554,42874,5365,-6712,275,5365,48267,48239,36162,43149,48239
37123,NC,7644,10739,4457,8554,6533,3916,6424,10739,4265.379045,7372,8554,42490,5365,-6712,275,5365,48267,47855,35778,42765,47855
37125,NC,7680,10739,4457,8554,6533,3916,6430,10990,5255.841594,7372,8045,43258,5365,-6712,275,5365,48309,48623,36546,43533,48623
37127,NC,8076,10739,4457,8554,6533,3916,6498,10199,4057.701413,7372,7729,41350,5187,-6890,-35,5187,48773,46537,34460,41315,46537
37129,NC,9816,10739,4457,8554,6533,3916,6800,10955,4776.585522,7372,8236,45072,5720,-6357,894,5720,50815,50792,38715,45966,50792
37131,NC,7644,10739,4457,8554,6533,3916,6424,11861,4680.734307,7372,7327,42801,5365,-6712,275,5365,48267,48166,36089,43076,48166
37133,NC,9084,10739,4457,8554,6533,3916,6673,11406,4457.081474,7372,8590,44825,5720,-6357,894,5720,49956,50545,38468,45719,50545
37135,NC,10116,10739,4457,8554,6533,3916,6852,11979,5511.444833,7372,8364,47258,6075,-6002,1513,6075,51167,53333,41256,48771,53333
37137,NC,7644,10739,4457,8554,6533,3916,6424,11574,4824.511129,7372,8188,43519,5542,-6535,584,5542,48267,49061,36984,44103,49061
37139,NC,8892,10739,4457,8554,6533,3916,6640,10715,4473.056676,7372,8365,43733,5542,-6535,584,5542,49731,49275,37198,44317,49275
37141,NC,7908,10739,4457,8554,6533,3916,6469,11658,5080.114368,7372,8270,44204,5542,-6535,584,5542,48576,49746,37669,44788,49746
37143,NC,8916,10739,4457,8554,6533,3916,6644,13398,4425.131069,7372,8379,46407,6075,-6002,1513,6075,49759,52482,40405,47920,52482
37145,NC,8100,10739,4457,8554,6533,3916,6503,12026,4249.403842,7372,8382,44046,5720,-6357,894,5720,48802,49766,37689,44940,49766
37147,NC,8232,10739,4457,8554,6533,3916,6525,11764,4473.056676,7372,8208,43965,5542,-6535,584,5542,48956,49507,37430,44549,49507
37149,NC,7704,10739,4457,8554,6533,3916,6434,10739,4712.684712,7372,8554,42998,5365,-6712,275,5365,48337,48363,36286,43273,48363
37151,NC,8508,10739,4457,8554,6533,3916,6573,11726,4153.552628,7372,8183,43858,5720,-6357,894,5720,49280,49578,37501,44752,49578
37153,NC,7644,10739,4457,8554,6533,3916,6424,10910,3818.073377,7372,7337,40998,5187,-6890,-35,5187,48267,46185,34108,40963,46185
37155,NC,7644,10739,4457,8554,6533,3916,6424,12885,3850.023782,7372,7621,43288,5542,-6535,584,5542,48267,48830,36753,43872,48830
37157,NC,7644,10739,4457,8554,6533,3916,6424,11609,4393.180664,7372,8180,43114,5542,-6535,584,5542,48267,48656,36579,43698,48656
37159,NC,7980,10739,4457,8554,6533,3916,6482,13361,4025.751008,7372,8540,45194,5897,-6180,1203,5897,48661,51091,39014,46397,51091
37161,NC,7644,10739,4457,8554,6533,3916,6424,13008,3881.974187,7372,7430,43252,5542,-6535,584,5542,48267,48794,36717,43836,48794
37163,NC,7644,10739,4457,8554,6533,3916,6424,10739,4153.552628,7372,8554,42379,5365,-6712,275,5365,48267,47744,35667,42654,47744
37165,NC,7704,10739,4457,8554,6533,3916,6434,12591,4457.081474,7372,7161,43201,5542,-6535,584,5542,48337,48743,36666,43785,48743
37167,NC,7644,10739,4457,8554,6533,3916,6424,12635,4105.62702,7372,8108,43781,5720,-6357,894,5720,48267,49501,37424,44675,49501
37169,NC,8316,10739,4457,8554,6533,3916,6540,12763,4696.70951,7372,8190,45254,5897,-6180,1203,5897,49055,51151,39074,46457,51151
37171,NC,7644,10739,4457,8554,6533,3916,6424,13179,4377.205461,7372,7588,44077,5720,-6357,894,5720,48267,49797,37720,44971,49797
37173,NC,8736,10739,4457,8554,6533,3916,6613,10739,4520.982283,7372,8554,43838,5542,-6535,584,5542,49548,49380,37303,44422,49380
37175,NC,7764,10739,4457,8554,6533,3916,6444,11537,4824.511129,7372,7768,43181,5365,-6712,275,5365,48407,48546,36469,43456,48546
37177,NC,7644,10739,4457,8554,6533,3916,6424,12883,4904.387141,7372,8430,45149,5720,-6357,894,5720,48267,50869,38792,46043,50869
37179,NC,9756,10739,4457,8554,6533,3916,6789,10949,4552.932688,7372,8539,45085,5720,-6357,894,5720,50744,50805,38728,45979,50805
37181,NC,7944,10739,4457,8554,6533,3916,6476,13374,4153.552628,7372,7677,44437,5720,-6357,894,5720,48619,50157,38080,45331,50157
37183,NC,10272,10739,4457,8554,6533,3916,6879,12041,4744.635117,7372,9094,47440,6252,-5825,1822,6252,51350,53692,41615,49262,53692
37185,NC,7644,10739,4457,8554,6533,3916,6424,10739,4217.453437,7372,8554,42442,5365,-6712,275,5365,48267,47807,35730,42717,47807
37187,NC,7644,10739,4457,8554,6533,3916,6424,10739,4425.131069,7372,8554,42650,5365,-6712,275,5365,48267,48015,35938,42925,48015
37189,NC,9684,10739,4457,8554,6533,3916,6777,12839,5399.618416,7372,7399,46610,5897,-6180,1203,5897,50660,52507,40430,47813,52507
37191,NC,8292,10739,4457,8554,6533,3916,6536,11865,4201.478235,7372,8193,43839,5720,-6357,894,5720,49027,49559,37482,44733,49559
37193,NC,7644,10739,4457,8554,6533,3916,6424,10513,4505.007081,7372,7450,41399,5187,-6890,-35,5187,48267,46586,34509,41364,46586
37195,NC,9636,10739,4457,8554,6533,3916,6769,9510,4153.552628,7372,7752,42340,5365,-6712,275,5365,50604,47705,35628,42615,47705
37197,NC,8316,10739,4457,8554,6533,3916,6540,9641,4441.106271,7372,8192,41878,5187,-6890,-35,5187,49055,47065,34988,41843,47065
37199,NC,7644,10739,4457,8554,6533,3916,6424,10739,4441.106271,7372,8554,42666,5365,-6712,275,5365,48267,48031,35954,42941,48031
38001,ND,7644,7261,4553,8320,5671,3699,4641,7261,4846.830533,5776,8320,37547,5299,-6778,-51,5299,41789,42846,30769,37496,42846
38003,ND,8016,7261,4553,8320,5671,3699,4689,7261,4602.041113,5776,8320,37674,5299,-6778,-51,5299,42209,42973,30896,37623,42973
38005,ND,7644,7261,4553,8320,5671,3699,4641,7261,4634.679702,5776,8320,37335,5299,-6778,-51,5299,41789,42634,30557,37284,42634
38007,ND,7740,7261,4553,8320,5671,3699,4654,7261,5222.174312,5776,8320,38018,5299,-6778,-51,5299,41898,43317,31240,37967,43317
38009,ND,7644,7261,4553,8320,5671,3699,4641,7261,4748.914765,5776,8320,37449,5299,-6778,-51,5299,41789,42748,30671,37398,42748
38011,ND,7644,7261,4553,8320,5671,3699,4641,7261,4846.830533,5776,8320,37547,5299,-6778,-51,5299,41789,42846,30769,37496,42846
38013,ND,7644,7261,4553,8320,5671,3699,4641,7261,5107.939249,5776,8320,37808,5299,-6778,-51,5299,41789,43107,31030,37757,43107
38015,ND,8448,7261,4553,8320,5671,3699,4744,6986,4487.80605,5776,8754,38151,5775,-6302,367,5775,42696,43926,31849,38518,43926
38017,ND,8208,7261,4553,8320,5671,3699,4713,8219,4585.721818,5776,8347,38836,5775,-6302,367,5775,42425,44611,32534,39203,44611
38019,ND,7644,7261,4553,8320,5671,3699,4641,7261,4683.637586,5776,8320,37384,5299,-6778,-51,5299,41789,42683,30606,37333,42683
38021,ND,7644,7261,4553,8320,5671,3699,4641,7261,4667.318291,5776,8320,37367,5299,-6778,-51,5299,41789,42666,30589,37316,42666
38023,ND,7644,7261,4553,8320,5671,3699,4641,7261,5401.686554,5776,8320,38102,5299,-6778,-51,5299,41789,43401,31324,38051,43401
38025,ND,7644,7261,4553,8320,5671,3699,4641,7261,5189.535723,5776,8320,37890,5299,-6778,-51,5299,41789,43189,31112,37839,43189
38027,ND,7644,7261,4553,8320,5671,3699,4641,7261,4797.872649,5776,8320,37498,5299,-6778,-51,5299,41789,42797,30720,37447,42797
38029,ND,7644,7261,4553,8320,5671,3699,4641,7261,4520.444639,5776,8320,37220,5299,-6778,-51,5299,41789,42519,30442,37169,42519
38031,ND,7644,7261,4553,8320,5671,3699,4641,7261,4765.23406,5776,8320,37465,5299,-6778,-51,5299,41789,42764,30687,37414,42764
38033,ND,7644,7261,4553,8320,5671,3699,4641,7261,5222.174312,5776,8320,37922,5299,-6778,-51,5299,41789,43221,31144,37871,43221
38035,ND,8700,7261,4553,8320,5671,3699,4776,7067,4536.763934,5776,8144,37923,5299,-6778,-51,5299,42980,43222,31145,37872,43222
38037,ND,7644,7261,4553,8320,5671,3699,4641,7261,4585.721818,5776,8320,37286,5299,-6778,-51,5299,41789,42585,30508,37235,42585
38039,ND,7644,7261,4553,8320,5671,3699,4641,7261,4585.721818,5776,8320,37286,5299,-6778,-51,5299,41789,42585,30508,37235,42585
38041,ND,7644,7261,4553,8320,5671,3699,4641,7261,4814.191944,5776,8320,37514,5299,-6778,-51,5299,41789,42813,30736,37463,42813
38043,ND,7644,7261,4553,8320,5671,3699,4641,7261,4553.083228,5776,8320,37253,5299,-6778,-51,5299,41789,42552,30475,37202,42552
38045,ND,7644,7261,4553,8320,5671,3699,4641,7261,4781.553355,5776,8320,37482,5299,-6778,-51,5299,41789,42781,30704,37431,42781
38047,ND,7644,7261,4553,8320,5671,3699,4641,7261,4553.083228,5776,8320,37253,5299,-6778,-51,5299,41789,42552,30475,37202,42552
38049,ND,7644,7261,4553,8320,5671,3699,4641,7534,4748.914765,5776,8446,37848,5299,-6778,-51,5299,41789,43147,31070,37797,43147
38051,ND,9348,7261,4553,8320,5671,3699,4858,7261,4553.083228,5776,8320,38957,5775,-6302,367,5775,43710,44732,32655,39324,44732
38053,ND,7644,7261,4553,8320,5671,3699,4641,7261,5254.812902,5776,8320,37955,5299,-6778,-51,5299,41789,43254,31177,37904,43254
38055,ND,7644,7261,4553,8320,5671,3699,4641,7261,4585.721818,5776,8320,37286,5299,-6778,-51,5299,41789,42585,30508,37235,42585
38057,ND,7644,7261,4553,8320,5671,3699,4641,7261,4716.276176,5776,8320,37416,5299,-6778,-51,5299,41789,42715,30638,37365,42715
38059,ND,8448,7261,4553,8320,5671,3699,4744,7221,4863.149828,5776,8726,38734,5775,-6302,367,5775,42696,44509,32432,39101,44509
38061,ND,12828,7261,4553,8320,5671,3699,5302,7261,5075.30066,5776,8320,42959,7127,-4950,2037,7127,47634,50086,38009,44996,50086
38063,ND,7644,7261,4553,8320,5671,3699,4641,7261,4553.083228,5776,8320,37253,5299,-6778,-51,5299,41789,42552,30475,37202,42552
38065,ND,7644,7261,4553,8320,5671,3699,4641,9625,4520.444639,5776,8723,39988,6556,-5521,1202,6556,41789,46544,34467,41190,46544
38067,ND,7644,7261,4553,8320,5671,3699,4641,7261,4536.763934,5776,8320,37237,5299,-6778,-51,5299,41789,42536,30459,37186,42536
38069,ND,7644,7261,4553,8320,5671,3699,4641,7261,4748.914765,5776,8320,37449,5299,-6778,-51,5299,41789,42748,30671,37398,42748
38071,ND,7848,7261,4553,8320,5671,3699,4667,7261,4569.402523,5776,8320,37473,5299,-6778,-51,5299,42019,42772,30695,37422,42772
38073,ND,8232,7261,4553,8320,5671,3699,4716,7261,4618.360407,5776,8320,37906,5299,-6778,-51,5299,42452,43205,31128,37855,43205
38075,ND,7644,7261,4553,8320,5671,3699,4641,7817,4765.23406,5776,8447,38148,5299,-6778,-51,5299,41789,43447,31370,38097,43447
38077,ND,7644,7261,4553,8320,5671,3699,4641,7095,4585.721818,5776,8158,36958,4823,-7254,-468,4823,41789,41781,29704,36490,41781
38079,ND,7644,7261,4553,8320,5671,3699,4641,7261,4634.679702,5776,8320,37335,5299,-6778,-51,5299,41789,42634,30557,37284,42634
38081,ND,7644,7261,4553,8320,5671,3699,4641,7261,4585.721818,5776,8320,37286,5299,-6778,-51,5299,41789,42585,30508,37235,42585
38083,ND,7644,7261,4553,8320,5671,3699,4641,7261,4602.041113,5776,8320,37302,5299,-6778,-51,5299,41789,42601,30524,37251,42601
38085,ND,7644,7261,4553,8320,5671,3699,4641,7645,4520.444639,5776,8731,38016,5775,-6302,367,5775,41789,43791,31714,38383,43791
38087,ND,7740,7261,4553,8320,5671,3699,4654,7261,4830.511239,5776,8320,37627,5299,-6778,-51,5299,41898,42926,30849,37576,42926
38089,ND,8904,7261,4553,8320,5671,3699,4802,8344,4814.191944,5776,8841,40378,6556,-5521,1202,6556,43210,46934,34857,41580,46934
38091,ND,7644,7261,4553,8320,5671,3699,4641,7261,4585.721818,5776,8320,37286,5299,-6778,-51,5299,41789,42585,30508,37235,42585
38093,ND,8004,7261,4553,8320,5671,3699,4687,7148,4830.511239,5776,7992,37450,5299,-6778,-51,5299,42195,42749,30672,37399,42749
38095,ND,7644,7261,4553,8320,5671,3699,4641,7261,4618.360407,5776,8320,37318,5299,-6778,-51,5299,41789,42617,30540,37267,42617
38097,ND,7764,7261,4553,8320,5671,3699,4657,7261,4585.721818,5776,8320,37406,5299,-6778,-51,5299,41925,42705,30628,37355,42705
38099,ND,7644,7261,4553,8320,5671,3699,4641,7261,4553.083228,5776,8320,37253,5299,-6778,-51,5299,41789,42552,30475,37202,42552
38101,ND,13392,7261,4553,8320,5671,3699,5374,7424,4765.23406,5776,8483,43539,7412,-4665,2454,7412,48270,50951,38874,45993,50951
38103,ND,7644,7261,4553,8320,5671,3699,4641,7261,4585.721818,5776,8320,37286,5299,-6778,-51,5299,41789,42585,30508,37235,42585
38105,ND,12636,7261,4553,8320,5671,3699,5277,8291,5238.493607,5776,8981,44622,7412,-4665,2454,7412,47417,52034,39957,47076,52034
39001,OH,7368,16568,4553,8320,5455,3699,4486,16568,4096.142976,4828,8320,44879,7447,-4541,2842,7536,50449,52326,40338,47721,52415
39003,OH,7860,16568,4553,8320,5455,3699,4547,15412,4047.185092,4828,7956,43802,7190,-4799,2452,7278,51002,50992,39003,46254,51080
39005,OH,7692,16568,4553,8320,5455,3699,4526,15479,3851.353555,4828,8025,43574,7190,-4799,2452,7278,50813,50764,38775,46026,50852
39007,OH,7416,16568,4553,8320,5455,3699,4492,15328,4194.058744,4828,7784,43250,6931,-5057,2062,7020,50503,50181,38193,45312,50270
39009,OH,8412,16568,4553,8320,5455,3699,4617,17903,4340.932397,4828,7297,46480,7706,-4282,3233,7795,51624,54186,42198,49713,54275
39011,OH,7704,16568,4553,8320,5455,3699,4528,15379,3965.588618,4828,8285,43860,7190,-4799,2452,7278,50827,51050,39061,46312,51138
39013,OH,7368,16568,4553,8320,5455,3699,4486,15028,3965.588618,4828,7707,42595,6931,-5057,2062,7020,50449,49526,37538,44657,49615
39015,OH,7368,16568,4553,8320,5455,3699,4486,16370,4308.293808,4828,8339,44912,7447,-4541,2842,7536,50449,52359,40371,47754,52448
39017,OH,8820,16568,4553,8320,5455,3699,4668,17578,4438.848165,4828,8339,47703,7968,-4020,3627,8057,52083,55671,43683,51330,55760
39019,OH,7944,16568,4553,8320,5455,3699,4558,15059,4781.553355,4828,7999,44311,7190,-4799,2452,7278,51097,51501,39512,46763,51589
39021,OH,7368,16568,4553,8320,5455,3699,4486,15647,4536.763934,4828,8146,44225,7190,-4799,2452,7278,50449,51415,39426,46677,51503
39023,OH,8556,16568,4553,8320,5455,3699,4635,15943,4112.462271,4828,7818,44957,7447,-4541,2842,7536,51786,52404,40416,47799,52493
39025,OH,8820,16568,4553,8320,5455,3699,4668,18097,4373.570986,4828,8337,48155,8232,-3756,4023,8321,52083,56387,44399,52178,56476
39027,OH,7776,16568,4553,8320,5455,3699,4537,16214,3900.311439,4828,8046,44464,7447,-4541,2842,7536,50908,51911,39923,47306,52000
39029,OH,7368,16568,4553,8320,5455,3699,4486,15350,4063.504387,4828,7822,43131,6931,-5057,2062,7020,50449,50062,38074,45193,50151
39031,OH,7368,16568,4553,8320,5455,3699,4486,15353,3720.799197,4828,7814,42783,6931,-5057,2062,7020,50449,49714,37726,44845,49803
39033,OH,7488,16568,4553,8320,5455,3699,4501,14788,4308.293808,4828,7689,42800,6931,-5057,2062,7020,50584,49731,37743,44862,49820
39035,OH,9000,16568,4553,8320,5455,3699,4691,18801,4585.721818,4828,7983,48897,8232,-3756,4023,8321,52286,57129,45141,52920,57218
39037,OH,7368,16568,4553,8320,5455,3699,4486,14281,3835.03426,4828,7933,41944,6673,-5315,1672,6762,50449,48617,36629,43616,48706
39039,OH,7368,16568,4553,8320,5455,3699,4486,15018,3786.076376,4828,8109,42809,6931,-5057,2062,7020,50449,49740,37752,44871,49829
39041,OH,9672,16568,4553,8320,5455,3699,4776,20209,4618.360407,4828,8336,51362,8759,-3229,4814,8848,53043,60121,48133,56176,60210
39043,OH,9552,16568,4553,8320,5455,3699,4760,16440,3932.950029,4828,7920,46372,7706,-4282,3233,7795,52907,54078,42090,49605,54167
39045,OH,9672,16568,4553,8320,5455,3699,4776,17018,4357.251692,4828,8337,47912,8232,-3756,4023,8321,53043,56144,44156,51935,56233
39047,OH,8412,16568,4553,8320,5455,3699,4617,15077,3786.076376,4828,7489,43291,7190,-4799,2452,7278,51624,50481,38492,45743,50569
39049,OH,9672,16568,4553,8320,5455,3699,4776,19871,4520.444639,4828,8339,50929,8759,-3229,4814,8848,53043,59688,47700,55743,59777
39051,OH,8124,16568,4553,8320,5455,3699,4581,15869,4487.80605,4828,7938,44946,7447,-4541,2842,7536,51300,52393,40405,47788,52482
39053,OH,7368,16568,4553,8320,5455,3699,4486,16885,3769.757082,4828,7461,44010,7190,-4799,2452,7278,50449,51200,39211,46462,51288
39055,OH,9000,16568,4553,8320,5455,3699,4691,17923,5107.939249,4828,8049,48606,8232,-3756,4023,8321,52286,56838,44850,52629,56927
39057,OH,8544,16568,4553,8320,5455,3699,4634,17765,4308.293808,4828,7894,47039,7968,-4020,3627,8057,51773,55007,43019,50666,55096
39059,OH,7368,16568,4553,8320,5455,3699,4486,15051,3818.714966,4828,7552,42317,6931,-5057,2062,7020,50449,49248,37260,44379,49337
39061,OH,8820,16568,4553,8320,5455,3699,4668,19255,4324.613102,4828,8338,49265,8495,-3493,4418,8584,52083,57760,45772,53683,57849
39063,OH,7548,16568,4553,8320,5455,3699,4508,16762,4520.444639,4828,8106,45464,7447,-4541,2842,7536,50651,52911,40923,48306,53000
39065,OH,7368,16568,4553,8320,5455,3699,4486,16568,4324.613102,4828,8320,45108,7447,-4541,2842,7536,50449,52555,40567,47950,52644
39067,OH,7368,16568,4553,8320,5455,3699,4486,16568,4161.420155,4828,8320,44944,7447,-4541,2842,7536,50449,52391,40403,47786,52480
39069,OH,7488,16568,4553,8320,5455,3699,4501,16568,4357.251692,4828,8320,45260,7447,-4541,2842,7536,50584,52707,40719,48102,52796
39071,OH,7368,16568,4553,8320,5455,3699,4486,16568,4161.420155,4828,8320,44944,7447,-4541,2842,7536,50449,52391,40403,47786,52480
39073,OH,7368,16568,4553,8320,5455,3699,4486,15964,4422.528871,4828,8338,44620,7190,-4799,2452,7278,50449,51810,39821,47072,51898
39075,OH,7368,16568,4553,8320,5455,3699,4486,16568,4602.041113,4828,8320,45385,7447,-4541,2842,7536,50449,52832,40844,48227,52921
39077,OH,7368,16568,4553,8320,5455,3699,4486,16237,3851.353555,4828,8224,44208,7190,-4799,2452,7278,50449,51398,39409,46660,51486
39079,OH,7368,16568,4553,8320,5455,3699,4486,15738,4243.016629,4828,7344,43220,6931,-5057,2062,7020,50449,50151,38163,45282,50240
39081,OH,7368,16568,4553,8320,5455,3699,4486,14152,4079.823681,4828,7665,41792,6673,-5315,1672,6762,50449,48465,36477,43464,48554
39083,OH,7740,16568,4553,8320,5455,3699,4532,15623,4096.142976,4828,8136,44122,7190,-4799,2452,7278,50867,51312,39323,46574,51400
39085,OH,9000,16568,4553,8320,5455,3699,4691,17619,4585.721818,4828,8025,47757,7968,-4020,3627,8057,52286,55725,43737,51384,55814
39087,OH,7716,16568,4553,8320,5455,3699,4529,15180,4063.504387,4828,7780,43267,6931,-5057,2062,7020,50840,50198,38210,45329,50287
39089,OH,9672,16568,4553,8320,5455,3699,4776,16934,4324.613102,4828,8339,47797,8232,-3756,4023,8321,53043,56029,44041,51820,56118
39091,OH,7572,16568,4553,8320,5455,3699,4511,15557,3900.311439,4828,7992,43548,7190,-4799,2452,7278,50678,50738,38749,46000,50826
39093,OH,9000,16568,4553,8320,5455,3699,4691,16983,4373.570986,4828,8030,46913,7968,-4020,3627,8057,52286,54881,42893,50540,54970
39095,OH,8124,16568,4553,8320,5455,3699,4581,17002,4243.016629,4828,7911,45807,7706,-4282,3233,7795,51300,53513,41525,49040,53602
39097,OH,9672,16568,4553,8320,5455,3699,4776,16382,4602.041113,4828,8338,47521,7968,-4020,3627,8057,53043,55489,43501,51148,55578
39099,OH,7644,16568,4553,8320,5455,3699,4520,15424,4243.016629,4828,7713,43551,6931,-5057,2062,7020,50759,50482,38494,45613,50571
39101,OH,8400,16568,4553,8320,5455,3699,4615,15428,3965.588618,4828,7735,44055,7190,-4799,2452,7278,51610,51245,39256,46507,51333
39103,OH,9000,16568,4553,8320,5455,3699,4691,17596,4569.402523,4828,8034,47726,7968,-4020,3627,8057,52286,55694,43706,51353,55783
39105,OH,7368,16568,4553,8320,5455,3699,4486,16568,4536.763934,4828,8320,45320,7447,-4541,2842,7536,50449,52767,40779,48162,52856
39107,OH,7368,16568,4553,8320,5455,3699,4486,15233,3704.479903,4828,8352,43185,7190,-4799,2452,7278,50449,50375,38386,45637,50463
39109,OH,8544,16568,4553,8320,5455,3699,4634,15746,4128.781566,4828,7913,44859,7447,-4541,2842,7536,51773,52306,40318,47701,52395
39111,OH,7368,16568,4553,8320,5455,3699,4486,16568,4210.378039,4828,8320,44993,7447,-4541,2842,7536,50449,52440,40452,47835,52529
39113,OH,8544,16568,4553,8320,5455,3699,4634,17271,4177.73945,4828,7865,46385,7706,-4282,3233,7795,51773,54091,42103,49618,54180
39115,OH,7368,16568,4553,8320,5455,3699,4486,16568,4145.10086,4828,8320,44928,7447,-4541,2842,7536,50449,52375,40387,47770,52464
39117,OH,9672,16568,4553,8320,5455,3699,4776,15781,4487.80605,4828,8338,46806,7706,-4282,3233,7795,53043,54512,42524,50039,54601
39119,OH,7632,16568,4553,8320,5455,3699,4519,15865,4030.865797,4828,7849,43903,7190,-4799,2452,7278,50746,51093,39104,46355,51181
39121,OH,7368,16568,4553,8320,5455,3699,4486,16568,4047.185092,4828,8320,44830,7447,-4541,2842,7536,50449,52277,40289,47672,52366
39123,OH,8124,16568,4553,8320,5455,3699,4581,16554,4765.23406,4828,8021,45991,7447,-4541,2842,7536,51300,53438,41450,48833,53527
39125,OH,7368,16568,4553,8320,5455,3699,4486,16568,4177.73945,4828,8320,44961,7447,-4541,2842,7536,50449,52408,40420,47803,52497
39127,OH,7368,16568,4553,8320,5455,3699,4486,15422,4438.848165,4828,8338,44094,7190,-4799,2452,7278,50449,51284,39295,46546,51372
39129,OH,9672,16568,4553,8320,5455,3699,4776,16371,3916.630734,4828,8337,46823,7968,-4020,3627,8057,53043,54791,42803,50450,54880
39131,OH,7368,16568,4553,8320,5455,3699,4486,16568,4243.016629,4828,8320,45026,7447,-4541,2842,7536,50449,52473,40485,47868,52562
39133,OH,9000,16568,4553,8320,5455,3699,4691,18229,4634.679702,4828,8159,48550,8232,-3756,4023,8321,52286,56782,44794,52573,56871
39135,OH,7896,16568,4553,8320,5455,3699,4552,16568,4243.016629,4828,8320,45554,7447,-4541,2842,7536,51043,53001,41013,48396,53090
39137,OH,7512,16568,4553,8320,5455,3699,4504,16568,4210.378039,4828,8320,45137,7447,-4541,2842,7536,50611,52584,40596,47979,52673
39139,OH,7368,16568,4553,8320,5455,3699,4486,15668,4194.058744,4828,7766,43522,6931,-5057,2062,7020,50449,50453,38465,45584,50542
39141,OH,8424,16568,4553,8320,5455,3699,4618,16097,3932.950029,4828,7761,44741,7447,-4541,2842,7536,51637,52188,40200,47583,52277
39143,OH,7368,16568,4553,8320,5455,3699,4486,15455,3932.950029,4828,8054,43337,6931,-5057,2062,7020,50449,50268,38280,45399,50357
39145,OH,7368,16568,4553,8320,5455,3699,4486,15603,3998.227208,4828,7276,42772,6931,-5057,2062,7020,50449,49703,37715,44834,49792
39147,OH,7368,16568,4553,8320,5455,3699,4486,14739,3998.227208,4828,7958,42591,6931,-5057,2062,7020,50449,49522,37534,44653,49611
39149,OH,7884,16568,4553,8320,5455,3699,4550,16062,3916.630734,4828,8325,44715,7447,-4541,2842,7536,51029,52162,40174,47557,52251
39151,OH,7944,16568,4553,8320,5455,3699,4558,15970,4308.293808,4828,7980,44730,7190,-4799,2452,7278,51097,51920,39931,47182,52008
39153,OH,9000,16568,4553,8320,5455,3699,4691,17389,4487.80605,4828,8148,47551,7968,-4020,3627,8057,52286,55519,43531,51178,55608
39155,OH,7644,16568,4553,8320,5455,3699,4520,15436,4145.10086,4828,7736,43488,6931,-5057,2062,7020,50759,50419,38431,45550,50508
39157,OH,7764,16568,4553,8320,5455,3699,4535,15385,4177.73945,4828,8004,43858,7190,-4799,2452,7278,50894,51048,39059,46310,51136
39159,OH,9600,16568,4553,8320,5455,3699,4766,17766,4079.823681,4828,8339,48311,8232,-3756,4023,8321,52961,56543,44555,52334,56632
39161,OH,7368,16568,4553,8320,5455,3699,4486,14103,4520.444639,4828,8017,42536,6673,-5315,1672,6762,50449,49209,37221,44208,49298
39163,OH,7368,16568,4553,8320,5455,3699,4486,16568,4112.462271,4828,8320,44895,7447,-4541,2842,7536,50449,52342,40354,47737,52431
39165,OH,8820,16568,4553,8320,5455,3699,4668,18572,4340.932397,4828,8339,48598,8232,-3756,4023,8321,52083,56830,44842,52621,56919
39167,OH,7368,16568,4553,8320,5455,3699,4486,15876,4226.697334,4828,7756,43754,7190,-4799,2452,7278,50449,50944,38955,46206,51032
39169,OH,7716,16568,4553,8320,5455,3699,4529,16343,4047.185092,4828,8253,44886,7447,-4541,2842,7536,50840,52333,40345,47728,52422
39171,OH,7368,16568,4553,8320,5455,3699,4486,16568,4308.293808,4828,8320,45091,7447,-4541,2842,7536,50449,52538,40550,47933,52627
39173,OH,8124,16568,4553,8320,5455,3699,4581,17876,4194.058744,4828,7928,46649,7968,-4020,3627,8057,51300,54617,42629,50276,54706
39175,OH,7368,16568,4553,8320,5455,3699,4486,16568,4455.16746,4828,8320,45238,7447,-4541,2842,7536,50449,52685,40697,48080,52774
40001,OK,7200,11506,4457,8554,6871,3916,4572,11506,4329.279854,5488,8554,40993,6646,-5382,1473,6695,47076,47639,35611,42466,47688
40003,OK,7200,11506,4457,8554,6871,3916,4572,11506,4265.379045,5488,8554,40929,6646,-5382,1473,6695,47076,47575,35547,42402,47624
40005,OK,7200,11506,4457,8554,6871,3916,4572,11506,4552.932688,5488,8554,41217,6646,-5382,1473,6695,47076,47863,35835,42690,47912
40007,OK,7200,11506,4457,8554,6871,3916,4572,11506,4441.106271,5488,8554,41105,6646,-5382,1473,6695,47076,47751,35723,42578,47800
40009,OK,8196,11506,4457,8554,6871,3916,4697,11392,4744.635117,5488,8458,42195,6646,-5382,1473,6695,48197,48841,36813,43668,48890
40011,OK,7596,11506,4457,8554,6871,3916,4622,11506,4632.8087,5488,8554,41693,6646,-5382,1473,6695,47522,48339,36311,43166,48388
40013,OK,7224,11506,4457,8554,6871,3916,4575,11748,4568.90789,5488,7805,40750,6389,-5640,1083,6437,47103,47139,35110,41833,47187
40015,OK,7200,11506,4457,8554,6871,3916,4572,11506,4425.131069,5488,8554,41089,6646,-5382,1473,6695,47076,47735,35707,42562,47784
40017,OK,8676,11506,4457,8554,6871,3916,4757,13734,5032.18876,5488,8514,45360,7421,-4607,2644,7470,48737,52781,40753,48004,52830
40019,OK,7428,11506,4457,8554,6871,3916,4601,11425,4185.503032,5488,8257,40700,6389,-5640,1083,6437,47333,47089,35060,41783,47137
40021,OK,7200,11506,4457,8554,6871,3916,4572,12426,4345.255057,5488,7814,41189,6646,-5382,1473,6695,47076,47835,35807,42662,47884
40023,OK,7200,11506,4457,8554,6871,3916,4572,11506,4584.883093,5488,8554,41249,6646,-5382,1473,6695,47076,47895,35867,42722,47944
40025,OK,7200,11506,4457,8554,6871,3916,4572,11506,4552.932688,5488,8554,41217,6646,-5382,1473,6695,47076,47863,35835,42690,47912
40027,OK,8676,11506,4457,8554,6871,3916,4757,14465,4712.684712,5488,8512,45770,7679,-4349,3034,7728,48737,53449,41421,48804,53498
40029,OK,7200,11506,4457,8554,6871,3916,4572,11506,4616.833498,5488,8554,41281,6646,-5382,1473,6695,47076,47927,35899,42754,47976
40031,OK,8760,11506,4457,8554,6871,3916,4768,12551,4361.230259,5488,8326,43402,7163,-4865,2254,7212,48832,50565,38537,45656,50614
40033,OK,7260,11506,4457,8554,6871,3916,4580,10120,4345.255057,5488,8361,39491,6111,-5917,693,6160,47144,45602,33574,40184,45651
40035,OK,7200,11506,4457,8554,6871,3916,4572,11506,4345.255057,5488,8554,41009,6646,-5382,1473,6695,47076,47655,35627,42482,47704
40037,OK,8868,11506,4457,8554,6871,3916,4781,12515,4505.007081,5488,8403,43696,7163,-4865,2254,7212,48953,50859,38831,45950,50908
40039,OK,7200,11506,4457,8554,6871,3916,4572,12147,4744.635117,5488,8387,41883,6646,-5382,1473,6695,47076,48529,36501,43356,48578
40041,OK,7200,11506,4457,8554,6871,3916,4572,11506,4441.106271,5488,8554,41105,6646,-5382,1473,6695,47076,47751,35723,42578,47800
40043,OK,7200,11506,4457,8554,6871,3916,4572,11506,4760.610319,5488,8554,41425,6646,-5382,1473,6695,47076,48071,36043,42898,48120
40045,OK,7200,11506,4457,8554,6871,3916,4572,11506,4696.70951,5488,8554,41361,6646,-5382,1473,6695,47076,48007,35979,42834,48056
40047,OK,7416,11506,4457,8554,6871,3916,4599,10725,4105.62702,5488,8308,39959,6389,-5640,1083,6437,47319,46348,34319,41042,46396
40049,OK,7200,11506,4457,8554,6871,3916,4572,11506,4584.883093,5488,8554,41249,6646,-5382,1473,6695,47076,47895,35867,42722,47944
40051,OK,7200,11506,4457,8554,6871,3916,4572,12385,4552.932688,5488,8512,42054,6646,-5382,1473,6695,47076,48700,36672,43527,48749
40053,OK,7200,11506,4457,8554,6871,3916,4572,11506,4121.602223,5488,8554,40786,6646,-5382,1473,6695,47076,47432,35404,42259,47481
40055,OK,7704,11506,4457,8554,6871,3916,4636,11506,4616.833498,5488,8554,41785,6646,-5382,1473,6695,47644,48431,36403,43258,48480
40057,OK,7200,11506,4457,8554,6871,3916,4572,11506,4664.759105,5488,8554,41329,6646,-5382,1473,6695,47076,47975,35947,42802,48024
40059,OK,7200,11506,4457,8554,6871,3916,4572,11506,4728.659915,5488,8554,41393,6646,-5382,1473,6695,47076,48039,36011,42866,48088
40061,OK,7200,11506,4457,8554,6871,3916,4572,11506,4313.304652,5488,8554,40977,6646,-5382,1473,6695,47076,47623,35595,42450,47672
40063,OK,7200,11506,4457,8554,6871,3916,4572,11506,4552.932688,5488,8554,41217,6646,-5382,1473,6695,47076,47863,35835,42690,47912
40065,OK,7200,11506,4457,8554,6871,3916,4572,10526,4489.031878,5488,8179,39798,6111,-5917,693,6160,47076,45909,33881,40491,45958
40067,OK,7200,11506,4457,8554,6871,3916,4572,11506,4361.230259,5488,8554,41025,6646,-5382,1473,6695,47076,47671,35643,42498,47720
40069,OK,7200,11506,4457,8554,6871,3916,4572,11506,4409.155866,5488,8554,41073,6646,-5382,1473,6695,47076,47719,35691,42546,47768
40071,OK,7632,11506,4457,8554,6871,3916,4626,10174,3961.850199,5488,8062,39234,6111,-5917,693,6160,47562,45345,33317,39927,45394
40073,OK,7920,11506,4457,8554,6871,3916,4663,11506,4505.007081,5488,8554,41889,6646,-5382,1473,6695,47887,48535,36507,43362,48584
40075,OK,7200,11506,4457,8554,6871,3916,4572,11506,4457.081474,5488,8554,41121,6646,-5382,1473,6695,47076,47767,35739,42594,47816
40077,OK,7200,11506,4457,8554,6871,3916,4572,11506,4393.180664,5488,8554,41057,6646,-5382,1473,6695,47076,47703,35675,42530,47752
40079,OK,7200,11506,4457,8554,6871,3916,4572,10604,4281.354247,5488,7842,39332,6111,-5917,693,6160,47076,45443,33415,40025,45492
40081,OK,7200,11506,4457,8554,6871,3916,4572,11865,4520.982283,5488,8514,41504,6646,-5382,1473,6695,47076,48150,36122,42977,48199
40083,OK,8676,11506,4457,8554,6871,3916,4757,13943,4728.659915,5488,8512,45264,7421,-4607,2644,7470,48737,52685,40657,47908,52734
40085,OK,7200,11506,4457,8554,6871,3916,4572,11506,4489.031878,5488,8554,41153,6646,-5382,1473,6695,47076,47799,35771,42626,47848
40087,OK,8676,11506,4457,8554,6871,3916,4757,13644,4632.8087,5488,8514,44870,7421,-4607,2644,7470,48737,52291,40263,47514,52340
40089,OK,7200,11506,4457,8554,6871,3916,4572,11506,4520.982283,5488,8554,41185,6646,-5382,1473,6695,47076,47831,35803,42658,47880
40091,OK,7224,11506,4457,8554,6871,3916,4575,11506,4600.858295,5488,8554,41289,6646,-5382,1473,6695,47103,47935,35907,42762,47984
40093,OK,7200,11506,4457,8554,6871,3916,4572,11506,4329.279854,5488,8554,40993,6646,-5382,1473,6695,47076,47639,35611,42466,47688
40095,OK,7380,11506,4457,8554,6871,3916,4595,11506,4361.230259,5488,8554,41205,6646,-5382,1473,6695,47279,47851,35823,42678,47900
40097,OK,7200,11506,4457,8554,6871,3916,4572,11506,4457.081474,5488,8554,41121,6646,-5382,1473,6695,47076,47767,35739,42594,47816
40099,OK,7428,11506,4457,8554,6871,3916,4601,11506,4425.131069,5488,8554,41317,6646,-5382,1473,6695,47333,47963,35935,42790,48012
40101,OK,7200,11506,4457,8554,6871,3916,4572,11611,4536.957486,5488,7630,40382,6389,-5640,1083,6437,47076,46771,34742,41465,46819
40103,OK,7200,11506,4457,8554,6871,3916,4572,11506,4441.106271,5488,8554,41105,6646,-5382,1473,6695,47076,47751,35723,42578,47800
40105,OK,7248,11506,4457,8554,6871,3916,4578,11506,4441.106271,5488,8554,41153,6646,-5382,1473,6695,47130,47799,35771,42626,47848
40107,OK,7200,11506,4457,8554,6871,3916,4572,11506,4584.883093,5488,8554,41249,6646,-5382,1473,6695,47076,47895,35867,42722,47944
40109,OK,8676,11506,4457,8554,6871,3916,4757,13892,4441.106271,5488,8515,44928,7421,-4607,2644,7470,48737,52349,40321,47572,52398
40111,OK,7260,11506,4457,8554,6871,3916,4580,11400,4409.155866,5488,8399,40872,6389,-5640,1083,6437,47144,47261,35232,41955,47309
40113,OK,8868,11506,4457,8554,6871,3916,4781,12118,4584.883093,5488,8408,43383,7163,-4865,2254,7212,48953,50546,38518,45637,50595
40115,OK,7524,11506,4457,8554,6871,3916,4613,10510,4169.52783,5488,7701,39308,6111,-5917,693,6160,47441,45419,33391,40001,45468
40117,OK,7200,11506,4457,8554,6871,3916,4572,12332,4505.007081,5488,8403,41844,6646,-5382,1473,6695,47076,48490,36462,43317,48539
40119,OK,8436,11506,4457,8554,6871,3916,4727,13966,4920.362344,5488,7643,44370,7163,-4865,2254,7212,48467,51533,39505,46624,51582
40121,OK,7908,11506,4457,8554,6871,3916,4661,10919,4505.007081,5488,7840,40576,6389,-5640,1083,6437,47873,46965,34936,41659,47013
40123,OK,7200,11506,4457,8554,6871,3916,4572,10873,4648.783903,5488,8203,40328,6389,-5640,1083,6437,47076,46717,34688,41411,46765
40125,OK,8712,11506,4457,8554,6871,3916,4762,11489,4840.486331,5488,8170,42615,6905,-5123,1864,6954,48778,49520,37492,44479,49569
40127,OK,7200,11506,4457,8554,6871,3916,4572,11506,4520.982283,5488,8554,41185,6646,-5382,1473,6695,47076,47831,35803,42658,47880
40129,OK,7200,11506,4457,8554,6871,3916,4572,11506,4760.610319,5488,8554,41425,6646,-5382,1473,6695,47076,48071,36043,42898,48120
40131,OK,8868,11506,4457,8554,6871,3916,4781,13455,4632.8087,5488,8401,44761,7421,-4607,2644,7470,48953,52182,40154,47405,52231
40133,OK,7200,11506,4457,8554,6871,3916,4572,11506,4473.056676,5488,8554,41137,6646,-5382,1473,6695,47076,47783,35755,42610,47832
40135,OK,7200,11506,4457,8554,6871,3916,4572,10829,4297.329449,5488,7849,39579,6111,-5917,693,6160,47076,45690,33662,40272,45739
40137,OK,7200,11506,4457,8554,6871,3916,4572,10526,4680.734307,5488,8125,39936,6111,-5917,693,6160,47076,46047,34019,40629,46096
40139,OK,7368,11506,4457,8554,6871,3916,4593,12299,4457.081474,5488,8885,42413,6905,-5123,1864,6954,47265,49318,37290,44277,49367
40141,OK,7200,11506,4457,8554,6871,3916,4572,11506,4345.255057,5488,8554,41009,6646,-5382,1473,6695,47076,47655,35627,42482,47704
40143,OK,8868,11506,4457,8554,6871,3916,4781,14196,4409.155866,5488,8393,45270,7679,-4349,3034,7728,48953,52949,40921,48304,52998
40145,OK,8868,11506,4457,8554,6871,3916,4781,13132,4648.783903,5488,8407,44459,7421,-4607,2644,7470,48953,51880,39852,47103,51929
40147,OK,7872,11506,4457,8554,6871,3916,4657,11617,4185.503032,5488,8164,41242,6646,-5382,1473,6695,47833,47888,35860,42715,47937
40149,OK,7200,11506,4457,8554,6871,3916,4572,11506,4696.70951,5488,8554,41361,6646,-5382,1473,6695,47076,48007,35979,42834,48056
40151,OK,7224,11506,4457,8554,6871,3916,4575,11506,4313.304652,5488,8554,41001,6646,-5382,1473,6695,47103,47647,35619,42474,47696
40153,OK,7200,11506,4457,8554,6871,3916,4572,11762,4680.734307,5488,8623,41670,6646,-5382,1473,6695,47076,48316,36288,43143,48365
41001,OR,7848,7977,5319,7382,6167,3971,6914,7977,5490.681012,4905,7382,37574,6699,-5378,1349,6699,45578,44273,32196,38923,44273
41003,OR,9888,7977,5319,7382,6167,3971,7292,9387,5910.108034,4905,7068,41129,8049,-4028,2695,8049,47996,49178,37101,43824,49178
41005,OR,11064,7977,5319,7382,6167,3971,7510,9890,5757.589117,4905,7417,43004,8682,-3395,3592,8682,49390,51686,39609,46596,51686
41007,OR,9204,7977,5319,7382,6167,3971,7166,8291,5395.356689,4905,6959,38725,7206,-4871,1798,7206,47186,45931,33854,40523,45931
41009,OR,11064,7977,5319,7382,6167,3971,7510,8091,5929.172899,4905,7422,41383,8049,-4028,2695,8049,49390,49432,37355,44078,49432
41011,OR,8292,7977,5319,7382,6167,3971,6997,7454,5662.264794,4905,6501,36786,6192,-5885,901,6192,46105,42978,30901,37687,42978
41013,OR,8136,7977,5319,7382,6167,3971,6968,7772,9551.497178,4905,6530,40865,6192,-5885,901,6192,45920,47057,34980,41766,47057
41015,OR,9588,7977,5319,7382,6167,3971,7237,9337,6062.626951,4905,6369,40233,7713,-4364,2246,7713,47641,47946,35869,42479,47946
41017,OR,9636,7977,5319,7382,6167,3971,7246,8552,5719.459388,4905,7086,39870,7713,-4364,2246,7713,47698,47583,35506,42116,47583
41019,OR,7848,7977,5319,7382,6167,3971,6914,8194,5204.708043,4905,6748,36872,6192,-5885,901,6192,45578,43064,30987,37773,43064
41021,OR,7644,7977,5319,7382,6167,3971,6877,7977,5566.940471,4905,7382,37446,6699,-5378,1349,6699,45337,44145,32068,38795,44145
41023,OR,7644,7977,5319,7382,6167,3971,6877,7977,5280.967502,4905,7382,37160,6699,-5378,1349,6699,45337,43859,31782,38509,43859
41025,OR,7644,7977,5319,7382,6167,3971,6877,7977,5433.486419,4905,7382,37312,6699,-5378,1349,6699,45337,44011,31934,38661,44011
41027,OR,10020,7977,5319,7382,6167,3971,7317,8456,6272.340462,4905,7498,41122,8049,-4028,2695,8049,48153,49171,37094,43817,49171
41029,OR,10008,7977,5319,7382,6167,3971,7315,9057,5319.097231,4905,6873,40133,8049,-4028,2695,8049,48139,48182,36105,42828,48182
41031,OR,7644,7977,5319,7382,6167,3971,6877,7977,5795.718846,4905,7382,37675,6699,-5378,1349,6699,45337,44374,32297,39024,44374
41033,OR,9768,7977,5319,7382,6167,3971,7270,8216,5643.199929,4905,6395,38899,7206,-4871,1798,7206,47854,46105,34028,40697,46105
41035,OR,8304,7977,5319,7382,6167,3971,6999,7770,5795.718846,4905,6565,37311,6192,-5885,901,6192,46119,43503,31426,38212,43503
41037,OR,7644,7977,5319,7382,6167,3971,6877,7977,5433.486419,4905,7382,37312,6699,-5378,1349,6699,45337,44011,31934,38661,44011
41039,OR,10008,7977,5319,7382,6167,3971,7315,8923,5452.551283,4905,6858,40117,7713,-4364,2246,7713,48139,47830,35753,42363,47830
41041,OR,9012,7977,5319,7382,6167,3971,7130,8400,6196.081004,4905,6783,39267,7206,-4871,1798,7206,46958,46473,34396,41065,46473
41043,OR,9024,7977,5319,7382,6167,3971,7132,8256,5242.837772,4905,7107,38505,7206,-4871,1798,7206,46972,45711,33634,40303,45711
41045,OR,7644,7977,5319,7382,6167,3971,6877,7465,4823.410751,4905,6690,35498,5685,-6392,452,5685,45337,41183,29106,35950,41183
41047,OR,9360,7977,5319,7382,6167,3971,7195,8994,5185.643178,4905,7231,39646,7713,-4364,2246,7713,47371,47359,35282,41892,47359
41049,OR,7644,7977,5319,7382,6167,3971,6877,8297,5300.032366,4905,7292,37408,6699,-5378,1349,6699,45337,44107,32030,38757,44107
41051,OR,11064,7977,5319,7382,6167,3971,7510,10405,5833.848576,4905,7422,43601,8998,-3079,4040,8998,49390,52599,40522,47641,52599
41053,OR,9360,7977,5319,7382,6167,3971,7195,8502,5662.264794,4905,7242,39642,7713,-4364,2246,7713,47371,47355,35278,41888,47355
41055,OR,7644,7977,5319,7382,6167,3971,6877,7977,5414.421554,4905,7382,37293,6699,-5378,1349,6699,45337,43992,31915,38642,43992
41057,OR,9108,7977,5319,7382,6167,3971,7148,7977,5967.302628,4905,7382,39310,7206,-4871,1798,7206,47072,46516,34439,41108,46516
41059,OR,8424,7977,5319,7382,6167,3971,7021,7676,5528.810742,4905,7302,37807,6699,-5378,1349,6699,46261,44506,32429,39156,44506
41061,OR,7764,7977,5319,7382,6167,3971,6899,7822,5776.653982,4905,6937,37176,6192,-5885,901,6192,45479,43368,31291,38077,43368
41063,OR,7644,7977,5319,7382,6167,3971,6877,7977,5433.486419,4905,7382,37312,6699,-5378,1349,6699,45337,44011,31934,38661,44011
41065,OR,8760,7977,5319,7382,6167,3971,7083,8354,5910.108034,4905,6842,38741,7206,-4871,1798,7206,46659,45947,33870,40539,45947
41067,OR,11064,7977,5319,7382,6167,3971,7510,10584,5452.551283,4905,7419,43396,8998,-3079,4040,8998,49390,52394,40317,47436,52394
41069,OR,7644,7977,5319,7382,6167,3971,6877,7977,5452.551283,4905,7382,37332,6699,-5378,1349,6699,45337,44031,31954,38681,44031
41071,OR,11064,7977,5319,7382,6167,3971,7510,9092,5528.810742,4905,7414,41975,8365,-3712,3143,8365,49390,50340,38263,45118,50340
42001,PA,9924,14625,5176,6855,5850,3644,5655,14842,6177.919381,5175,7022,46785,7964,-4113,3270,7964,51729,54749,42672,50055,54749
42003,PA,9468,14625,5176,6855,5850,3644,5589,14464,5305.96079,5175,6577,44634,7707,-4370,2881,7707,51207,52341,40264,47515,52341
42005,PA,7644,14625,5176,6855,5850,3644,5323,12879,5380.170032,5175,6623,41345,6935,-5142,1713,6935,49117,48280,36203,43058,48280
42007,PA,9468,14625,5176,6855,5850,3644,5589,13400,4879.25765,5175,6612,43179,7450,-4627,2492,7450,51207,50629,38552,45671,50629
42009,PA,7644,14625,5176,6855,5850,3644,5323,14625,5788.320862,5175,6855,43731,7450,-4627,2492,7450,49117,51181,39104,46223,51181
42011,PA,10308,14625,5176,6855,5850,3644,5711,15496,5268.856169,5175,6908,46799,8222,-3855,3660,8222,52169,55021,42944,50459,55021
42013,PA,8208,14625,5176,6855,5850,3644,5405,13181,5064.780754,5175,6465,41738,6935,-5142,1713,6935,49763,48673,36596,43451,48673
42015,PA,7644,14625,5176,6855,5850,3644,5323,13396,4786.496097,5175,6637,41283,6935,-5142,1713,6935,49117,48218,36141,42996,48218
42017,PA,13620,14625,5176,6855,5850,3644,6195,17755,5732.66393,5175,7238,53165,9765,-2312,5995,9765,55965,62930,50853,59160,62930
42019,PA,9468,14625,5176,6855,5850,3644,5589,14651,5305.96079,5175,6617,44861,7707,-4370,2881,7707,51207,52568,40491,47742,52568
42021,PA,7644,14625,5176,6855,5850,3644,5323,12683,5046.228444,5175,6298,40491,6679,-5398,1325,6679,49117,47170,35093,41816,47170
42023,PA,7644,14625,5176,6855,5850,3644,5323,14625,5120.437685,5175,6855,43063,7450,-4627,2492,7450,49117,50513,38436,45555,50513
42025,PA,11688,14625,5176,6855,5850,3644,5913,14478,4730.839166,5175,6902,46618,8478,-3599,4048,8478,53751,55096,43019,50666,55096
42027,PA,10968,14625,5176,6855,5850,3644,5808,14991,5788.320862,5175,6644,47210,8222,-3855,3660,8222,52926,55432,43355,50870,55432
42029,PA,13620,14625,5176,6855,5850,3644,6195,18148,6400.547107,5175,7230,54218,9765,-2312,5995,9765,55965,63983,51906,60213,63983
42031,PA,7644,14625,5176,6855,5850,3644,5323,14625,4434.002199,5175,6855,42377,7450,-4627,2492,7450,49117,49827,37750,44869,49827
42033,PA,7644,14625,5176,6855,5850,3644,5323,12770,4860.705339,5175,6361,40456,6679,-5398,1325,6679,49117,47135,35058,41781,47135
42035,PA,8688,14625,5176,6855,5850,3644,5475,13422,5287.40848,5175,6440,42656,7193,-4884,2103,7193,50313,49849,37772,44759,49849
42037,PA,8004,14625,5176,6855,5850,3644,5375,13649,5138.989996,5175,6564,42176,7193,-4884,2103,7193,49529,49369,37292,44279,49369
42039,PA,7716,14625,5176,6855,5850,3644,5333,13044,4897.80996,5175,6420,40897,6935,-5142,1713,6935,49199,47832,35755,42610,47832
42041,PA,10140,14625,5176,6855,5850,3644,5687,15239,5510.036205,5175,6818,46527,8222,-3855,3660,8222,51977,54749,42672,50187,54749
42043,PA,10140,14625,5176,6855,5850,3644,5687,15280,5213.199238,5175,6816,46269,8222,-3855,3660,8222,51977,54491,42414,49929,54491
42045,PA,13620,14625,5176,6855,5850,3644,6195,17540,5825.425483,5175,7267,53071,9765,-2312,5995,9765,55965,62836,50759,59066,62836
42047,PA,7644,14625,5176,6855,5850,3644,5323,14625,5361.617721,5175,6855,43305,7450,-4627,2492,7450,49117,50755,38678,45797,50755
42049,PA,7992,14625,5176,6855,5850,3644,5373,13622,5157.542306,5175,6573,42164,7193,-4884,2103,7193,49515,49357,37280,44267,49357
42051,PA,9468,14625,5176,6855,5850,3644,5589,12775,4934.914581,5175,6622,42619,7193,-4884,2103,7193,51207,49812,37735,44722,49812
42053,PA,8340,14625,5176,6855,5850,3644,5424,14625,4712.286855,5175,6855,43351,7450,-4627,2492,7450,49914,50801,38724,45843,50801
42055,PA,8952,14625,5176,6855,5850,3644,5514,14426,5176.094617,5175,6798,44172,7707,-4370,2881,7707,50616,51879,39802,47053,51879
42057,PA,7644,14625,5176,6855,5850,3644,5323,14625,5231.751548,5175,6855,43175,7450,-4627,2492,7450,49117,50625,38548,45667,50625
42059,PA,7644,14625,5176,6855,5850,3644,5323,14625,4638.077614,5175,6855,42581,7450,-4627,2492,7450,49117,50031,37954,45073,50031
42061,PA,7644,14625,5176,6855,5850,3644,5323,12805,5194.646927,5175,6381,40843,6679,-5398,1325,6679,49117,47522,35445,42168,47522
42063,PA,8220,14625,5176,6855,5850,3644,5407,13315,5602.797757,5175,6474,42431,7193,-4884,2103,7193,49777,49624,37547,44534,49624
42065,PA,7644,14625,5176,6855,5850,3644,5323,14625,4341.240646,5175,6855,42284,7450,-4627,2492,7450,49117,49734,37657,44776,49734
42067,PA,7644,14625,5176,6855,5850,3644,5323,14625,5621.350068,5175,6855,43564,7450,-4627,2492,7450,49117,51014,38937,46056,51014
42069,PA,8328,14625,5176,6855,5850,3644,5422,14231,5305.96079,5175,6514,43197,7450,-4627,2492,7450,49900,50647,38570,45689,50647
42071,PA,10776,14625,5176,6855,5850,3644,5780,15443,5435.826963,5175,6967,47441,8478,-3599,4048,8478,52706,55919,43842,51489,55919
42073,PA,8196,14625,5176,6855,5850,3644,5403,12928,4934.914581,5175,6447,41325,6935,-5142,1713,6935,49749,48260,36183,43038,48260
42075,PA,8556,14625,5176,6855,5850,3644,5456,14763,5101.885375,5175,6861,44101,7707,-4370,2881,7707,50162,51808,39731,46982,51808
42077,PA,11688,14625,5176,6855,5850,3644,5913,16219,5380.170032,5175,6905,49011,8736,-3341,4438,8736,53751,57747,45670,53449,57747
42079,PA,8328,14625,5176,6855,5850,3644,5422,13957,5083.333065,5175,6516,42704,7193,-4884,2103,7193,49900,49897,37820,44807,49897
42081,PA,7860,14625,5176,6855,5850,3644,5354,13552,5009.123823,5175,6562,41802,6935,-5142,1713,6935,49364,48737,36660,43515,48737
42083,PA,7644,14625,5176,6855,5850,3644,5323,12278,5491.483895,5175,6312,40545,6679,-5398,1325,6679,49117,47224,35147,41870,47224
42085,PA,7692,14625,5176,6855,5850,3644,5330,13057,4526.763751,5175,6368,40463,6935,-5142,1713,6935,49172,47398,35321,42176,47398
42087,PA,7644,14625,5176,6855,5850,3644,5323,12952,4582.420682,5175,6380,40378,6679,-5398,1325,6679,49117,47057,34980,41703,47057
42089,PA,10452,14625,5176,6855,5850,3644,5732,15402,5157.542306,5175,7026,46856,8222,-3855,3660,8222,52334,55078,43001,50516,55078
42091,PA,13620,14625,5176,6855,5850,3644,6195,18021,5528.588515,5175,7249,53238,9765,-2312,5995,9765,55965,63003,50926,59233,63003
42093,PA,8304,14625,5176,6855,5850,3644,5419,14044,5138.989996,5175,6566,42872,7193,-4884,2103,7193,49873,50065,37988,44975,50065
42095,PA,11688,14625,5176,6855,5850,3644,5913,16140,5435.826963,5175,6903,48986,8736,-3341,4438,8736,53751,57722,45645,53424,57722
42097,PA,7644,14625,5176,6855,5850,3644,5323,13673,5324.5131,5175,6258,41718,6935,-5142,1713,6935,49117,48653,36576,43431,48653
42099,PA,10140,14625,5176,6855,5850,3644,5687,14196,5472.931584,5175,6826,45454,7964,-4113,3270,7964,51977,53418,41341,48724,53418
42101,PA,13620,14625,5176,6855,5850,3644,6195,16875,5324.5131,5175,7330,51968,9251,-2826,5217,9251,55965,61219,49142,57185,61219
42103,PA,13932,14625,5176,6855,5850,3644,6240,14550,5806.873172,5175,7360,50468,8993,-3084,4827,8993,56322,59461,47384,55295,59461
42105,PA,7644,14625,5176,6855,5850,3644,5323,14625,4879.25765,5175,6855,42822,7450,-4627,2492,7450,49117,50272,38195,45314,50272
42107,PA,7644,14625,5176,6855,5850,3644,5323,14058,4953.466891,5175,6416,41891,7193,-4884,2103,7193,49117,49084,37007,43994,49084
42109,PA,7740,14625,5176,6855,5850,3644,5337,13316,4823.600718,5175,6715,41414,6935,-5142,1713,6935,49227,48349,36272,43127,48349
42111,PA,7644,14625,5176,6855,5850,3644,5323,12984,4730.839166,5175,6477,40655,6935,-5142,1713,6935,49117,47590,35513,42368,47590
42113,PA,7644,14625,5176,6855,5850,3644,5323,14625,5176.094617,5175,6855,43119,7450,-4627,2492,7450,49117,50569,38492,45611,50569
42115,PA,8124,14625,5176,6855,5850,3644,5393,14625,6159.367071,5175,6855,44582,7450,-4627,2492,7450,49667,52032,39955,47074,52032
42117,PA,7764,14625,5176,6855,5850,3644,5340,14625,5324.5131,5175,6855,43388,7450,-4627,2492,7450,49254,50838,38761,45880,50838
42119,PA,8316,14625,5176,6855,5850,3644,5421,13837,5732.66393,5175,6325,43029,7193,-4884,2103,7193,49887,50222,38145,45132,50222
42121,PA,7704,14625,5176,6855,5850,3644,5331,12371,4619.525303,5175,6408,39921,6679,-5398,1325,6679,49185,46600,34523,41246,46600
42123,PA,7644,14625,5176,6855,5850,3644,5323,12702,4378.345267,5175,6464,40007,6679,-5398,1325,6679,49117,46686,34609,41332,46686
42125,PA,9468,14625,5176,6855,5850,3644,5589,13782,5547.140826,5175,6612,44229,7450,-4627,2492,7450,51207,51679,39602,46721,51679
42127,PA,8508,14625,5176,6855,5850,3644,5449,14625,5621.350068,5175,6855,44428,7450,-4627,2492,7450,50107,51878,39801,46920,51878
42129,PA,9468,14625,5176,6855,5850,3644,5589,13522,5194.646927,5175,6615,43619,7450,-4627,2492,7450,51207,51069,38992,46111,51069
42131,PA,8328,14625,5176,6855,5850,3644,5422,13656,5398.722342,5175,6552,42754,7193,-4884,2103,7193,49900,49947,37870,44857,49947
42133,PA,10032,14625,5176,6855,5850,3644,5671,15281,5398.722342,5175,6988,46518,8222,-3855,3660,8222,51853,54740,42663,50178,54740
44001,RI,10956,9358,5176,6855,6083,3644,6417,11287,7328.162629,4971,6855,45041,6879,-5198,1789,6879,48489,51920,39843,46830,51920
44003,RI,10956,9358,5176,6855,6083,3644,6417,9651,5472.931584,4971,6855,41550,6615,-5462,1393,6615,48489,48165,36088,42943,48165
44005,RI,12692,9358,5176,6855,6083,3644,6682,10666,5769.768551,4971,6855,44597,7407,-4670,2581,7407,50490,52004,39927,47178,52004
44007,RI,10956,9358,5176,6855,6083,3644,6417,10004,5194.646927,4971,6855,41624,6615,-5462,1393,6615,48489,48239,36162,43017,48239
44009,RI,11098,9358,5176,6855,6083,3644,6438,10171,6567.517901,4971,6855,43307,6615,-5462,1393,6615,48652,49922,37845,44700,49922
45001,SC,7608,8028,4457,8554,6326,3916,5432,7535,4377.205461,5800,7612,36848,4983,-7094,-308,4983,44321,41831,29754,36540,41831
45003,SC,8760,8028,4457,8554,6326,3916,5611,8240,4281.354247,5800,8334,39331,6444,-5633,977,6444,45652,45775,33698,40308,45775
45005,SC,7620,8028,4457,8554,6326,3916,5434,8028,4265.379045,5800,8554,38183,5957,-6120,549,5957,44335,44140,32063,38732,44140
45007,SC,7824,8028,4457,8554,6326,3916,5466,7776,4169.52783,5800,8265,37751,5957,-6120,549,5957,44571,43708,31631,38300,43708
45009,SC,7608,8028,4457,8554,6326,3916,5432,8028,4329.279854,5800,8554,38235,5957,-6120,549,5957,44321,44192,32115,38784,44192
45011,SC,7608,8028,4457,8554,6326,3916,5432,8028,4265.379045,5800,8554,38171,5957,-6120,549,5957,44321,44128,32051,38720,44128
45013,SC,10596,8028,4457,8554,6326,3916,5896,10115,5000.238356,5800,8386,43814,7649,-4428,2691,7649,47773,51463,39386,46505,51463
45015,SC,10752,8028,4457,8554,6326,3916,5920,9102,4536.957486,5800,8532,42639,7353,-4724,2263,7353,47953,49992,37915,44902,49992
45017,SC,9516,8028,4457,8554,6326,3916,5729,8313,4265.379045,5800,8421,40231,6760,-5317,1406,6760,46526,46991,34914,41637,46991
45019,SC,10752,8028,4457,8554,6326,3916,5920,10350,4728.659915,5800,8531,44078,7649,-4428,2691,7649,47953,51727,39650,46769,51727
45021,SC,7608,8028,4457,8554,6326,3916,5432,8389,3770.14777,5800,7603,37086,5470,-6607,120,5470,44321,42556,30479,37206,42556
45023,SC,7608,8028,4457,8554,6326,3916,5432,7372,4409.155866,5800,8538,37644,5470,-6607,120,5470,44321,43114,31037,37764,43114
45025,SC,7608,8028,4457,8554,6326,3916,5432,8028,4249.403842,5800,8554,38155,5957,-6120,549,5957,44321,44112,32035,38704,44112
45027,SC,7608,8028,4457,8554,6326,3916,5432,8028,4233.42864,5800,8554,38139,5957,-6120,549,5957,44321,44096,32019,38688,44096
45029,SC,8496,8028,4457,8554,6326,3916,5570,8028,4441.106271,5800,8554,39235,6444,-5633,977,6444,45347,45679,33602,40212,45679
45031,SC,7884,8028,4457,8554,6326,3916,5475,8088,4345.255057,5800,8112,38146,5957,-6120,549,5957,44640,44103,32026,38695,44103
45033,SC,7608,8028,4457,8554,6326,3916,5432,8028,4281.354247,5800,8554,38187,5957,-6120,549,5957,44321,44144,32067,38736,44144
45035,SC,10752,8028,4457,8554,6326,3916,5920,9003,4473.056676,5800,8531,42475,7353,-4724,2263,7353,47953,49828,37751,44738,49828
45037,SC,8760,8028,4457,8554,6326,3916,5611,8314,4505.007081,5800,8344,39639,6444,-5633,977,6444,45652,46083,34006,40616,46083
45039,SC,9516,8028,4457,8554,6326,3916,5729,7827,4201.478235,5800,8417,39678,6444,-5633,977,6444,46526,46122,34045,40655,46122
45041,SC,7800,8028,4457,8554,6326,3916,5462,8219,4185.503032,5800,8097,38018,5957,-6120,549,5957,44543,43975,31898,38567,43975
45043,SC,8664,8028,4457,8554,6326,3916,5596,9647,4664.759105,5800,7932,40624,6760,-5317,1406,6760,45541,47384,35307,42030,47384
45045,SC,8820,8028,4457,8554,6326,3916,5621,8397,4249.403842,5800,8255,39437,6444,-5633,977,6444,45722,45881,33804,40414,45881
45047,SC,7608,8028,4457,8554,6326,3916,5432,7804,4057.701413,5800,7561,36746,5470,-6607,120,5470,44321,42216,30139,36866,42216
45049,SC,7608,8028,4457,8554,6326,3916,5432,8028,4137.577425,5800,8554,38044,5957,-6120,549,5957,44321,44001,31924,38593,44001
45051,SC,9660,8028,4457,8554,6326,3916,5751,10002,4552.932688,5800,8010,41940,7056,-5021,1834,7056,46692,48996,36919,43774,48996
45053,SC,8808,8028,4457,8554,6326,3916,5619,8780,4712.684712,5800,8400,40417,6760,-5317,1406,6760,45708,47177,35100,41823,47177
45055,SC,7680,8028,4457,8554,6326,3916,5444,8208,4441.106271,5800,8414,38459,5957,-6120,549,5957,44405,44416,32339,39008,44416
45057,SC,7788,8028,4457,8554,6326,3916,5460,7339,4185.503032,5800,8538,37566,5470,-6607,120,5470,44529,43036,30959,37686,43036
45059,SC,7608,8028,4457,8554,6326,3916,5432,8250,3754.172567,5800,8253,37582,5957,-6120,549,5957,44321,43539,31462,38131,43539
45061,SC,7608,8028,4457,8554,6326,3916,5432,8028,4185.503032,5800,8554,38092,5957,-6120,549,5957,44321,44049,31972,38641,44049
45063,SC,9516,8028,4457,8554,6326,3916,5729,8507,4265.379045,5800,8413,40417,6760,-5317,1406,6760,46526,47177,35100,41823,47177
45065,SC,7608,8028,4457,8554,6326,3916,5432,8028,4281.354247,5800,8554,38187,5957,-6120,549,5957,44321,44144,32067,38736,44144
45067,SC,7608,8028,4457,8554,6326,3916,5432,8028,4137.577425,5800,8554,38044,5957,-6120,549,5957,44321,44001,31924,38593,44001
45069,SC,7608,8028,4457,8554,6326,3916,5432,7415,4121.602223,5800,7329,36191,4983,-7094,-308,4983,44321,41174,29097,35883,41174
45071,SC,8460,8028,4457,8554,6326,3916,5565,7928,4169.52783,5800,8167,38440,5957,-6120,549,5957,45306,44397,32320,38989,44397
45073,SC,7608,8028,4457,8554,6326,3916,5432,8046,4009.775806,5800,7911,37290,5470,-6607,120,5470,44321,42760,30683,37410,42760
45075,SC,8088,8028,4457,8554,6326,3916,5507,8582,4313.304652,5800,7537,38236,5957,-6120,549,5957,44876,44193,32116,38785,44193
45077,SC,8820,8028,4457,8554,6326,3916,5621,8265,4520.982283,5800,8259,39582,6444,-5633,977,6444,45722,46026,33949,40559,46026
45079,SC,9516,8028,4457,8554,6326,3916,5729,8628,4281.354247,5800,8410,40551,6760,-5317,1406,6760,46526,47311,35234,41957,47311
45081,SC,9516,8028,4457,8554,6326,3916,5729,8063,4265.379045,5800,8419,39979,6760,-5317,1406,6760,46526,46739,34662,41385,46739
45083,SC,8136,8028,4457,8554,6326,3916,5514,7695,4153.552628,5800,8180,37880,5957,-6120,549,5957,44931,43837,31760,38429,43837
45085,SC,9228,8028,4457,8554,6326,3916,5684,8180,4121.602223,5800,8175,39421,6444,-5633,977,6444,46193,45865,33788,40398,45865
45087,SC,7692,8028,4457,8554,6326,3916,5445,7287,4345.255057,5800,8167,37207,5470,-6607,120,5470,44418,42677,30600,37327,42677
45089,SC,7608,8028,4457,8554,6326,3916,5432,8028,4217.453437,5800,8554,38123,5957,-6120,549,5957,44321,44080,32003,38672,44080
45091,SC,9756,8028,4457,8554,6326,3916,5766,8534,4568.90789,5800,8539,41114,7056,-5021,1834,7056,46803,48170,36093,42948,48170
46003,SD,7776,30324,4553,8320,6758,3699,4202,30324,4634.679702,5860,8320,60614,9129,-1207,7266,9980,65632,69743,59407,67880,70594
46005,SD,7128,30324,4553,8320,6758,3699,4127,29015,4748.914765,5860,7943,58394,8676,-1981,6549,9527,64909,67070,56413,64943,67921
46007,SD,7128,30324,4553,8320,6758,3699,4127,30324,4732.59547,5860,8320,60064,8676,-1981,6549,9527,64909,68740,58083,66613,69591
46009,SD,7128,30324,4553,8320,6758,3699,4127,30324,4797.872649,5860,8320,60129,8676,-1981,6549,9527,64909,68805,58148,66678,69656
46011,SD,7488,30324,4553,8320,6758,3699,4169,34646,4977.384891,5860,8222,64892,10035,340,8700,10886,65311,74927,65232,73592,75778
46013,SD,7476,30324,4553,8320,6758,3699,4167,32319,4814.191944,5860,8194,62362,9582,-434,7983,10433,65297,71944,61928,70345,72795
46015,SD,7128,30324,4553,8320,6758,3699,4127,30324,4650.998997,5860,8320,59982,8676,-1981,6549,9527,64909,68658,58001,66531,69509
46017,SD,8304,30324,4553,8320,6758,3699,4263,30324,4716.276176,5860,8320,61223,9129,-1207,7266,9980,66221,70352,60016,68489,71203
46019,SD,7128,30324,4553,8320,6758,3699,4127,30324,4895.788418,5860,8320,60227,8676,-1981,6549,9527,64909,68903,58246,66776,69754
46021,SD,7128,30324,4553,8320,6758,3699,4127,30324,4422.528871,5860,8320,59754,8676,-1981,6549,9527,64909,68430,57773,66303,69281
46023,SD,7128,30324,4553,8320,6758,3699,4127,30324,4634.679702,5860,8320,59966,8676,-1981,6549,9527,64909,68642,57985,66515,69493
46025,SD,7128,30324,4553,8320,6758,3699,4127,30324,4765.23406,5860,8320,60096,8676,-1981,6549,9527,64909,68772,58115,66645,69623
46027,SD,7800,30324,4553,8320,6758,3699,4205,35308,4536.763934,5860,7488,64691,10035,340,8700,10886,65659,74726,65031,73391,75577
46029,SD,7152,30324,4553,8320,6758,3699,4130,32695,4699.956881,5860,8153,62259,9582,-434,7983,10433,64936,71841,61825,70242,72692
46031,SD,7128,30324,4553,8320,6758,3699,4127,30324,4422.528871,5860,8320,59754,8676,-1981,6549,9527,64909,68430,57773,66303,69281
46033,SD,8460,30324,4553,8320,6758,3699,4281,33333,4879.469123,5860,8235,64467,10035,340,8700,10886,66395,74502,64807,73167,75353
46035,SD,7704,30324,4553,8320,6758,3699,4194,31003,4602.041113,5860,8077,60945,9129,-1207,7266,9980,65552,70074,59738,68211,70925
46037,SD,7128,30324,4553,8320,6758,3699,4127,30324,4716.276176,5860,8320,60047,8676,-1981,6549,9527,64909,68723,58066,66596,69574
46039,SD,7128,30324,4553,8320,6758,3699,4127,30324,4814.191944,5860,8320,60145,8676,-1981,6549,9527,64909,68821,58164,66694,69672
46041,SD,7128,30324,4553,8320,6758,3699,4127,30324,4748.914765,5860,8320,60080,8676,-1981,6549,9527,64909,68756,58099,66629,69607
46043,SD,7128,30324,4553,8320,6758,3699,4127,30324,4683.637586,5860,8320,60015,8676,-1981,6549,9527,64909,68691,58034,66564,69542
46045,SD,7872,30324,4553,8320,6758,3699,4213,28147,4781.553355,5860,8216,58576,8676,-1981,6549,9527,65739,67252,56595,65125,68103
46047,SD,8892,30324,4553,8320,6758,3699,4330,30324,4814.191944,5860,8320,61909,9129,-1207,7266,9980,66876,71038,60702,69175,71889
46049,SD,7128,30324,4553,8320,6758,3699,4127,30324,4699.956881,5860,8320,60031,8676,-1981,6549,9527,64909,68707,58050,66580,69558
46051,SD,7128,30324,4553,8320,6758,3699,4127,30324,4797.872649,5860,8320,60129,8676,-1981,6549,9527,64909,68805,58148,66678,69656
46053,SD,7128,30324,4553,8320,6758,3699,4127,30324,4438.848165,5860,8320,59770,8676,-1981,6549,9527,64909,68446,57789,66319,69297
46055,SD,7128,30324,4553,8320,6758,3699,4127,30324,4797.872649,5860,8320,60129,8676,-1981,6549,9527,64909,68805,58148,66678,69656
46057,SD,7128,30324,4553,8320,6758,3699,4127,30324,4814.191944,5860,8320,60145,8676,-1981,6549,9527,64909,68821,58164,66694,69672
46059,SD,7128,30324,4553,8320,6758,3699,4127,30324,4699.956881,5860,8320,60031,8676,-1981,6549,9527,64909,68707,58050,66580,69558
46061,SD,7200,30324,4553,8320,6758,3699,4136,28284,4650.998997,5860,8117,57811,8223,-2755,5832,9074,64990,66034,55056,63643,66885
46063,SD,7128,30324,4553,8320,6758,3699,4127,30324,5140.577839,5860,8320,60472,8676,-1981,6549,9527,64909,69148,58491,67021,69999
46065,SD,7680,30324,4553,8320,6758,3699,4191,35382,4667.318291,5860,8420,65708,10035,340,8700,10886,65525,75743,66048,74408,76594
46067,SD,7128,30324,4553,8320,6758,3699,4127,30324,4618.360407,5860,8320,59949,8676,-1981,6549,9527,64909,68625,57968,66498,69476
46069,SD,7128,30324,4553,8320,6758,3699,4127,30324,4716.276176,5860,8320,60047,8676,-1981,6549,9527,64909,68723,58066,66596,69574
46071,SD,7128,30324,4553,8320,6758,3699,4127,30324,4814.191944,5860,8320,60145,8676,-1981,6549,9527,64909,68821,58164,66694,69672
46073,SD,7128,30324,4553,8320,6758,3699,4127,30324,4634.679702,5860,8320,59966,8676,-1981,6549,9527,64909,68642,57985,66515,69493
46075,SD,7128,30324,4553,8320,6758,3699,4127,30324,4699.956881,5860,8320,60031,8676,-1981,6549,9527,64909,68707,58050,66580,69558
46077,SD,7128,30324,4553,8320,6758,3699,4127,30324,4748.914765,5860,8320,60080,8676,-1981,6549,9527,64909,68756,58099,66629,69607
46079,SD,7128,30324,4553,8320,6758,3699,4127,30324,4618.360407,5860,8320,59949,8676,-1981,6549,9527,64909,68625,57968,66498,69476
46081,SD,7296,30324,4553,8320,6758,3699,4147,34885,5369.047965,5860,7786,64896,10035,340,8700,10886,65097,74931,65236,73596,75782
46083,SD,9120,30324,4553,8320,6758,3699,4357,38942,5499.602322,5860,8569,71690,11649,2916,11106,12500,67131,83339,74606,82796,84190
46085,SD,7128,30324,4553,8320,6758,3699,4127,30324,4699.956881,5860,8320,60031,8676,-1981,6549,9527,64909,68707,58050,66580,69558
46087,SD,9120,30324,4553,8320,6758,3699,4357,27673,4634.679702,5860,8547,59533,8676,-1981,6549,9527,67131,68209,57552,66082,69060
46089,SD,7128,30324,4553,8320,6758,3699,4127,30324,4863.149828,5860,8320,60194,8676,-1981,6549,9527,64909,68870,58213,66743,69721
46091,SD,7128,30324,4553,8320,6758,3699,4127,30324,4797.872649,5860,8320,60129,8676,-1981,6549,9527,64909,68805,58148,66678,69656
46093,SD,7860,30324,4553,8320,6758,3699,4212,35963,4079.823681,5860,8228,65690,10488,1114,9417,11339,65726,76178,66804,75107,77029
46095,SD,7128,30324,4553,8320,6758,3699,4127,30324,4879.469123,5860,8320,60210,8676,-1981,6549,9527,64909,68886,58229,66759,69737
46097,SD,7128,30324,4553,8320,6758,3699,4127,30324,4765.23406,5860,8320,60096,8676,-1981,6549,9527,64909,68772,58115,66645,69623
46099,SD,9120,30324,4553,8320,6758,3699,4357,34624,4585.721818,5860,8593,66482,10488,1114,9417,11339,67131,76970,67596,75899,77821
46101,SD,7128,30324,4553,8320,6758,3699,4127,30324,4618.360407,5860,8320,59949,8676,-1981,6549,9527,64909,68625,57968,66498,69476
46103,SD,9312,30324,4553,8320,6758,3699,4379,36504,4830.511239,5860,8219,68424,10996,1943,10189,11847,67345,79420,70367,78613,80271
46105,SD,7680,30324,4553,8320,6758,3699,4191,30324,4716.276176,5860,8320,60599,9129,-1207,7266,9980,65525,69728,59392,67865,70579
46107,SD,7128,30324,4553,8320,6758,3699,4127,30324,4699.956881,5860,8320,60031,8676,-1981,6549,9527,64909,68707,58050,66580,69558
46109,SD,7128,30324,4553,8320,6758,3699,4127,30324,4699.956881,5860,8320,60031,8676,-1981,6549,9527,64909,68707,58050,66580,69558
46111,SD,7128,30324,4553,8320,6758,3699,4127,30324,4634.679702,5860,8320,59966,8676,-1981,6549,9527,64909,68642,57985,66515,69493
46113,SD,7128,30324,4553,8320,6758,3699,4127,30324,4814.191944,5860,8320,60145,8676,-1981,6549,9527,64909,68821,58164,66694,69672
46115,SD,7128,30324,4553,8320,6758,3699,4127,30324,4683.637586,5860,8320,60015,8676,-1981,6549,9527,64909,68691,58034,66564,69542
46117,SD,8460,30324,4553,8320,6758,3699,4281,35793,4748.914765,5860,8412,66973,10488,1114,9417,11339,66395,77461,68087,76390,78312
46119,SD,8184,30324,4553,8320,6758,3699,4249,31600,4699.956881,5860,8403,62447,9582,-434,7983,10433,66087,72029,62013,70430,72880
46121,SD,7128,30324,4553,8320,6758,3699,4127,30324,4618.360407,5860,8320,59949,8676,-1981,6549,9527,64909,68625,57968,66498,69476
46123,SD,7128,30324,4553,8320,6758,3699,4127,30324,4667.318291,5860,8320,59998,8676,-1981,6549,9527,64909,68674,58017,66547,69525
46125,SD,9120,30324,4553,8320,6758,3699,4357,28729,4618.360407,5860,8547,60573,9129,-1207,7266,9980,67131,69702,59366,67839,70553
46127,SD,8352,30324,4553,8320,6758,3699,4268,33735,4520.444639,5860,8363,64529,10035,340,8700,10886,66274,74564,64869,73229,75415
46129,SD,7128,30324,4553,8320,6758,3699,4127,30324,4716.276176,5860,8320,60047,8676,-1981,6549,9527,64909,68723,58066,66596,69574
46135,SD,7128,30324,4553,8320,6758,3699,4127,32750,4667.318291,5860,8147,62251,9582,-434,7983,10433,64909,71833,61817,70234,72684
46137,SD,7128,30324,4553,8320,6758,3699,4127,30324,4797.872649,5860,8320,60129,8676,-1981,6549,9527,64909,68805,58148,66678,69656
47001,TN,9288,10381,4457,8554,6202,3916,6405,10152,4952.312748,5248,8107,41664,8059,-4015,2840,8062,49203,49723,37649,44504,49726
47003,TN,7392,10381,4457,8554,6202,3916,6073,9660,4568.90789,5248,8265,39050,6990,-5084,1585,6993,46975,46040,33966,40635,46043
47005,TN,6756,10381,4457,8554,6202,3916,5962,10381,4600.858295,5248,8554,39456,7467,-4607,2003,7470,46228,46923,34849,41459,46926
47007,TN,6756,10381,4457,8554,6202,3916,5962,10381,4680.734307,5248,8554,39536,7467,-4607,2003,7470,46228,47003,34929,41539,47006
47009,TN,9288,10381,4457,8554,6202,3916,6405,10146,4936.337546,5248,8107,41641,8059,-4015,2840,8062,49203,49700,37626,44481,49703
47011,TN,7788,10381,4457,8554,6202,3916,6142,9957,4505.007081,5248,8072,39487,7467,-4607,2003,7470,47440,46954,34880,41490,46957
47013,TN,6756,10381,4457,8554,6202,3916,5962,9372,4648.783903,5248,8119,38060,6513,-5561,1166,6516,46228,44573,32499,39226,44576
47015,TN,10212,10381,4457,8554,6202,3916,6567,9474,4473.056676,5248,8565,41888,8059,-4015,2840,8062,50289,49947,37873,44728,49950
47017,TN,6756,10381,4457,8554,6202,3916,5962,10381,4568.90789,5248,8554,39424,7467,-4607,2003,7470,46228,46891,34817,41427,46894
47019,TN,7752,10381,4457,8554,6202,3916,6136,9795,4744.635117,5248,7588,39043,6990,-5084,1585,6993,47398,46033,33959,40628,46036
47021,TN,10212,10381,4457,8554,6202,3916,6567,9803,4712.684712,5248,8565,42457,8346,-3728,3259,8349,50289,50803,38729,45716,50806
47023,TN,8220,10381,4457,8554,6202,3916,6218,9535,4552.932688,5248,8188,39660,7467,-4607,2003,7470,47948,47127,35053,41663,47130
47025,TN,6756,10381,4457,8554,6202,3916,5962,10381,4377.205461,5248,8554,39232,7467,-4607,2003,7470,46228,46699,34625,41235,46702
47027,TN,6756,10381,4457,8554,6202,3916,5962,10381,4409.155866,5248,8554,39264,7467,-4607,2003,7470,46228,46731,34657,41267,46734
47029,TN,6756,10381,4457,8554,6202,3916,5962,10355,4552.932688,5248,7216,38043,6513,-5561,1166,6516,46228,44556,32482,39209,44559
47031,TN,7380,10381,4457,8554,6202,3916,6071,9986,4696.70951,5248,7942,39169,6990,-5084,1585,6993,46961,46159,34085,40754,46162
47033,TN,6984,10381,4457,8554,6202,3916,6002,8639,4552.932688,5248,8193,37533,6513,-5561,1166,6516,46496,44046,31972,38699,44049
47035,TN,7056,10381,4457,8554,6202,3916,6014,9673,4808.535927,5248,7358,38059,6513,-5561,1166,6516,46580,44572,32498,39225,44575
47037,TN,10212,10381,4457,8554,6202,3916,6567,12450,4648.783903,5248,8569,45043,8919,-3155,4096,8922,50289,53962,41888,49139,53965
47039,TN,6756,10381,4457,8554,6202,3916,5962,10381,4600.858295,5248,8554,39456,7467,-4607,2003,7470,46228,46923,34849,41459,46926
47041,TN,6756,10381,4457,8554,6202,3916,5962,10381,4393.180664,5248,8554,39248,7467,-4607,2003,7470,46228,46715,34641,41251,46718
47043,TN,10212,10381,4457,8554,6202,3916,6567,9999,4217.453437,5248,8566,42158,8346,-3728,3259,8349,50289,50504,38430,45417,50507
47045,TN,6924,10381,4457,8554,6202,3916,5991,9065,4536.957486,5248,7763,37453,6513,-5561,1166,6516,46425,43966,31892,38619,43969
47047,TN,9360,10381,4457,8554,6202,3916,6418,9944,4808.535927,5248,8480,41757,8059,-4015,2840,8062,49288,49816,37742,44597,49819
47049,TN,6756,10381,4457,8554,6202,3916,5962,10381,4489.031878,5248,8554,39344,7467,-4607,2003,7470,46228,46811,34737,41347,46814
47051,TN,6996,10381,4457,8554,6202,3916,6004,9048,4616.833498,5248,7969,37794,6513,-5561,1166,6516,46510,44307,32233,38960,44310
47053,TN,6756,10381,4457,8554,6202,3916,5962,10381,4664.759105,5248,8554,39520,7467,-4607,2003,7470,46228,46987,34913,41523,46990
47055,TN,7428,10381,4457,8554,6202,3916,6079,10381,4584.883093,5248,8554,40112,7467,-4607,2003,7470,47017,47579,35505,42115,47582
47057,TN,7644,10381,4457,8554,6202,3916,6117,10083,4984.263153,5248,8129,40004,7467,-4607,2003,7470,47271,47471,35397,42007,47474
47059,TN,7008,10381,4457,8554,6202,3916,6006,9929,4568.90789,5248,7418,38088,6513,-5561,1166,6516,46524,44601,32527,39254,44604
47061,TN,6756,10381,4457,8554,6202,3916,5962,10381,4696.70951,5248,8554,39552,7467,-4607,2003,7470,46228,47019,34945,41555,47022
47063,TN,7644,10381,4457,8554,6202,3916,6117,9586,4536.957486,5248,7761,38692,6990,-5084,1585,6993,47271,45682,33608,40277,45685
47065,TN,8148,10381,4457,8554,6202,3916,6205,10488,4760.610319,5248,8230,40791,7773,-4301,2422,7776,47863,48564,36490,43213,48567
47067,TN,6756,10381,4457,8554,6202,3916,5962,10381,4536.957486,5248,8554,39392,7467,-4607,2003,7470,46228,46859,34785,41395,46862
47069,TN,6756,10381,4457,8554,6202,3916,5962,10381,4584.883093,5248,8554,39440,7467,-4607,2003,7470,46228,46907,34833,41443,46910
47071,TN,6756,10381,4457,8554,6202,3916,5962,10381,4536.957486,5248,8554,39392,7467,-4607,2003,7470,46228,46859,34785,41395,46862
47073,TN,7404,10381,4457,8554,6202,3916,6075,9852,4568.90789,5248,7612,38601,6990,-5084,1585,6993,46989,45591,33517,40186,45594
47075,TN,7656,10381,4457,8554,6202,3916,6119,10381,4584.883093,5248,8554,40340,7773,-4301,2422,7776,47285,48113,36039,42762,48116
47077,TN,6780,10381,4457,8554,6202,3916,5966,10381,4648.783903,5248,8554,39528,7467,-4607,2003,7470,46256,46995,34921,41531,46998
47079,TN,6948,10381,4457,8554,6202,3916,5995,9894,4505.007081,5248,7460,37971,6513,-5561,1166,6516,46453,44484,32410,39137,44487
47081,TN,7584,10381,4457,8554,6202,3916,6107,10117,4872.436736,5248,8565,40303,7467,-4607,2003,7470,47201,47770,35696,42306,47773
47083,TN,6756,10381,4457,8554,6202,3916,5962,10381,4473.056676,5248,8554,39328,7467,-4607,2003,7470,46228,46795,34721,41331,46798
47085,TN,6756,10381,4457,8554,6202,3916,5962,10381,4377.205461,5248,8554,39232,7467,-4607,2003,7470,46228,46699,34625,41235,46702
47087,TN,6756,10381,4457,8554,6202,3916,5962,9679,4441.106271,5248,7517,37557,6513,-5561,1166,6516,46228,44070,31996,38723,44073
47089,TN,7644,10381,4457,8554,6202,3916,6117,10399,4792.560724,5248,7782,39782,7467,-4607,2003,7470,47271,47249,35175,41785,47252
47091,TN,6756,10381,4457,8554,6202,3916,5962,10381,4776.585522,5248,8554,39632,7467,-4607,2003,7470,46228,47099,35025,41635,47102
47093,TN,9288,10381,4457,8554,6202,3916,6405,10888,4728.659915,5248,8106,42175,8059,-4015,2840,8062,49203,50234,38160,45015,50237
47095,TN,6756,10381,4457,8554,6202,3916,5962,10381,4153.552628,5248,8554,39009,7467,-4607,2003,7470,46228,46476,34402,41012,46479
47097,TN,6756,10381,4457,8554,6202,3916,5962,10381,4441.106271,5248,8554,39296,7467,-4607,2003,7470,46228,46763,34689,41299,46766
47099,TN,6756,10381,4457,8554,6202,3916,5962,9314,4409.155866,5248,7775,37419,6513,-5561,1166,6516,46228,43932,31858,38585,43935
47101,TN,6756,10381,4457,8554,6202,3916,5962,10381,4457.081474,5248,8554,39312,7467,-4607,2003,7470,46228,46779,34705,41315,46782
47103,TN,6756,10381,4457,8554,6202,3916,5962,10381,4648.783903,5248,8554,39504,7467,-4607,2003,7470,46228,46971,34897,41507,46974
47105,TN,9288,10381,4457,8554,6202,3916,6405,10098,4840.486331,5248,8119,41509,8059,-4015,2840,8062,49203,49568,37494,44349,49571
47107,TN,7020,10381,4457,8554,6202,3916,6008,9913,4728.659915,5248,7731,38556,6990,-5084,1585,6993,46538,45546,33472,40141,45549
47109,TN,6756,10381,4457,8554,6202,3916,5962,10381,4457.081474,5248,8554,39312,7467,-4607,2003,7470,46228,46779,34705,41315,46782
47111,TN,6756,10381,4457,8554,6202,3916,5962,9702,4568.90789,5248,8565,38756,6990,-5084,1585,6993,46228,45746,33672,40341,45749
47113,TN,8220,10381,4457,8554,6202,3916,6218,9708,4536.957486,5248,8156,39785,7467,-4607,2003,7470,47948,47252,35178,41788,47255
47115,TN,8148,10381,4457,8554,6202,3916,6205,9573,4664.759105,5248,8249,39799,7467,-4607,2003,7470,47863,47266,35192,41802,47269
47117,TN,7812,10381,4457,8554,6202,3916,6147,9304,4489.031878,5248,8270,39040,7467,-4607,2003,7470,47469,46507,34433,41043,46510
47119,TN,7416,10381,4457,8554,6202,3916,6077,9916,4473.056676,5248,8566,39535,7467,-4607,2003,7470,47003,47002,34928,41538,47005
47121,TN,6756,10381,4457,8554,6202,3916,5962,10381,4696.70951,5248,8554,39552,7467,-4607,2003,7470,46228,47019,34945,41555,47022
47123,TN,6756,10381,4457,8554,6202,3916,5962,10381,4808.535927,5248,8554,39664,7467,-4607,2003,7470,46228,47131,35057,41667,47134
47125,TN,9204,10381,4457,8554,6202,3916,6390,10194,4520.982283,5248,8427,41510,8059,-4015,2840,8062,49104,49569,37495,44350,49572
47127,TN,7212,10381,4457,8554,6202,3916,6041,8738,4616.833498,5248,7995,37725,6513,-5561,1166,6516,46763,44238,32164,38891,44241
47129,TN,6756,10381,4457,8554,6202,3916,5962,10057,4968.287951,5248,8143,39088,6990,-5084,1585,6993,46228,46078,34004,40673,46081
47131,TN,6756,10381,4457,8554,6202,3916,5962,9244,4552.932688,5248,7605,37322,6513,-5561,1166,6516,46228,43835,31761,38488,43838
47133,TN,6756,10381,4457,8554,6202,3916,5962,9503,5000.238356,5248,7500,37924,6513,-5561,1166,6516,46228,44437,32363,39090,44440
47135,TN,6756,10381,4457,8554,6202,3916,5962,10381,4648.783903,5248,8554,39504,7467,-4607,2003,7470,46228,46971,34897,41507,46974
47137,TN,6756,10381,4457,8554,6202,3916,5962,10381,4409.155866,5248,8554,39264,7467,-4607,2003,7470,46228,46731,34657,41267,46734
47139,TN,7788,10381,4457,8554,6202,3916,6142,9573,4536.957486,5248,8116,39179,7467,-4607,2003,7470,47440,46646,34572,41182,46649
47141,TN,7176,10381,4457,8554,6202,3916,6035,10079,4361.230259,5248,7422,38202,6990,-5084,1585,6993,46721,45192,33118,39787,45195
47143,TN,6756,10381,4457,8554,6202,3916,5962,10211,4760.610319,5248,7635,38526,6990,-5084,1585,6993,46228,45516,33442,40111,45519
47145,TN,7296,10381,4457,8554,6202,3916,6056,9964,4744.635117,5248,8115,39283,6990,-5084,1585,6993,46862,46273,34199,40868,46276
47147,TN,10212,10381,4457,8554,6202,3916,6567,9589,4313.304652,5248,8566,41844,8059,-4015,2840,8062,50289,49903,37829,44684,49906
47149,TN,10212,10381,4457,8554,6202,3916,6567,10610,4536.957486,5248,8566,43089,8632,-3442,3677,8635,50289,51721,39647,46766,51724
47151,TN,6756,10381,4457,8554,6202,3916,5962,10381,4680.734307,5248,8554,39536,7467,-4607,2003,7470,46228,47003,34929,41539,47006
47153,TN,8148,10381,4457,8554,6202,3916,6205,9935,4616.833498,5248,8246,40110,7467,-4607,2003,7470,47863,47577,35503,42113,47580
47155,TN,8676,10381,4457,8554,6202,3916,6298,10524,4968.287951,5248,8245,41577,8059,-4015,2840,8062,48484,49636,37562,44417,49639
47157,TN,9360,10381,4457,8554,6202,3916,6418,11029,4457.081474,5248,8483,42493,8346,-3728,3259,8349,49288,50839,38765,45752,50842
47159,TN,6876,10381,4457,8554,6202,3916,5983,9868,4377.205461,5248,8565,38850,6990,-5084,1585,6993,46369,45840,33766,40435,45843
47161,TN,6756,10381,4457,8554,6202,3916,5962,10381,4489.031878,5248,8554,39344,7467,-4607,2003,7470,46228,46811,34737,41347,46814
47163,TN,7404,10381,4457,8554,6202,3916,6075,9823,4856.461534,5248,7604,38851,6990,-5084,1585,6993,46989,45841,33767,40436,45844
47165,TN,10212,10381,4457,8554,6202,3916,6567,10475,4377.205461,5248,8567,42795,8346,-3728,3259,8349,50289,51141,39067,46054,51144
47167,TN,9360,10381,4457,8554,6202,3916,6418,9768,4632.8087,5248,8479,41404,8059,-4015,2840,8062,49288,49463,37389,44244,49466
47169,TN,10212,10381,4457,8554,6202,3916,6567,9894,4361.230259,5248,8565,42196,8346,-3728,3259,8349,50289,50542,38468,45455,50545
47171,TN,7752,10381,4457,8554,6202,3916,6136,9190,4680.734307,5248,7592,38379,6990,-5084,1585,6993,47398,45369,33295,39964,45372
47173,TN,9288,10381,4457,8554,6202,3916,6405,10310,4744.635117,5248,8127,41633,8059,-4015,2840,8062,49203,49692,37618,44473,49695
47175,TN,6756,10381,4457,8554,6202,3916,5962,10381,4536.957486,5248,8554,39392,7467,-4607,2003,7470,46228,46859,34785,41395,46862
47177,TN,6756,10381,4457,8554,6202,3916,5962,9254,4520.982283,5248,7610,37305,6513,-5561,1166,6516,46228,43818,31744,38471,43821
47179,TN,7752,10381,4457,8554,6202,3916,6136,10681,4696.70951,5248,7577,39870,7467,-4607,2003,7470,47398,47337,35263,41873,47340
47181,TN,6756,10381,4457,8554,6202,3916,5962,10381,4441.106271,5248,8554,39296,7467,-4607,2003,7470,46228,46763,34689,41299,46766
47183,TN,6756,10381,4457,8554,6202,3916,5962,9462,4792.560724,5248,7501,37675,6513,-5561,1166,6516,46228,44188,32114,38841,44191
47185,TN,7128,10381,4457,8554,6202,3916,6027,10381,4457.081474,5248,8554,39684,7467,-4607,2003,7470,46665,47151,35077,41687,47154
47187,TN,10212,10381,4457,8554,6202,3916,6567,12051,4760.610319,5248,8567,44754,8919,-3155,4096,8922,50289,53673,41599,48850,53676
47189,TN,10212,10381,4457,8554,6202,3916,6567,10241,4313.304652,5248,8566,42497,8346,-3728,3259,8349,50289,50843,38769,45756,50846
48001,TX,8040,5523,4457,8554,6745,3916,4266,5835,4217.453437,4828,8124,34961,3485,-8541,-1697,3536,41501,38446,26420,33264,38497
48003,TX,7644,5523,4457,8554,6745,3916,4220,5571,4137.577425,4828,8995,35092,3485,-8541,-1697,3536,41059,38577,26551,33395,38628
48005,TX,8556,5523,4457,8554,6745,3916,4325,5762,4089.651818,4828,8282,35434,3485,-8541,-1697,3536,42076,38919,26893,33737,38970
48007,TX,8424,5523,4457,8554,6745,3916,4310,6347,3993.800604,4828,8523,36031,3902,-8124,-1338,3953,41929,39933,27907,34693,39984
48009,TX,8544,5523,4457,8554,6745,3916,4324,5380,4089.651818,4828,8317,35074,3485,-8541,-1697,3536,42063,38559,26533,33377,38610
48011,TX,8832,5523,4457,8554,6745,3916,4357,4902,4377.205461,4828,8529,35384,3485,-8541,-1697,3536,42384,38869,26843,33687,38920
48013,TX,8268,5523,4457,8554,6745,3916,4292,6074,4009.775806,4828,8739,35834,3902,-8124,-1338,3953,41755,39736,27710,34496,39787
48015,TX,8400,5523,4457,8554,6745,3916,4307,6108,4505.007081,4828,8948,36705,3902,-8124,-1338,3953,41902,40607,28581,35367,40658
48017,TX,7848,5523,4457,8554,6745,3916,4244,5523,4473.056676,4828,8554,35142,3485,-8541,-1697,3536,41287,38627,26601,33445,38678
48019,TX,10284,5523,4457,8554,6745,3916,4524,6189,4552.932688,4828,8738,38507,4736,-7290,-621,4787,44003,43243,31217,37886,43294
48021,TX,12888,5523,4457,8554,6745,3916,4824,6335,3786.122972,4828,9096,40850,5625,-6401,454,5676,46907,46475,34449,41304,46526
48023,TX,7644,5523,4457,8554,6745,3916,4220,5523,4057.701413,4828,8554,34523,3068,-8958,-2055,3119,41059,37591,25565,32468,37642
48025,TX,7932,5523,4457,8554,6745,3916,4253,5476,3562.470138,4828,8066,33780,3068,-8958,-2055,3119,41380,36848,24822,31725,36899
48027,TX,8808,5523,4457,8554,6745,3916,4354,6120,3786.122972,4828,8833,36291,3902,-8124,-1338,3953,42357,40193,28167,34953,40244
48029,TX,10284,5523,4457,8554,6745,3916,4524,6130,3929.899794,4828,8776,37864,4736,-7290,-621,4787,44003,42600,30574,37243,42651
48031,TX,9660,5523,4457,8554,6745,3916,4453,5523,4137.577425,4828,8554,36619,3902,-8124,-1338,3953,43308,40521,28495,35281,40572
48033,TX,7836,5523,4457,8554,6745,3916,4242,5523,3913.924591,4828,8554,34571,3485,-8541,-1697,3536,41273,38056,26030,32874,38107
48035,TX,7644,5523,4457,8554,6745,3916,4220,5523,3850.023782,4828,8554,34315,3068,-8958,-2055,3119,41059,37383,25357,32260,37434
48037,TX,8448,5523,4457,8554,6745,3916,4313,5768,4025.751008,4828,8129,35114,3485,-8541,-1697,3536,41956,38599,26573,33417,38650
48039,TX,9936,5523,4457,8554,6745,3916,4484,6401,4249.403842,4828,8983,38313,4736,-7290,-621,4787,43615,43049,31023,37692,43100
48041,TX,10416,5523,4457,8554,6745,3916,4540,6651,4105.62702,4828,8015,37932,4736,-7290,-621,4787,44151,42668,30642,37311,42719
48043,TX,8916,5523,4457,8554,6745,3916,4367,5523,4520.982283,4828,8554,36258,3902,-8124,-1338,3953,42478,40160,28134,34920,40211
48045,TX,7644,5523,4457,8554,6745,3916,4220,5523,4313.304652,4828,8554,34778,3068,-8958,-2055,3119,41059,37846,25820,32723,37897
48047,TX,7644,5523,4457,8554,6745,3916,4220,5523,3530.519734,4828,8554,33996,3068,-8958,-2055,3119,41059,37064,25038,31941,37115
48049,TX,8028,5523,4457,8554,6745,3916,4265,5631,4265.379045,4828,7900,34569,3068,-8958,-2055,3119,41488,37637,25611,32514,37688
48051,TX,10416,5523,4457,8554,6745,3916,4540,5839,4121.602223,4828,8029,37149,4319,-7707,-980,4370,44151,41468,29442,36169,41519
48053,TX,8184,5523,4457,8554,6745,3916,4282,5523,3945.874996,4828,8554,34951,3485,-8541,-1697,3536,41661,38436,26410,33254,38487
48055,TX,12888,5523,4457,8554,6745,3916,4824,6188,3530.519734,4828,9117,40468,5625,-6401,454,5676,46907,46093,34067,40922,46144
48057,TX,8520,5523,4457,8554,6745,3916,4321,5736,3706.24696,4828,8364,35070,3485,-8541,-1697,3536,42036,38555,26529,33373,38606
48059,TX,9480,5523,4457,8554,6745,3916,4432,5642,4009.775806,4828,8285,36160,3902,-8124,-1338,3953,43107,40062,28036,34822,40113
48061,TX,8112,5523,4457,8554,6745,3916,4274,5721,3370.767709,4828,8226,34174,3485,-8541,-1697,3536,41581,37659,25633,32477,37710
48063,TX,7644,5523,4457,8554,6745,3916,4220,5523,4249.403842,4828,8554,34714,3068,-8958,-2055,3119,41059,37782,25756,32659,37833
48065,TX,8832,5523,4457,8554,6745,3916,4357,5248,4377.205461,4828,8529,35731,3485,-8541,-1697,3536,42384,39216,27190,34034,39267
48067,TX,7644,5523,4457,8554,6745,3916,4220,5523,4265.379045,4828,8554,34730,3068,-8958,-2055,3119,41059,37798,25772,32675,37849
48069,TX,7644,5523,4457,8554,6745,3916,4220,5523,4552.932688,4828,8554,35018,3068,-8958,-2055,3119,41059,38086,26060,32963,38137
48071,TX,11112,5523,4457,8554,6745,3916,4620,6251,4936.337546,4828,8952,39996,5153,-6873,-263,5204,44927,45149,33123,39733,45200
48073,TX,7644,5523,4457,8554,6745,3916,4220,5689,4201.478235,4828,7883,34162,3068,-8958,-2055,3119,41059,37230,25204,32107,37281
48075,TX,7968,5523,4457,8554,6745,3916,4258,5523,4345.255057,4828,8554,35134,3485,-8541,-1697,3536,41421,38619,26593,33437,38670
48077,TX,8544,5523,4457,8554,6745,3916,4324,5357,4025.751008,4828,8314,34986,3485,-8541,-1697,3536,42063,38471,26445,33289,38522
48079,TX,7644,5523,4457,8554,6745,3916,4220,5523,4313.304652,4828,8554,34778,3068,-8958,-2055,3119,41059,37846,25820,32723,37897
48081,TX,7644,5523,4457,8554,6745,3916,4220,5523,3913.924591,4828,8554,34379,3068,-8958,-2055,3119,41059,37447,25421,32324,37498
48083,TX,7644,5523,4457,8554,6745,3916,4220,5523,3993.800604,4828,8554,34459,3068,-8958,-2055,3119,41059,37527,25501,32404,37578
48085,TX,10956,5523,4457,8554,6745,3916,4602,6904,4600.858295,4828,8916,40122,5153,-6873,-263,5204,44753,45275,33249,39859,45326
48087,TX,7644,5523,4457,8554,6745,3916,4220,5523,4393.180664,4828,8554,34858,3068,-8958,-2055,3119,41059,37926,25900,32803,37977
48089,TX,7644,5523,4457,8554,6745,3916,4220,5523,3802.098175,4828,8554,34267,3068,-8958,-2055,3119,41059,37335,25309,32212,37386
48091,TX,10284,5523,4457,8554,6745,3916,4524,6391,4345.255057,4828,8746,38511,4736,-7290,-621,4787,44003,43247,31221,37890,43298
48093,TX,7644,5523,4457,8554,6745,3916,4220,5523,4185.503032,4828,8554,34651,3068,-8958,-2055,3119,41059,37719,25693,32596,37770
48095,TX,12204,5523,4457,8554,6745,3916,4746,5523,3945.874996,4828,8554,38971,5153,-6873,-263,5204,46145,44124,32098,38708,44175
48097,TX,9756,5523,4457,8554,6745,3916,4464,5751,4680.734307,4828,8468,37400,4319,-7707,-980,4370,43415,41719,29693,36420,41770
48099,TX,8808,5523,4457,8554,6745,3916,4354,5891,3929.899794,4828,8814,36187,3902,-8124,-1338,3953,42357,40089,28063,34849,40140
48101,TX,7644,5523,4457,8554,6745,3916,4220,5523,4345.255057,4828,8554,34810,3068,-8958,-2055,3119,41059,37878,25852,32755,37929
48103,TX,8952,5523,4457,8554,6745,3916,4371,5523,4073.676616,4828,8554,35847,3902,-8124,-1338,3953,42518,39749,27723,34509,39800
48105,TX,7644,5523,4457,8554,6745,3916,4220,5523,3706.24696,4828,8554,34171,3068,-8958,-2055,3119,41059,37239,25213,32116,37290
48107,TX,9288,5523,4457,8554,6745,3916,4410,4846,4233.42864,4828,8407,35518,3485,-8541,-1697,3536,42893,39003,26977,33821,39054
48109,TX,7644,5523,4457,8554,6745,3916,4220,5523,4169.52783,4828,8554,34635,3068,-8958,-2055,3119,41059,37703,25677,32580,37754
48111,TX,7644,5523,4457,8554,6745,3916,4220,5523,4345.255057,4828,8554,34810,3068,-8958,-2055,3119,41059,37878,25852,32755,37929
48113,TX,10956,5523,4457,8554,6745,3916,4602,6704,4361.230259,4828,8946,39711,5153,-6873,-263,5204,44753,44864,32838,39448,44915
48115,TX,7644,5523,4457,8554,6745,3916,4220,4909,4153.552628,4828,7613,33063,2651,-9375,-2414,2702,41059,35714,23688,30649,35765
48117,TX,7656,5523,4457,8554,6745,3916,4222,5377,4377.205461,4828,8583,34737,3068,-8958,-2055,3119,41073,37805,25779,32682,37856
48119,TX,10956,5523,4457,8554,6745,3916,4602,5523,4329.279854,4828,8554,38106,4736,-7290,-621,4787,44753,42842,30816,37485,42893
48121,TX,10956,5523,4457,8554,6745,3916,4602,6781,4584.883093,4828,8924,39990,5153,-6873,-263,5204,44753,45143,33117,39727,45194
48123,TX,7644,5523,4457,8554,6745,3916,4220,5523,3402.718114,4828,8554,33868,3068,-8958,-2055,3119,41059,36936,24910,31813,36987
48125,TX,7644,5523,4457,8554,6745,3916,4220,5523,4233.42864,4828,8554,34698,3068,-8958,-2055,3119,41059,37766,25740,32643,37817
48127,TX,7644,5523,4457,8554,6745,3916,4220,5523,3338.817305,4828,8554,33804,3068,-8958,-2055,3119,41059,36872,24846,31749,36923
48129,TX,7644,5523,4457,8554,6745,3916,4220,5523,4505.007081,4828,8554,34970,3068,-8958,-2055,3119,41059,38038,26012,32915,38089
48131,TX,8496,5523,4457,8554,6745,3916,4318,5523,3578.445341,4828,8554,34895,3485,-8541,-1697,3536,42009,38380,26354,33198,38431
48133,TX,7644,5523,4457,8554,6745,3916,4220,5523,4201.478235,4828,8554,34666,3068,-8958,-2055,3119,41059,37734,25708,32611,37785
48135,TX,11904,5523,4457,8554,6745,3916,4711,6125,3977.825401,4828,8766,39517,5153,-6873,-263,5204,45810,44670,32644,39254,44721
48137,TX,7644,5523,4457,8554,6745,3916,4220,5523,3706.24696,4828,8554,34171,3068,-8958,-2055,3119,41059,37239,25213,32116,37290
48139,TX,10956,5523,4457,8554,6745,3916,4602,6072,4137.577425,4828,8888,38798,5153,-6873,-263,5204,44753,43951,31925,38535,44002
48141,TX,8964,5523,4457,8554,6745,3916,4372,5812,4057.701413,4828,8636,36213,3902,-8124,-1338,3953,42531,40115,28089,34875,40166
48143,TX,8328,5523,4457,8554,6745,3916,4299,6033,4073.676616,4828,8001,35179,3485,-8541,-1697,3536,41822,38664,26638,33482,38715
48145,TX,7812,5523,4457,8554,6745,3916,4240,5332,3770.14777,4828,8332,33990,3068,-8958,-2055,3119,41247,37058,25032,31935,37109
48147,TX,7824,5523,4457,8554,6745,3916,4241,5523,4265.379045,4828,8554,34910,3485,-8541,-1697,3536,41260,38395,26369,33213,38446
48149,TX,7920,5523,4457,8554,6745,3916,4252,5523,3738.197365,4828,8554,34479,3485,-8541,-1697,3536,41367,37964,25938,32782,38015
48151,TX,7644,5523,4457,8554,6745,3916,4220,5523,3961.850199,4828,8554,34427,3068,-8958,-2055,3119,41059,37495,25469,32372,37546
48153,TX,7644,5523,4457,8554,6745,3916,4220,5523,4233.42864,4828,8554,34698,3068,-8958,-2055,3119,41059,37766,25740,32643,37817
48155,TX,7644,5523,4457,8554,6745,3916,4220,5523,4457.081474,4828,8554,34922,3068,-8958,-2055,3119,41059,37990,25964,32867,38041
48157,TX,11112,5523,4457,8554,6745,3916,4620,6492,4297.329449,4828,8975,39621,5153,-6873,-263,5204,44927,44774,32748,39358,44825
48159,TX,7644,5523,4457,8554,6745,3916,4220,5523,4281.354247,4828,8554,34746,3068,-8958,-2055,3119,41059,37814,25788,32691,37865
48161,TX,9420,5523,4457,8554,6745,3916,4425,5523,4073.676616,4828,8554,36315,3902,-8124,-1338,3953,43040,40217,28191,34977,40268
48163,TX,7644,5523,4457,8554,6745,3916,4220,5523,3929.899794,4828,8554,34395,3068,-8958,-2055,3119,41059,37463,25437,32340,37514
48165,TX,7668,5523,4457,8554,6745,3916,4223,5523,4137.577425,4828,8554,34627,3068,-8958,-2055,3119,41086,37695,25669,32572,37746
48167,TX,11112,5523,4457,8554,6745,3916,4620,6336,4489.031878,4828,8991,39673,5153,-6873,-263,5204,44927,44826,32800,39410,44877
48169,TX,7644,5523,4457,8554,6745,3916,4220,5523,4233.42864,4828,8554,34698,3068,-8958,-2055,3119,41059,37766,25740,32643,37817
48171,TX,10500,5523,4457,8554,6745,3916,4549,6098,4041.726211,4828,8227,37611,4736,-7290,-621,4787,44244,42347,30321,36990,42398
48173,TX,7836,5523,4457,8554,6745,3916,4242,5800,4041.726211,4828,8245,34667,3485,-8541,-1697,3536,41273,38152,26126,32970,38203
48175,TX,8772,5523,4457,8554,6745,3916,4350,5694,3738.197365,4828,8575,35524,3902,-8124,-1338,3953,42317,39426,27400,34186,39477
48177,TX,7644,5523,4457,8554,6745,3916,4220,5523,4009.775806,4828,8554,34475,3068,-8958,-2055,3119,41059,37543,25517,32420,37594
48179,TX,7644,5523,4457,8554,6745,3916,4220,5212,4536.957486,4828,8036,34173,3068,-8958,-2055,3119,41059,37241,25215,32118,37292
48181,TX,9672,5523,4457,8554,6745,3916,4454,5774,4153.552628,4828,8250,36593,3902,-8124,-1338,3953,43321,40495,28469,35255,40546
48183,TX,9576,5523,4457,8554,6745,3916,4443,5918,4201.478235,4828,8373,36812,4319,-7707,-980,4370,43214,41131,29105,35832,41182
48185,TX,7644,5523,4457,8554,6745,3916,4220,5523,4520.982283,4828,8554,34986,3068,-8958,-2055,3119,41059,38054,26028,32931,38105
48187,TX,10284,5523,4457,8554,6745,3916,4524,6009,4073.676616,4828,8748,37859,4736,-7290,-621,4787,44003,42595,30569,37238,42646
48189,TX,7644,5523,4457,8554,6745,3916,4220,5174,4281.354247,4828,8308,34151,3068,-8958,-2055,3119,41059,37219,25193,32096,37270
48191,TX,7644,5523,4457,8554,6745,3916,4220,5523,4345.255057,4828,8554,34810,3068,-8958,-2055,3119,41059,37878,25852,32755,37929
48193,TX,7644,5523,4457,8554,6745,3916,4220,5523,3881.974187,4828,8554,34347,3068,-8958,-2055,3119,41059,37415,25389,32292,37466
48195,TX,7644,5523,4457,8554,6745,3916,4220,5523,4345.255057,4828,8554,34810,3068,-8958,-2055,3119,41059,37878,25852,32755,37929
48197,TX,7740,5523,4457,8554,6745,3916,4231,5523,4297.329449,4828,8554,34858,3485,-8541,-1697,3536,41166,38343,26317,33161,38394
48199,TX,9672,5523,4457,8554,6745,3916,4454,5992,4137.577425,4828,8215,36761,4319,-7707,-980,4370,43321,41080,29054,35781,41131
48201,TX,11112,5523,4457,8554,6745,3916,4620,6682,4249.403842,4828,9027,39814,5399,-6627,96,5450,44927,45213,33187,39910,45264
48203,TX,7644,5523,4457,8554,6745,3916,4220,5909,4217.453437,4828,8447,34962,3485,-8541,-1697,3536,41059,38447,26421,33265,38498
48205,TX,7644,5523,4457,8554,6745,3916,4220,5523,4329.279854,4828,8554,34794,3068,-8958,-2055,3119,41059,37862,25836,32739,37913
48207,TX,7644,5523,4457,8554,6745,3916,4220,5523,4457.081474,4828,8554,34922,3068,-8958,-2055,3119,41059,37990,25964,32867,38041
48209,TX,12888,5523,4457,8554,6745,3916,4824,6647,4105.62702,4828,9122,41507,5625,-6401,454,5676,46907,47132,35106,41961,47183
48211,TX,8412,5523,4457,8554,6745,3916,4309,5523,4473.056676,4828,8554,35706,3485,-8541,-1697,3536,41916,39191,27165,34009,39242
48213,TX,8232,5523,4457,8554,6745,3916,4288,6086,4233.42864,4828,8012,35308,3485,-8541,-1697,3536,41715,38793,26767,33611,38844
48215,TX,7860,5523,4457,8554,6745,3916,4245,5739,3418.693317,4828,8412,34174,3485,-8541,-1697,3536,41300,37659,25633,32477,37710
48217,TX,8400,5523,4457,8554,6745,3916,4307,5523,4377.205461,4828,8554,35598,3485,-8541,-1697,3536,41902,39083,27057,33901,39134
48219,TX,8532,5523,4457,8554,6745,3916,4323,5470,4265.379045,4828,8672,35684,3485,-8541,-1697,3536,42050,39169,27143,33987,39220
48221,TX,10248,5523,4457,8554,6745,3916,4520,6404,4536.957486,4828,8893,38826,4736,-7290,-621,4787,43963,43562,31536,38205,43613
48223,TX,8460,5523,4457,8554,6745,3916,4314,5630,4281.354247,4828,8187,35302,3485,-8541,-1697,3536,41969,38787,26761,33605,38838
48225,TX,7860,5523,4457,8554,6745,3916,4245,5523,3738.197365,4828,8554,34419,3485,-8541,-1697,3536,41300,37904,25878,32722,37955
48227,TX,7848,5523,4457,8554,6745,3916,4244,5359,3881.974187,4828,8177,34011,3068,-8958,-2055,3119,41287,37079,25053,31956,37130
48229,TX,7644,5523,4457,8554,6745,3916,4220,5774,4153.552628,4828,8578,34893,3485,-8541,-1697,3536,41059,38378,26352,33196,38429
48231,TX,10956,5523,4457,8554,6745,3916,4602,6043,4329.279854,4828,8893,38965,5153,-6873,-263,5204,44753,44118,32092,38702,44169
48233,TX,8520,5523,4457,8554,6745,3916,4321,5278,4600.858295,4828,8243,35386,3485,-8541,-1697,3536,42036,38871,26845,33689,38922
48235,TX,8760,5523,4457,8554,6745,3916,4349,5225,3865.998984,4828,8354,34949,3485,-8541,-1697,3536,42304,38434,26408,33252,38485
48237,TX,7992,5523,4457,8554,6745,3916,4260,5523,4600.858295,4828,8554,35414,3485,-8541,-1697,3536,41447,38899,26873,33717,38950
48239,TX,9024,5523,4457,8554,6745,3916,4379,5523,3722.222162,4828,8554,35567,3902,-8124,-1338,3953,42598,39469,27443,34229,39520
48241,TX,8724,5523,4457,8554,6745,3916,4345,5523,4073.676616,4828,8554,35619,3902,-8124,-1338,3953,42264,39521,27495,34281,39572
48243,TX,7644,5523,4457,8554,6745,3916,4220,5523,4568.90789,4828,8554,35034,3068,-8958,-2055,3119,41059,38102,26076,32979,38153
48245,TX,9672,5523,4457,8554,6745,3916,4454,5769,3897.949389,4828,8191,36274,3902,-8124,-1338,3953,43321,40176,28150,34936,40227
48247,TX,7644,5523,4457,8554,6745,3916,4220,5523,3418.693317,4828,8554,33884,3068,-8958,-2055,3119,41059,36952,24926,31829,37003
48249,TX,9120,5523,4457,8554,6745,3916,4390,5712,3562.470138,4828,8435,35573,3902,-8124,-1338,3953,42705,39475,27449,34235,39526
48251,TX,11256,5523,4457,8554,6745,3916,4636,6128,3770.14777,4828,8892,38790,5153,-6873,-263,5204,45087,43943,31917,38527,43994
48253,TX,9480,5523,4457,8554,6745,3916,4432,5158,4664.759105,4828,8291,36337,3902,-8124,-1338,3953,43107,40239,28213,34999,40290
48255,TX,7644,5523,4457,8554,6745,3916,4220,5523,3961.850199,4828,8554,34427,3068,-8958,-2055,3119,41059,37495,25469,32372,37546
48257,TX,10956,5523,4457,8554,6745,3916,4602,6106,4520.982283,4828,8884,39212,5153,-6873,-263,5204,44753,44365,32339,38949,44416
48259,TX,10128,5523,4457,8554,6745,3916,4506,6712,4329.279854,4828,8739,38652,4736,-7290,-621,4787,43829,43388,31362,38031,43439
48261,TX,8964,5523,4457,8554,6745,3916,4372,4638,3530.519734,4828,8329,34206,3485,-8541,-1697,3536,42531,37691,25665,32509,37742
48263,TX,9084,5523,4457,8554,6745,3916,4386,5523,4329.279854,4828,8554,36234,3902,-8124,-1338,3953,42665,40136,28110,34896,40187
48265,TX,9456,5523,4457,8554,6745,3916,4429,6080,4041.726211,4828,7898,36219,3902,-8124,-1338,3953,43080,40121,28095,34881,40172
48267,TX,8088,5523,4457,8554,6745,3916,4271,5523,4041.726211,4828,8554,34951,3485,-8541,-1697,3536,41554,38436,26410,33254,38487
48269,TX,7836,5523,4457,8554,6745,3916,4242,5523,4409.155866,4828,8554,35066,3485,-8541,-1697,3536,41273,38551,26525,33369,38602
48271,TX,7644,5523,4457,8554,6745,3916,4220,5523,3306.8669,4828,8554,33772,3068,-8958,-2055,3119,41059,36840,24814,31717,36891
48273,TX,8448,5523,4457,8554,6745,3916,4313,5735,3834.048579,4828,8294,35056,3485,-8541,-1697,3536,41956,38541,26515,33359,38592
48275,TX,7644,5523,4457,8554,6745,3916,4220,5523,4409.155866,4828,8554,34874,3068,-8958,-2055,3119,41059,37942,25916,32819,37993
48277,TX,7644,5523,4457,8554,6745,3916,4220,5350,4345.255057,4828,8057,34140,3068,-8958,-2055,3119,41059,37208,25182,32085,37259
48279,TX,7644,5523,4457,8554,6745,3916,4220,5523,4233.42864,4828,8554,34698,3068,-8958,-2055,3119,41059,37766,25740,32643,37817
48281,TX,7644,5523,4457,8554,6745,3916,4220,5828,4073.676616,4828,8792,35082,3485,-8541,-1697,3536,41059,38567,26541,33385,38618
48283,TX,7644,5523,4457,8554,6745,3916,4220,5523,3482.594126,4828,8554,33948,3068,-8958,-2055,3119,41059,37016,24990,31893,37067
48285,TX,7644,5523,4457,8554,6745,3916,4220,5523,3738.197365,4828,8554,34203,3068,-8958,-2055,3119,41059,37271,25245,32148,37322
48287,TX,7644,5523,4457,8554,6745,3916,4220,5523,4281.354247,4828,8554,34746,3068,-8958,-2055,3119,41059,37814,25788,32691,37865
48289,TX,7824,5523,4457,8554,6745,3916,4241,5523,4073.676616,4828,8554,34719,3485,-8541,-1697,3536,41260,38204,26178,33022,38255
48291,TX,11112,5523,4457,8554,6745,3916,4620,6273,4009.775806,4828,8942,39080,5153,-6873,-263,5204,44927,44233,32207,38817,44284
48293,TX,9036,5523,4457,8554,6745,3916,4381,5523,3818.073377,4828,8554,35675,3902,-8124,-1338,3953,42612,39577,27551,34337,39628
48295,TX,7644,5523,4457,8554,6745,3916,4220,5523,4409.155866,4828,8554,34874,3068,-8958,-2055,3119,41059,37942,25916,32819,37993
48297,TX,7644,5523,4457,8554,6745,3916,4220,5523,3770.14777,4828,8554,34235,3068,-8958,-2055,3119,41059,37303,25277,32180,37354
48299,TX,7644,5523,4457,8554,6745,3916,4220,5523,3913.924591,4828,8554,34379,3068,-8958,-2055,3119,41059,37447,25421,32324,37498
48301,TX,7836,5523,4457,8554,6745,3916,4242,5523,4680.734307,4828,8554,35338,3485,-8541,-1697,3536,41273,38823,26797,33641,38874
48303,TX,9288,5523,4457,8554,6745,3916,4410,5980,4233.42864,4828,8407,36652,3902,-8124,-1338,3953,42893,40554,28528,35314,40605
48305,TX,7644,5523,4457,8554,6745,3916,4220,5286,4233.42864,4828,8409,34316,3068,-8958,-2055,3119,41059,37384,25358,32261,37435
48307,TX,7644,5523,4457,8554,6745,3916,4220,5523,4249.403842,4828,8554,34714,3068,-8958,-2055,3119,41059,37782,25756,32659,37833
48309,TX,9060,5523,4457,8554,6745,3916,4383,5907,3754.172567,4828,8348,35813,3902,-8124,-1338,3953,42638,39715,27689,34475,39766
48311,TX,7836,5523,4457,8554,6745,3916,4242,5523,3834.048579,4828,8554,34491,3485,-8541,-1697,3536,41273,37976,25950,32794,38027
48313,TX,7644,5523,4457,8554,6745,3916,4220,5523,4121.602223,4828,8554,34587,3068,-8958,-2055,3119,41059,37655,25629,32532,37706
48315,TX,7644,5523,4457,8554,6745,3916,4220,5523,4329.279854,4828,8554,34794,3068,-8958,-2055,3119,41059,37862,25836,32739,37913
48317,TX,7644,5523,4457,8554,6745,3916,4220,5339,4057.701413,4828,9236,35021,3485,-8541,-1697,3536,41059,38506,26480,33324,38557
48319,TX,7644,5523,4457,8554,6745,3916,4220,5523,3993.800604,4828,8554,34459,3068,-8958,-2055,3119,41059,37527,25501,32404,37578
48321,TX,8604,5523,4457,8554,6745,3916,4331,5725,3674.296555,4828,8351,35099,3485,-8541,-1697,3536,42130,38584,26558,33402,38635
48323,TX,7644,5523,4457,8554,6745,3916,4220,5534,3147.114876,4828,8142,33211,3068,-8958,-2055,3119,41059,36279,24253,31156,36330
48325,TX,8316,5523,4457,8554,6745,3916,4298,6295,3578.445341,4828,8741,35674,3902,-8124,-1338,3953,41809,39576,27550,34336,39627
48327,TX,7644,5523,4457,8554,6745,3916,4220,5523,3881.974187,4828,8554,34347,3068,-8958,-2055,3119,41059,37415,25389,32292,37466
48329,TX,11220,5523,4457,8554,6745,3916,4632,6316,4169.52783,4828,9333,39783,5399,-6627,96,5450,45047,45182,33156,39879,45233
48331,TX,7644,5523,4457,8554,6745,3916,4220,5523,4153.552628,4828,8554,34619,3068,-8958,-2055,3119,41059,37687,25661,32564,37738
48333,TX,7644,5523,4457,8554,6745,3916,4220,5523,3993.800604,4828,8554,34459,3068,-8958,-2055,3119,41059,37527,25501,32404,37578
48335,TX,7644,5523,4457,8554,6745,3916,4220,5523,4025.751008,4828,8554,34491,3068,-8958,-2055,3119,41059,37559,25533,32436,37610
48337,TX,7944,5523,4457,8554,6745,3916,4255,5523,4169.52783,4828,8554,34935,3485,-8541,-1697,3536,41394,38420,26394,33238,38471
48339,TX,11112,5523,4457,8554,6745,3916,4620,6624,4473.056676,4828,8975,39928,5153,-6873,-263,5204,44927,45081,33055,39665,45132
48341,TX,8196,5523,4457,8554,6745,3916,4284,5619,4345.255057,4828,9235,36140,3902,-8124,-1338,3953,41675,40042,28016,34802,40093
48343,TX,7644,5523,4457,8554,6745,3916,4220,5523,4169.52783,4828,8554,34635,3068,-8958,-2055,3119,41059,37703,25677,32580,37754
48345,TX,7644,5523,4457,8554,6745,3916,4220,5523,4313.304652,4828,8554,34778,3068,-8958,-2055,3119,41059,37846,25820,32723,37897
48347,TX,8592,5523,4457,8554,6745,3916,4329,5988,4393.180664,4828,7740,35457,3485,-8541,-1697,3536,42116,38942,26916,33760,38993
48349,TX,8784,5523,4457,8554,6745,3916,4352,5716,3770.14777,4828,8207,35221,3485,-8541,-1697,3536,42331,38706,26680,33524,38757
48351,TX,7644,5523,4457,8554,6745,3916,4220,5636,4089.651818,4828,8239,34352,3068,-8958,-2055,3119,41059,37420,25394,32297,37471
48353,TX,7644,5523,4457,8554,6745,3916,4220,5037,3961.850199,4828,7859,33246,2651,-9375,-2414,2702,41059,35897,23871,30832,35948
48355,TX,10068,5523,4457,8554,6745,3916,4500,6087,3818.073377,4828,8531,37248,4319,-7707,-980,4370,43763,41567,29541,36268,41618
48357,TX,7728,5523,4457,8554,6745,3916,4230,5523,4233.42864,4828,8554,34782,3485,-8541,-1697,3536,41153,38267,26241,33085,38318
48359,TX,8196,5523,4457,8554,6745,3916,4284,5428,4345.255057,4828,8530,35243,3485,-8541,-1697,3536,41675,38728,26702,33546,38779
48361,TX,9672,5523,4457,8554,6745,3916,4454,5747,4089.651818,4828,8207,36459,3902,-8124,-1338,3953,43321,40361,28335,35121,40412
48363,TX,8628,5523,4457,8554,6745,3916,4334,5926,4233.42864,4828,8182,35714,3485,-8541,-1697,3536,42157,39199,27173,34017,39250
48365,TX,7644,5523,4457,8554,6745,3916,4220,5523,3977.825401,4828,8554,34443,3068,-8958,-2055,3119,41059,37511,25485,32388,37562
48367,TX,11256,5523,4457,8554,6745,3916,4636,6359,4792.560724,4828,8886,40037,5153,-6873,-263,5204,45087,45190,33164,39774,45241
48369,TX,7644,5523,4457,8554,6745,3916,4220,5523,4505.007081,4828,8554,34970,3068,-8958,-2055,3119,41059,38038,26012,32915,38089
48371,TX,7752,5523,4457,8554,6745,3916,4233,5523,4089.651818,4828,8554,34663,3485,-8541,-1697,3536,41180,38148,26122,32966,38199
48373,TX,7644,5523,4457,8554,6745,3916,4220,5523,3977.825401,4828,8554,34443,3068,-8958,-2055,3119,41059,37511,25485,32388,37562
48375,TX,8832,5523,4457,8554,6745,3916,4357,5712,4153.552628,4828,8537,35978,3902,-8124,-1338,3953,42384,39880,27854,34640,39931
48377,TX,7644,5523,4457,8554,6745,3916,4220,5523,4744.635117,4828,8554,35210,3068,-8958,-2055,3119,41059,38278,26252,33155,38329
48379,TX,7644,5523,4457,8554,6745,3916,4220,5523,4409.155866,4828,8554,34874,3068,-8958,-2055,3119,41059,37942,25916,32819,37993
48381,TX,8832,5523,4457,8554,6745,3916,4357,6041,4712.684712,4828,8535,36865,3902,-8124,-1338,3953,42384,40767,28741,35527,40818
48383,TX,7644,5523,4457,8554,6745,3916,4220,5523,3993.800604,4828,8554,34459,3068,-8958,-2055,3119,41059,37527,25501,32404,37578
48385,TX,7644,5523,4457,8554,6745,3916,4220,5523,3929.899794,4828,8554,34395,3068,-8958,-2055,3119,41059,37463,25437,32340,37514
48387,TX,7644,5523,4457,8554,6745,3916,4220,5523,4153.552628,4828,8554,34619,3068,-8958,-2055,3119,41059,37687,25661,32564,37738
48389,TX,7644,5523,4457,8554,6745,3916,4220,5254,4137.577425,4828,8464,34243,3068,-8958,-2055,3119,41059,37311,25285,32188,37362
48391,TX,7800,5523,4457,8554,6745,3916,4238,5523,3770.14777,4828,8554,34391,3485,-8541,-1697,3536,41233,37876,25850,32694,37927
48393,TX,7836,5523,4457,8554,6745,3916,4242,5523,4505.007081,4828,8554,35162,3485,-8541,-1697,3536,41273,38647,26621,33465,38698
48395,TX,10416,5523,4457,8554,6745,3916,4540,5830,3929.899794,4828,8029,36949,4319,-7707,-980,4370,44151,41268,29242,35969,41319
48397,TX,10956,5523,4457,8554,6745,3916,4602,6528,4489.031878,4828,8884,39601,5153,-6873,-263,5204,44753,44754,32728,39338,44805
48399,TX,7644,5523,4457,8554,6745,3916,4220,5523,3913.924591,4828,8554,34379,3068,-8958,-2055,3119,41059,37447,25421,32324,37498
48401,TX,8184,5523,4457,8554,6745,3916,4282,5618,4233.42864,4828,8372,35152,3485,-8541,-1697,3536,41661,38637,26611,33455,38688
48403,TX,7644,5523,4457,8554,6745,3916,4220,5523,4201.478235,4828,8554,34666,3068,-8958,-2055,3119,41059,37734,25708,32611,37785
48405,TX,7644,5523,4457,8554,6745,3916,4220,5523,4201.478235,4828,8554,34666,3068,-8958,-2055,3119,41059,37734,25708,32611,37785
48407,TX,11112,5523,4457,8554,6745,3916,4620,5523,4648.783903,4828,8554,38582,4736,-7290,-621,4787,44927,43318,31292,37961,43369
48409,TX,10068,5523,4457,8554,6745,3916,4500,5840,3690.271758,4828,8528,36870,4319,-7707,-980,4370,43763,41189,29163,35890,41240
48411,TX,7644,5523,4457,8554,6745,3916,4220,5523,3977.825401,4828,8554,34443,3068,-8958,-2055,3119,41059,37511,25485,32388,37562
48413,TX,7644,5523,4457,8554,6745,3916,4220,5523,3865.998984,4828,8554,34331,3068,-8958,-2055,3119,41059,37399,25373,32276,37450
48415,TX,7644,5523,4457,8554,6745,3916,4220,5338,4009.775806,4828,8356,34092,3068,-8958,-2055,3119,41059,37160,25134,32037,37211
48417,TX,7644,5523,4457,8554,6745,3916,4220,5523,3961.850199,4828,8554,34427,3068,-8958,-2055,3119,41059,37495,25469,32372,37546
48419,TX,7644,5523,4457,8554,6745,3916,4220,5523,4265.379045,4828,8554,34730,3068,-8958,-2055,3119,41059,37798,25772,32675,37849
48421,TX,7644,5523,4457,8554,6745,3916,4220,5523,4281.354247,4828,8554,34746,3068,-8958,-2055,3119,41059,37814,25788,32691,37865
48423,TX,10500,5523,4457,8554,6745,3916,4549,6125,4393.180664,4828,8419,38181,4736,-7290,-621,4787,44244,42917,30891,37560,42968
48425,TX,7644,5523,4457,8554,6745,3916,4220,6031,3977.825401,4828,8878,35276,3485,-8541,-1697,3536,41059,38761,26735,33579,38812
48427,TX,7644,5523,4457,8554,6745,3916,4220,4916,3706.24696,4828,8045,33055,2651,-9375,-2414,2702,41059,35706,23680,30641,35757
48429,TX,7944,5523,4457,8554,6745,3916,4255,5523,4313.304652,4828,8554,35078,3485,-8541,-1697,3536,41394,38563,26537,33381,38614
48431,TX,8328,5523,4457,8554,6745,3916,4299,5523,4025.751008,4828,8554,35175,3485,-8541,-1697,3536,41822,38660,26634,33478,38711
48433,TX,7644,5523,4457,8554,6745,3916,4220,5523,4345.255057,4828,8554,34810,3068,-8958,-2055,3119,41059,37878,25852,32755,37929
48435,TX,7644,5523,4457,8554,6745,3916,4220,5523,3658.321353,4828,8554,34123,3068,-8958,-2055,3119,41059,37191,25165,32068,37242
48437,TX,7644,5523,4457,8554,6745,3916,4220,5523,4329.279854,4828,8554,34794,3068,-8958,-2055,3119,41059,37862,25836,32739,37913
48439,TX,11256,5523,4457,8554,6745,3916,4636,6391,4345.255057,4828,8920,39657,5153,-6873,-263,5204,45087,44810,32784,39394,44861
48441,TX,9480,5523,4457,8554,6745,3916,4432,5694,3913.924591,4828,8246,36078,3902,-8124,-1338,3953,43107,39980,27954,34740,40031
48443,TX,7644,5523,4457,8554,6745,3916,4220,5523,3562.470138,4828,8554,34027,3068,-8958,-2055,3119,41059,37095,25069,31972,37146
48445,TX,7644,5523,4457,8554,6745,3916,4220,5523,4233.42864,4828,8554,34698,3068,-8958,-2055,3119,41059,37766,25740,32643,37817
48447,TX,7644,5523,4457,8554,6745,3916,4220,5523,4425.131069,4828,8554,34890,3068,-8958,-2055,3119,41059,37958,25932,32835,38009
48449,TX,7644,5523,4457,8554,6745,3916,4220,5653,4089.651818,4828,8550,34680,3485,-8541,-1697,3536,41059,38165,26139,32983,38216
48451,TX,8760,5523,4457,8554,6745,3916,4349,5685,3865.998984,4828,8315,35370,3485,-8541,-1697,3536,42304,38855,26829,33673,38906
48453,TX,12888,5523,4457,8554,6745,3916,4824,7136,4377.205461,4828,9157,42302,5852,-6174,813,5903,46907,48154,36128,43115,48205
48455,TX,7644,5523,4457,8554,6745,3916,4220,5925,4057.701413,4828,7304,33674,3068,-8958,-2055,3119,41059,36742,24716,31619,36793
48457,TX,7644,5523,4457,8554,6745,3916,4220,5523,4153.552628,4828,8554,34619,3068,-8958,-2055,3119,41059,37687,25661,32564,37738
48459,TX,9576,5523,4457,8554,6745,3916,4443,5840,4153.552628,4828,8375,36689,3902,-8124,-1338,3953,43214,40591,28565,35351,40642
48461,TX,7644,5523,4457,8554,6745,3916,4220,5523,4089.651818,4828,8554,34555,3068,-8958,-2055,3119,41059,37623,25597,32500,37674
48463,TX,7644,5523,4457,8554,6745,3916,4220,5512,3626.370948,4828,7948,33474,3068,-8958,-2055,3119,41059,36542,24516,31419,36593
48465,TX,7644,5523,4457,8554,6745,3916,4220,5708,3370.767709,4828,8615,34082,3485,-8541,-1697,3536,41059,37567,25541,32385,37618
48467,TX,8688,5523,4457,8554,6745,3916,4341,5523,4329.279854,4828,8554,35838,3485,-8541,-1697,3536,42224,39323,27297,34141,39374
48469,TX,8772,5523,4457,8554,6745,3916,4350,5929,3834.048579,4828,8579,35858,3902,-8124,-1338,3953,42317,39760,27734,34520,39811
48471,TX,8568,5523,4457,8554,6745,3916,4327,6518,4201.478235,4828,7199,35231,3485,-8541,-1697,3536,42090,38716,26690,33534,38767
48473,TX,11112,5523,4457,8554,6745,3916,4620,6472,4776.585522,4828,8958,40062,5153,-6873,-263,5204,44927,45215,33189,39799,45266
48475,TX,7644,5523,4457,8554,6745,3916,4220,5523,4009.775806,4828,8554,34475,3068,-8958,-2055,3119,41059,37543,25517,32420,37594
48477,TX,8784,5523,4457,8554,6745,3916,4352,5942,4089.651818,4828,8276,35836,3902,-8124,-1338,3953,42331,39738,27712,34498,39789
48479,TX,9324,5523,4457,8554,6745,3916,4414,6009,3322.842102,4828,8746,36146,4319,-7707,-980,4370,42933,40465,28439,35166,40516
48481,TX,8448,5523,4457,8554,6745,3916,4313,5688,3754.172567,4828,8389,35023,3485,-8541,-1697,3536,41956,38508,26482,33326,38559
48483,TX,7644,5523,4457,8554,6745,3916,4220,5523,4473.056676,4828,8554,34938,3068,-8958,-2055,3119,41059,38006,25980,32883,38057
48485,TX,8544,5523,4457,8554,6745,3916,4324,5693,3993.800604,4828,8280,35255,3485,-8541,-1697,3536,42063,38740,26714,33558,38791
48487,TX,8052,5523,4457,8554,6745,3916,4267,5012,4057.701413,4828,8060,33926,3068,-8958,-2055,3119,41514,36994,24968,31871,37045
48489,TX,7716,5523,4457,8554,6745,3916,4229,5263,3195.040483,4828,7644,32562,2651,-9375,-2414,2702,41140,35213,23187,30148,35264
48491,TX,12888,5523,4457,8554,6745,3916,4824,6413,4297.329449,4828,9125,41467,5625,-6401,454,5676,46907,47092,35066,41921,47143
48493,TX,10284,5523,4457,8554,6745,3916,4524,6250,4041.726211,4828,8735,38054,4736,-7290,-621,4787,44003,42790,30764,37433,42841
48495,TX,7644,5523,4457,8554,6745,3916,4220,5523,4137.577425,4828,8554,34603,3068,-8958,-2055,3119,41059,37671,25645,32548,37722
48497,TX,9540,5523,4457,8554,6745,3916,4439,6357,4536.957486,4828,8883,38061,4319,-7707,-980,4370,43174,42380,30354,37081,42431
48499,TX,7956,5523,4457,8554,6745,3916,4256,5523,4377.205461,4828,8554,35154,3485,-8541,-1697,3536,41407,38639,26613,33457,38690
48501,TX,7836,5523,4457,8554,6745,3916,4242,5523,4600.858295,4828,8554,35258,3485,-8541,-1697,3536,41273,38743,26717,33561,38794
48503,TX,8796,5523,4457,8554,6745,3916,4353,5523,4057.701413,4828,8554,35675,3902,-8124,-1338,3953,42344,39577,27551,34337,39628
48505,TX,7644,5523,4457,8554,6745,3916,4220,5865,3402.718114,4828,7928,33584,3068,-8958,-2055,3119,41059,36652,24626,31529,36703
48507,TX,7644,5523,4457,8554,6745,3916,4220,5523,3402.718114,4828,8554,33868,3068,-8958,-2055,3119,41059,36936,24910,31813,36987
49001,UT,7488,12784,5319,7382,5433,3971,5776,12784,5261.902637,4629,7382,41516,7293,-4650,2205,7427,48153,48809,36866,43721,48943
49003,UT,7476,12784,5319,7382,5433,3971,5774,12306,5547.875606,4629,8139,42069,7293,-4650,2205,7427,48139,49362,37419,44274,49496
49005,UT,7644,12784,5319,7382,5433,3971,5802,13476,5223.772908,4629,7752,42696,7570,-4373,2614,7704,48335,50266,38323,45310,50400
49007,UT,7476,12784,5319,7382,5433,3971,5774,12417,5414.421554,4629,7167,41075,7017,-4926,1797,7151,48139,48092,36149,42872,48226
49009,UT,9264,12784,5319,7382,5433,3971,6069,12784,5910.108034,4629,7382,43940,7846,-4097,3022,7980,50222,51786,39843,46962,51920
49011,UT,9264,12784,5319,7382,5433,3971,6069,14112,5204.708043,4629,8213,45394,8399,-3544,3839,8533,50222,53793,41850,49233,53927
49013,UT,8064,12784,5319,7382,5433,3971,5871,12784,5147.513449,4629,7382,41978,7570,-4373,2614,7704,48824,49548,37605,44592,49682
49015,UT,7476,12784,5319,7382,5433,3971,5774,12784,5185.643178,4629,7382,41428,7293,-4650,2205,7427,48139,48721,36778,43633,48855
49017,UT,7860,12784,5319,7382,5433,3971,5837,12784,5261.902637,4629,7382,41888,7293,-4650,2205,7427,48586,49181,37238,44093,49315
49019,UT,8400,12784,5319,7382,5433,3971,5926,12784,5852.91344,4629,7382,43019,7570,-4373,2614,7704,49215,50589,38646,45633,50723
49021,UT,7476,12784,5319,7382,5433,3971,5774,14030,5357.22696,4629,7290,42753,7570,-4373,2614,7704,48139,50323,38380,45367,50457
49023,UT,8748,12784,5319,7382,5433,3971,5984,11804,5147.513449,4629,8084,42383,7570,-4373,2614,7704,49621,49953,38010,44997,50087
49025,UT,9480,12784,5319,7382,5433,3971,6105,12784,5586.005336,4629,7382,43832,7846,-4097,3022,7980,50474,51678,39735,46854,51812
49027,UT,7476,12784,5319,7382,5433,3971,5774,12784,5128.448585,4629,7382,41370,7293,-4650,2205,7427,48139,48663,36720,43575,48797
49029,UT,9264,12784,5319,7382,5433,3971,6069,13178,5128.448585,4629,8099,44269,8123,-3820,3431,8257,50222,52392,40449,47700,52526
49031,UT,9348,12784,5319,7382,5433,3971,6083,12784,5223.772908,4629,7382,43338,7846,-4097,3022,7980,50320,51184,39241,46360,51318
49033,UT,9444,12784,5319,7382,5433,3971,6099,12784,5166.578314,4629,7382,43377,7846,-4097,3022,7980,50432,51223,39280,46399,51357
49035,UT,10512,12784,5319,7382,5433,3971,6275,15271,5109.38372,4629,8260,47752,8952,-2991,4656,9086,51676,56704,44761,52408,56838
49037,UT,7476,12784,5319,7382,5433,3971,5774,12784,5738.524253,4629,7382,41981,7293,-4650,2205,7427,48139,49274,37331,44186,49408
49039,UT,7644,12784,5319,7382,5433,3971,5802,12784,5242.837772,4629,7382,41653,7293,-4650,2205,7427,48335,48946,37003,43858,49080
49041,UT,7476,12784,5319,7382,5433,3971,5774,12784,5185.643178,4629,7382,41428,7293,-4650,2205,7427,48139,48721,36778,43633,48855
49043,UT,10968,12784,5319,7382,5433,3971,6351,17098,6748.962078,4629,8172,51587,9782,-2161,5882,9916,52208,61369,49426,57469,61503
49045,UT,9204,12784,5319,7382,5433,3971,6059,12857,5319.097231,4629,8144,44124,8123,-3820,3431,8257,50152,52247,40304,47555,52381
49047,UT,10896,12784,5319,7382,5433,3971,6339,13630,5566.940471,4629,8019,46712,8676,-3267,4248,8810,52124,55388,43445,50960,55522
49049,UT,8748,12784,5319,7382,5433,3971,5984,14945,5052.189126,4629,8216,45561,8399,-3544,3839,8533,49621,53960,42017,49400,54094
49051,UT,10092,12784,5319,7382,5433,3971,6206,14240,5929.172899,4629,8222,47083,8676,-3267,4248,8810,51187,55759,43816,51331,55893
49053,UT,9036,12784,5319,7382,5433,3971,6032,13914,5242.837772,4629,7373,44165,8123,-3820,3431,8257,49957,52288,40345,47596,52422
49055,UT,7476,12784,5319,7382,5433,3971,5774,12784,5566.940471,4629,7382,41809,7293,-4650,2205,7427,48139,49102,37159,44014,49236
49057,UT,9264,12784,5319,7382,5433,3971,6069,13776,4956.864803,4629,8217,44814,8399,-3544,3839,8533,50222,53213,41270,48653,53347
50001,VT,10440,7312,5176,6855,6181,3644,5977,7312,6975.668731,8367,6855,43594,7326,-4723,2132,7354,45585,50920,38871,45726,50948
50003,VT,10032,7312,5176,6855,6181,3644,5915,8462,5565.693136,8367,6551,42621,7603,-4446,2541,7631,45115,50224,38175,45162,50252
50005,VT,8136,7312,5176,6855,6181,3644,5629,7312,6419.099417,8367,6855,40733,6754,-5295,1315,6782,42933,47487,35438,42048,47515
50007,VT,15708,7312,5176,6855,6181,3644,6771,6721,6066.605519,8367,7177,47683,8709,-3340,4175,8737,51647,56392,44343,51858,56420
50009,VT,8088,7312,5176,6855,6181,3644,5622,6941,6215.024002,8367,6289,39544,6287,-5762,907,6315,42878,45831,33782,40451,45859
50011,VT,15708,7312,5176,6855,6181,3644,6771,6570,6493.308659,8367,7158,47940,8709,-3340,4175,8737,51647,56649,44600,52115,56677
50013,VT,15708,7312,5176,6855,6181,3644,6771,8152,5751.216241,8367,7167,48789,9262,-2787,4992,9290,51647,58051,46002,53781,58079
50015,VT,11304,7312,5176,6855,6181,3644,6107,7312,6901.459489,8367,6855,44383,7603,-4446,2541,7631,46579,51986,39937,46924,52014
50017,VT,9768,7312,5176,6855,6181,3644,5875,9755,6715.936385,8367,6721,44972,7879,-4170,2949,7907,44811,52851,40802,47921,52879
50019,VT,8484,7312,5176,6855,6181,3644,5682,7312,6103.71014,8367,6855,40766,6754,-5295,1315,6782,43334,47520,35471,42081,47548
50021,VT,9900,7312,5176,6855,6181,3644,5895,6592,5565.693136,8367,6574,40642,7050,-4999,1724,7078,44963,47692,35643,42366,47720
50023,VT,10800,7312,5176,6855,6181,3644,6031,8848,6827.250247,8367,6782,45268,7879,-4170,2949,7907,45999,53147,41098,48217,53175
50025,VT,9984,7312,5176,6855,6181,3644,5908,7312,6567.517901,8367,6855,42730,7326,-4723,2132,7354,45060,50056,38007,44862,50084
50027,VT,10620,7312,5176,6855,6181,3644,6004,8311,6994.221041,8367,6715,44650,7603,-4446,2541,7631,45792,52253,40204,47191,52281
51001,VA,8808,10636,4457,8554,6742,3916,5703,10636,4393.180664,5164,8554,41471,4162,-7915,-1060,4162,48816,45633,33556,40411,45633
51003,VA,12096,10636,4457,8554,6742,3916,6181,10756,4968.287951,5164,8423,45323,4948,-7129,122,4948,52582,50271,38194,45445,50271
51005,VA,7404,10636,4457,8554,6742,3916,5499,10636,4632.8087,5164,8554,40307,3900,-8177,-1454,3900,47208,44207,32130,38853,44207
51007,VA,11808,10636,4457,8554,6742,3916,6139,11776,4648.783903,5164,8675,45989,5210,-6867,516,5210,52252,51199,39122,46505,51199
51009,VA,7884,10636,4457,8554,6742,3916,5569,9686,4425.131069,5164,8262,39337,3619,-8458,-1848,3619,47758,42956,30879,37489,42956
51011,VA,7884,10636,4457,8554,6742,3916,5569,10676,4505.007081,5164,8257,40403,3900,-8177,-1454,3900,47758,44303,32226,38949,44303
51013,VA,17628,10636,4457,8554,6742,3916,6984,10850,5878.874488,5164,10265,53702,8962,-3115,5192,8962,58917,62664,50587,58894,62664
51015,VA,8628,10636,4457,8554,6742,3916,5677,10338,4568.90789,5164,8238,40852,3900,-8177,-1454,3900,48610,44752,32675,39398,44752
51017,VA,7404,10636,4457,8554,6742,3916,5499,10636,4600.858295,5164,8554,40275,3900,-8177,-1454,3900,47208,44175,32098,38821,44175
51019,VA,7884,10636,4457,8554,6742,3916,5569,10633,4840.486331,5164,8256,40693,3900,-8177,-1454,3900,47758,44593,32516,39239,44593
51021,VA,7404,10636,4457,8554,6742,3916,5499,10636,4425.131069,5164,8554,40099,3900,-8177,-1454,3900,47208,43999,31922,38645,43999
51023,VA,8640,10636,4457,8554,6742,3916,5679,10936,4856.461534,5164,8251,41764,4162,-7915,-1060,4162,48624,45926,33849,40704,45926
51025,VA,7404,10636,4457,8554,6742,3916,5499,10636,4233.42864,5164,8554,39907,3900,-8177,-1454,3900,47208,43807,31730,38453,43807
51027,VA,7404,10636,4457,8554,6742,3916,5499,10636,4297.329449,5164,8554,39971,3900,-8177,-1454,3900,47208,43871,31794,38517,43871
51029,VA,7764,10636,4457,8554,6742,3916,5552,10899,4712.684712,5164,8444,40899,3900,-8177,-1454,3900,47621,44799,32722,39445,44799
51031,VA,7884,10636,4457,8554,6742,3916,5569,11524,4377.205461,5164,8251,41116,4162,-7915,-1060,4162,47758,45278,33201,40056,45278
51033,VA,11808,10636,4457,8554,6742,3916,6139,10253,4520.982283,5164,8663,44326,4948,-7129,122,4948,52252,49274,37197,44448,49274
51035,VA,7404,10636,4457,8554,6742,3916,5499,10636,4297.329449,5164,8554,39971,3900,-8177,-1454,3900,47208,43871,31794,38517,43871
51036,VA,11808,10636,4457,8554,6742,3916,6139,9801,4792.560724,5164,8671,44152,4686,-7391,-272,4686,52252,48838,36761,43880,48838
51037,VA,7404,10636,4457,8554,6742,3916,5499,10636,4393.180664,5164,8554,40067,3900,-8177,-1454,3900,47208,43967,31890,38613,43967
51041,VA,11808,10636,4457,8554,6742,3916,6139,9775,4728.659915,5164,8677,44068,4686,-7391,-272,4686,52252,48754,36677,43796,48754
51043,VA,17628,10636,4457,8554,6742,3916,6984,13809,4936.337546,5164,9702,55155,9486,-2591,5980,9486,58917,64641,52564,61135,64641
51045,VA,8640,10636,4457,8554,6742,3916,5679,10089,4680.734307,5164,8265,40754,3900,-8177,-1454,3900,48624,44654,32577,39300,44654
51047,VA,9888,10636,4457,8554,6742,3916,5860,10257,4361.230259,5164,9730,43316,4686,-7391,-272,4686,50053,48002,35925,43044,48002
51049,VA,11808,10636,4457,8554,6742,3916,6139,10636,4489.031878,5164,8554,44567,4948,-7129,122,4948,52252,49515,37438,44689,49515
51051,VA,7404,10636,4457,8554,6742,3916,5499,10241,4393.180664,5164,7413,38531,3166,-8911,-2242,3166,47208,41697,29620,36289,41697
51053,VA,11808,10636,4457,8554,6742,3916,6139,10027,4361.230259,5164,8670,43946,4948,-7129,122,4948,52252,48894,36817,44068,48894
51057,VA,9984,10636,4457,8554,6742,3916,5874,10636,4568.90789,5164,8554,42823,4424,-7653,-666,4424,50163,47247,35170,42157,47247
51059,VA,17628,10636,4457,8554,6742,3916,6984,10100,5479.494428,5164,9951,52238,8438,-3639,4404,8438,58917,60676,48599,56642,60676
51061,VA,17628,10636,4457,8554,6742,3916,6984,10188,5495.46963,5164,9712,52104,8438,-3639,4404,8438,58917,60542,48465,56508,60542
51063,VA,7404,10636,4457,8554,6742,3916,5499,9895,4584.883093,5164,8161,39125,3166,-8911,-2242,3166,47208,42291,30214,36883,42291
51065,VA,12096,10636,4457,8554,6742,3916,6181,10850,4968.287951,5164,8441,45435,4948,-7129,122,4948,52582,50383,38306,45557,50383
51067,VA,7404,10636,4457,8554,6742,3916,5499,10920,4536.957486,5164,8249,40189,3900,-8177,-1454,3900,47208,44089,32012,38735,44089
51069,VA,9648,10636,4457,8554,6742,3916,5825,9927,4441.106271,5164,8481,41577,4162,-7915,-1060,4162,49778,45739,33662,40517,45739
51071,VA,7404,10636,4457,8554,6742,3916,5499,10966,4744.635117,5164,8148,40342,3900,-8177,-1454,3900,47208,44242,32165,38888,44242
51073,VA,13560,10636,4457,8554,6742,3916,6393,10052,4712.684712,5164,8770,46175,5210,-6867,516,5210,54258,51385,39308,46691,51385
51075,VA,11808,10636,4457,8554,6742,3916,6139,10105,4824.511129,5164,8671,44488,4948,-7129,122,4948,52252,49436,37359,44610,49436
51077,VA,7404,10636,4457,8554,6742,3916,5499,10636,4489.031878,5164,8554,40163,3900,-8177,-1454,3900,47208,44063,31986,38709,44063
51079,VA,12096,10636,4457,8554,6742,3916,6181,13483,4888.411939,5164,8441,47989,5734,-6343,1304,5734,52582,53723,41646,49293,53723
51081,VA,7404,10636,4457,8554,6742,3916,5499,10636,4249.403842,5164,8554,39923,3900,-8177,-1454,3900,47208,43823,31746,38469,43823
51083,VA,7404,10636,4457,8554,6742,3916,5499,10636,4281.354247,5164,8554,39955,3900,-8177,-1454,3900,47208,43855,31778,38501,43855
51085,VA,11808,10636,4457,8554,6742,3916,6139,11642,4728.659915,5164,8673,45932,5210,-6867,516,5210,52252,51142,39065,46448,51142
51087,VA,11808,10636,4457,8554,6742,3916,6139,9725,4728.659915,5164,8685,44026,4686,-7391,-272,4686,52252,48712,36635,43754,48712
51089,VA,7404,10636,4457,8554,6742,3916,5499,10098,4345.255057,5164,7336,38263,3166,-8911,-2242,3166,47208,41429,29352,36021,41429
51091,VA,7404,10636,4457,8554,6742,3916,5499,10636,4536.957486,5164,8554,40211,3900,-8177,-1454,3900,47208,44111,32034,38757,44111
51093,VA,13560,10636,4457,8554,6742,3916,6393,10175,4776.585522,5164,8763,46355,5472,-6605,910,5472,54258,51827,39750,47265,51827
51095,VA,13560,10636,4457,8554,6742,3916,6393,10871,5814.973679,5164,8774,48100,5472,-6605,910,5472,54258,53572,41495,49010,53572
51097,VA,11808,10636,4457,8554,6742,3916,6139,10636,4872.436736,5164,8554,44950,4948,-7129,122,4948,52252,49898,37821,45072,49898
51099,VA,11568,10636,4457,8554,6742,3916,6104,10636,4728.659915,5164,8554,44567,4948,-7129,122,4948,51977,49515,37438,44689,49515
51101,VA,11808,10636,4457,8554,6742,3916,6139,9637,4824.511129,5164,8677,44027,4686,-7391,-272,4686,52252,48713,36636,43755,48713
51103,VA,9624,10636,4457,8554,6742,3916,5822,10636,4728.659915,5164,8554,42623,4424,-7653,-666,4424,49751,47047,34970,41957,47047
51105,VA,7404,10636,4457,8554,6742,3916,5499,10636,4265.379045,5164,8554,39939,3900,-8177,-1454,3900,47208,43839,31762,38485,43839
51107,VA,17628,10636,4457,8554,6742,3916,6984,10537,5335.717606,5164,9840,52420,8438,-3639,4404,8438,58917,60858,48781,56824,60858
51109,VA,8604,10636,4457,8554,6742,3916,5674,10636,4616.833498,5164,8554,41491,4162,-7915,-1060,4162,48583,45653,33576,40431,45653
51111,VA,7404,10636,4457,8554,6742,3916,5499,10636,4233.42864,5164,8554,39907,3900,-8177,-1454,3900,47208,43807,31730,38453,43807
51113,VA,8208,10636,4457,8554,6742,3916,5616,10636,4473.056676,5164,8554,40951,3900,-8177,-1454,3900,48129,44851,32774,39497,44851
51115,VA,13560,10636,4457,8554,6742,3916,6393,11264,4888.411939,5164,8771,47564,5734,-6343,1304,5734,54258,53298,41221,48868,53298
51117,VA,7404,10636,4457,8554,6742,3916,5499,10636,4249.403842,5164,8554,39923,3900,-8177,-1454,3900,47208,43823,31746,38469,43823
51119,VA,7548,10636,4457,8554,6742,3916,5520,10636,5000.238356,5164,8554,40818,3900,-8177,-1454,3900,47373,44718,32641,39364,44718
51121,VA,8592,10636,4457,8554,6742,3916,5672,10254,5096.08957,5164,8120,41142,3900,-8177,-1454,3900,48569,45042,32965,39688,45042
51125,VA,12096,10636,4457,8554,6742,3916,6181,10763,4776.585522,5164,8441,45157,4948,-7129,122,4948,52582,50105,38028,45279,50105
51127,VA,11808,10636,4457,8554,6742,3916,6139,11134,4824.511129,5164,8669,45516,5210,-6867,516,5210,52252,50726,38649,46032,50726
51131,VA,8496,10636,4457,8554,6742,3916,5658,10636,4664.759105,5164,8554,41431,4162,-7915,-1060,4162,48459,45593,33516,40371,45593
51133,VA,7896,10636,4457,8554,6742,3916,5571,10636,4760.610319,5164,8554,40927,3900,-8177,-1454,3900,47772,44827,32750,39473,44827
51135,VA,8592,10636,4457,8554,6742,3916,5672,10636,4249.403842,5164,8554,41111,4162,-7915,-1060,4162,48569,45273,33196,40051,45273
51137,VA,9924,10636,4457,8554,6742,3916,5865,10636,4680.734307,5164,8554,42875,4424,-7653,-666,4424,50094,47299,35222,42209,47299
51139,VA,7824,10636,4457,8554,6742,3916,5560,10636,4425.131069,5164,8554,40519,3900,-8177,-1454,3900,47689,44419,32342,39065,44419
51141,VA,7404,10636,4457,8554,6742,3916,5499,10636,4505.007081,5164,8554,40179,3900,-8177,-1454,3900,47208,44079,32002,38725,44079
51143,VA,7404,10636,4457,8554,6742,3916,5499,9694,4489.031878,5164,7520,38187,3166,-8911,-2242,3166,47208,41353,29276,35945,41353
51145,VA,11808,10636,4457,8554,6742,3916,6139,10980,4632.8087,5164,8675,45176,5210,-6867,516,5210,52252,50386,38309,45692,50386
51147,VA,8460,10636,4457,8554,6742,3916,5653,10636,4281.354247,5164,8554,41011,4162,-7915,-1060,4162,48418,45173,33096,39951,45173
51149,VA,11808,10636,4457,8554,6742,3916,6139,11668,4249.403842,5164,8667,45473,5210,-6867,516,5210,52252,50683,38606,45989,50683
51153,VA,17628,10636,4457,8554,6742,3916,6984,10319,4776.585522,5164,9840,51644,8438,-3639,4404,8438,58917,60082,48005,56048,60082
51155,VA,7404,10636,4457,8554,6742,3916,5499,13762,4536.957486,5164,8119,42903,4424,-7653,-666,4424,47208,47327,35250,42237,47327
51157,VA,11880,10636,4457,8554,6742,3916,6149,10187,4776.585522,5164,9651,45575,5210,-6867,516,5210,52334,50785,38708,46091,50785
51159,VA,8628,10636,4457,8554,6742,3916,5677,10636,4552.932688,5164,8554,41451,4162,-7915,-1060,4162,48610,45613,33536,40391,45613
51161,VA,8640,10636,4457,8554,6742,3916,5679,11069,4872.436736,5164,8218,41880,4162,-7915,-1060,4162,48624,46042,33965,40820,46042
51163,VA,7656,10636,4457,8554,6742,3916,5536,10636,4520.982283,5164,8554,40447,3900,-8177,-1454,3900,47497,44347,32270,38993,44347
51165,VA,8880,10636,4457,8554,6742,3916,5714,10302,4361.230259,5164,8455,41078,4162,-7915,-1060,4162,48899,45240,33163,40018,45240
51167,VA,7404,10636,4457,8554,6742,3916,5499,10636,4425.131069,5164,8554,40099,3900,-8177,-1454,3900,47208,43999,31922,38645,43999
51169,VA,7404,10636,4457,8554,6742,3916,5499,10690,4520.982283,5164,7655,39350,3619,-8458,-1848,3619,47208,42969,30892,37502,42969
51171,VA,8568,10636,4457,8554,6742,3916,5668,10636,4552.932688,5164,8554,41391,4162,-7915,-1060,4162,48541,45553,33476,40331,45553
51173,VA,7404,10636,4457,8554,6742,3916,5499,10636,4297.329449,5164,8554,39971,3900,-8177,-1454,3900,47208,43871,31794,38517,43871
51175,VA,8976,10636,4457,8554,6742,3916,5728,10636,4568.90789,5164,8554,41815,4162,-7915,-1060,4162,49009,45977,33900,40755,45977
51177,VA,17628,10636,4457,8554,6742,3916,6984,9889,4313.304652,5164,9720,50630,8438,-3639,4404,8438,58917,59068,46991,55034,59068
51179,VA,17628,10636,4457,8554,6742,3916,6984,10475,4568.90789,5164,9736,51488,8438,-3639,4404,8438,58917,59926,47849,55892,59926
51181,VA,13560,10636,4457,8554,6742,3916,6393,10636,4600.858295,5164,8554,46431,5472,-6605,910,5472,54258,51903,39826,47341,51903
51183,VA,11808,10636,4457,8554,6742,3916,6139,10590,4664.759105,5164,8676,44819,4948,-7129,122,4948,52252,49767,37690,44941,49767
51185,VA,7404,10636,4457,8554,6742,3916,5499,12722,4297.329449,5164,7386,40889,4162,-7915,-1060,4162,47208,45051,32974,39829,45051
51187,VA,10968,10636,4457,8554,6742,3916,6017,9901,4936.337546,5164,9749,44635,4948,-7129,122,4948,51290,49583,37506,44757,49583
51191,VA,7404,10636,4457,8554,6742,3916,5499,10611,4345.255057,5164,7607,39048,3619,-8458,-1848,3619,47208,42667,30590,37200,42667
51193,VA,8508,10636,4457,8554,6742,3916,5660,10636,4744.635117,5164,8554,41523,4162,-7915,-1060,4162,48473,45685,33608,40463,45685
51195,VA,7404,10636,4457,8554,6742,3916,5499,10394,4457.081474,5164,7392,38727,3166,-8911,-2242,3166,47208,41893,29816,36485,41893
51197,VA,7404,10636,4457,8554,6742,3916,5499,10636,4664.759105,5164,8554,40339,3900,-8177,-1454,3900,47208,44239,32162,38885,44239
51199,VA,13560,10636,4457,8554,6742,3916,6393,10308,4872.436736,5164,8777,46598,5472,-6605,910,5472,54258,52070,39993,47508,52070
51510,VA,17628,10636,4457,8554,6742,3916,6984,9603,6006.676108,5164,10231,52548,8438,-3639,4404,8438,58917,60986,48909,56952,60986
51515,VA,7884,10636,4457,8554,6742,3916,5569,11206,4648.783903,5164,8210,41029,3900,-8177,-1454,3900,47758,44929,32852,39575,44929
51520,VA,7404,10636,4457,8554,6742,3916,5499,11949,4505.007081,5164,7554,40492,3900,-8177,-1454,3900,47208,44392,32315,39038,44392
51530,VA,7656,10636,4457,8554,6742,3916,5536,10636,4568.90789,5164,8554,40495,3900,-8177,-1454,3900,47497,44395,32318,39041,44395
51540,VA,12096,10636,4457,8554,6742,3916,6181,9948,5719.122464,5164,8394,45237,4686,-7391,-272,4686,52582,49923,37846,44965,49923
51550,VA,13560,10636,4457,8554,6742,3916,6393,9846,4600.858295,5164,8790,45877,5210,-6867,516,5210,54258,51087,39010,46393,51087
51560,VA,7404,10636,4457,8554,6742,3916,5499,10636,4457,5164,8554,40131,3900,-8177,-1454,3900,47208,44031,31954,38677,44031
51570,VA,11808,10636,4457,8554,6742,3916,6139,10591,4600.858295,5164,8679,44759,4948,-7129,122,4948,52252,49707,37630,44881,49707
51580,VA,7404,10636,4457,8554,6742,3916,5499,10636,4313.304652,5164,8554,39987,3900,-8177,-1454,3900,47208,43887,31810,38533,43887
51590,VA,7404,10636,4457,8554,6742,3916,5499,10039,3993.800604,5164,7414,37931,3166,-8911,-2242,3166,47208,41097,29020,35689,41097
51595,VA,7404,10636,4457,8554,6742,3916,5499,10636,4201.478235,5164,8554,39875,3900,-8177,-1454,3900,47208,43775,31698,38421,43775
51600,VA,17628,10636,4457,8554,6742,3916,6984,9743,6182.403334,5164,9948,52582,8438,-3639,4404,8438,58917,61020,48943,56986,61020
51610,VA,17628,10636,4457,8554,6742,3916,6984,11625,5575.345643,5164,10080,53988,8962,-3115,5192,8962,58917,62950,50873,59180,62950
51620,VA,8976,10636,4457,8554,6742,3916,5728,10636,4536.957486,5164,8554,41783,4162,-7915,-1060,4162,49009,45945,33868,40723,45945
51630,VA,17628,10636,4457,8554,6742,3916,6984,13927,5303.767201,5164,9897,55836,9486,-2591,5980,9486,58917,65322,53245,61816,65322
51640,VA,7404,10636,4457,8554,6742,3916,5499,10636,4425.131069,5164,8554,40099,3900,-8177,-1454,3900,47208,43999,31922,38645,43999
51650,VA,13560,10636,4457,8554,6742,3916,6393,10084,4552.932688,5164,8801,46078,5210,-6867,516,5210,54258,51288,39211,46594,51288
51660,VA,8880,10636,4457,8554,6742,3916,5714,9794,4536.957486,5164,8438,40729,3900,-8177,-1454,3900,48899,44629,32552,39275,44629
51670,VA,11808,10636,4457,8554,6742,3916,6139,11416,4600.858295,5164,8684,45589,5210,-6867,516,5210,52252,50799,38722,46105,50799
51678,VA,7656,10636,4457,8554,6742,3916,5536,10636,4600.858295,5164,8554,40527,3900,-8177,-1454,3900,47497,44427,32350,39073,44427
51680,VA,7884,10636,4457,8554,6742,3916,5569,11472,4568.90789,5164,8214,41219,4162,-7915,-1060,4162,47758,45381,33304,40159,45381
51683,VA,17628,10636,4457,8554,6742,3916,6984,10197,4345.255057,5164,9927,51177,8438,-3639,4404,8438,58917,59615,47538,55581,59615
51685,VA,17628,10636,4457,8554,6742,3916,6984,9710,4792.560724,5164,9905,51116,8438,-3639,4404,8438,58917,59554,47477,55520,59554
51690,VA,7404,10636,4457,8554,6742,3916,5499,12944,4265.379045,5164,7251,40945,4162,-7915,-1060,4162,47208,45107,33030,39885,45107
51700,VA,13560,10636,4457,8554,6742,3916,6393,13947,4409.155866,5164,8805,49801,8175,-3902,4009,8175,54258,57976,45899,53810,57976
51710,VA,13560,10636,4457,8554,6742,3916,6393,11636,4584.883093,5164,8830,47691,5734,-6343,1304,5734,54258,53425,41348,48995,53425
51720,VA,7404,10636,4457,8554,6742,3916,5499,10805,4441.106271,5164,7303,39033,3619,-8458,-1848,3619,47208,42652,30575,37185,42652
51730,VA,11808,10636,4457,8554,6742,3916,6139,11331,4457.081474,5164,8686,45362,5210,-6867,516,5210,52252,50572,38495,45878,50572
51735,VA,13560,10636,4457,8554,6742,3916,6393,10045,4536.957486,5164,8768,45990,5210,-6867,516,5210,54258,51200,39123,46506,51200
51740,VA,13560,10636,4457,8554,6742,3916,6393,10551,4664.759105,5164,8807,46662,5472,-6605,910,5472,54258,52134,40057,47572,52134
51750,VA,8592,10636,4457,8554,6742,3916,5672,12364,4872.436736,5164,8077,42986,4424,-7653,-666,4424,48569,47410,35333,42320,47410
51760,VA,11808,10636,4457,8554,6742,3916,6139,12220,5399.618416,5164,8708,47216,5472,-6605,910,5472,52252,52688,40611,48126,52688
51770,VA,8640,10636,4457,8554,6742,3916,5679,9497,4409.155866,5164,8178,39805,3619,-8458,-1848,3619,48624,43424,31347,37957,43424
51775,VA,8640,10636,4457,8554,6742,3916,5679,11157,4696.70951,5164,8202,41776,4162,-7915,-1060,4162,48624,45938,33861,40716,45938
51790,VA,8628,10636,4457,8554,6742,3916,5677,11370,4760.610319,5164,8190,42029,4162,-7915,-1060,4162,48610,46191,34114,40969,46191
51800,VA,13560,10636,4457,8554,6742,3916,6393,10126,4744.635117,5164,8781,46292,5472,-6605,910,5472,54258,51764,39687,47202,51764
51810,VA,13560,10636,4457,8554,6742,3916,6393,10164,4872.436736,5164,8805,46481,5472,-6605,910,5472,54258,51953,39876,47391,51953
51820,VA,8628,10636,4457,8554,6742,3916,5677,11394,4712.684712,5164,8187,42002,4162,-7915,-1060,4162,48610,46164,34087,40942,46164
51830,VA,13560,10636,4457,8554,6742,3916,6393,10860,5144.015177,5164,8802,47446,5472,-6605,910,5472,54258,52918,40841,48356,52918
51840,VA,9648,10636,4457,8554,6742,3916,5825,10392,4728.659915,5164,8469,42317,4424,-7653,-666,4424,49778,46741,34664,41651,46741
53001,WA,7644,20148,5319,7382,5761,3971,4372,19185,5376.291825,4353,7503,48032,7019,-5042,2605,7035,54597,55051,42990,50637,55067
53003,WA,7908,20148,5319,7382,5761,3971,4403,19031,4994.994532,4353,6989,47247,7019,-5042,2605,7035,54892,54266,42205,49852,54282
53005,WA,9048,20148,5319,7382,5761,3971,4534,20903,5128.448585,4353,7672,51075,7699,-4362,3681,7715,56163,58774,46713,54756,58790
53007,WA,9708,20148,5319,7382,5761,3971,4610,20254,6177.016139,4353,7369,51832,7699,-4362,3681,7715,56899,59531,47470,55513,59547
53009,WA,9060,20148,5319,7382,5761,3971,4535,19190,5490.681012,4353,6733,48797,7246,-4815,2964,7262,56176,56043,43982,51761,56059
53011,WA,11064,20148,5319,7382,5761,3971,4766,22170,5357.22696,4353,7418,54333,8605,-3456,5115,8621,58411,62938,50877,59448,62954
53013,WA,7644,20148,5319,7382,5761,3971,4372,16810,5280.967502,4353,7063,45122,6566,-5495,1888,6582,54597,51688,39627,47010,51704
53015,WA,8196,20148,5319,7382,5761,3971,4436,19952,5490.681012,4353,7002,48965,7246,-4815,2964,7262,55213,56211,44150,51929,56227
53017,WA,9708,20148,5319,7382,5761,3971,4610,20565,5185.643178,4353,7369,51151,7699,-4362,3681,7715,56899,58850,46789,54832,58866
53019,WA,7644,20148,5319,7382,5761,3971,4372,20148,5452.551283,4353,7382,48951,7246,-4815,2964,7262,54597,56197,44136,51915,56213
53021,WA,9048,20148,5319,7382,5761,3971,4534,19167,5261.902637,4353,7662,49463,7472,-4589,3322,7488,56163,56935,44874,52785,56951
53023,WA,7644,20148,5319,7382,5761,3971,4372,20148,5376.291825,4353,7382,48874,7246,-4815,2964,7262,54597,56120,44059,51838,56136
53025,WA,7920,20148,5319,7382,5761,3971,4404,20451,5662.264794,4353,7353,49711,7472,-4589,3322,7488,54905,57183,45122,53033,57199
53027,WA,8232,20148,5319,7382,5761,3971,4440,18057,6138.88641,4353,6811,47563,6793,-5268,2247,6809,55253,54356,42295,49810,54372
53029,WA,10752,20148,5319,7382,5761,3971,4730,20712,6234.210733,4353,7147,53169,8152,-3909,4398,8168,58063,61321,49260,57567,61337
53031,WA,10860,20148,5319,7382,5761,3971,4743,20148,7073.064776,4353,7382,53787,8152,-3909,4398,8168,58184,61939,49878,58185,61955
53033,WA,13476,20148,5319,7382,5761,3971,5044,27365,6138.88641,4353,7873,63177,10417,-434,7983,10433,61101,73594,62743,71160,73610
53035,WA,11412,20148,5319,7382,5761,3971,4806,22267,5643.199929,4353,7637,55283,8605,-3456,5115,8621,58799,63888,51827,60398,63904
53037,WA,9540,20148,5319,7382,5761,3971,4591,20937,6653.637755,4353,6941,52396,7699,-4362,3681,7715,56712,60095,48034,56077,60111
53039,WA,7932,20148,5319,7382,5761,3971,4405,20148,5528.810742,4353,7382,49315,7472,-4589,3322,7488,54918,56787,44726,52637,56803
53041,WA,8796,20148,5319,7382,5761,3971,4505,19419,5700.394523,4353,6879,49119,7246,-4815,2964,7262,55882,56365,44304,52083,56381
53043,WA,7788,20148,5319,7382,5761,3971,4389,20148,5376.291825,4353,7382,49018,7246,-4815,2964,7262,54758,56264,44203,51982,56280
53045,WA,9888,20148,5319,7382,5761,3971,4631,19436,5719.459388,4353,6965,50333,7472,-4589,3322,7488,57100,57805,45744,53655,57821
53047,WA,7644,20148,5319,7382,5761,3971,4372,20148,5280.967502,4353,7382,48779,7246,-4815,2964,7262,54597,56025,43964,51743,56041
53049,WA,8340,20148,5319,7382,5761,3971,4452,20148,5509.745877,4353,7382,49704,7472,-4589,3322,7488,55373,57176,45115,53026,57192
53051,WA,7644,20148,5319,7382,5761,3971,4372,17165,5319.097231,4353,7087,45539,6566,-5495,1888,6582,54597,52105,40044,47427,52121
53053,WA,11988,20148,5319,7382,5761,3971,4873,23106,5605.0702,4353,7841,56864,9058,-2755,5832,9074,59442,65922,54109,62696,65938
53055,WA,10236,20148,5319,7382,5761,3971,4671,20148,5490.681012,4353,7382,51581,7699,-4362,3681,7715,57488,59280,47219,55262,59296
53057,WA,10896,20148,5319,7382,5761,3971,4747,21769,5452.551283,4353,7299,53741,8152,-3909,4398,8168,58224,61893,49832,58139,61909
53059,WA,11064,20148,5319,7382,5761,3971,4766,19154,5490.681012,4353,7417,51449,7699,-4362,3681,7715,58411,59148,47087,55130,59164
53061,WA,13476,20148,5319,7382,5761,3971,5044,24834,5738.524253,4353,7842,60215,9511,-1981,6549,9527,61101,69726,58234,66764,69742
53063,WA,8868,20148,5319,7382,5761,3971,4513,19863,5319.097231,4353,7036,49410,7472,-4589,3322,7488,55962,56882,44821,52732,56898
53065,WA,7644,20148,5319,7382,5761,3971,4372,18163,5414.421554,4353,7085,46630,6793,-5268,2247,6809,54597,53423,41362,48877,53439
53067,WA,11316,20148,5319,7382,5761,3971,4795,22099,5528.810742,4353,7650,54917,8605,-3456,5115,8621,58692,63522,51461,60032,63538
53069,WA,7644,20148,5319,7382,5761,3971,4372,20148,5490.681012,4353,7382,48989,7246,-4815,2964,7262,54597,56235,44174,51953,56251
53071,WA,8556,20148,5319,7382,5761,3971,4477,19577,6005.432357,4353,7040,49502,7246,-4815,2964,7262,55614,56748,44687,52466,56764
53073,WA,10620,20148,5319,7382,5761,3971,4715,22297,5280.967502,4353,7268,53790,8152,-3909,4398,8168,57916,61942,49881,58188,61958
53075,WA,8460,20148,5319,7382,5761,3971,4466,21595,6291.405327,4353,6520,51191,7699,-4362,3681,7715,55507,58890,46829,54872,58906
53077,WA,8784,20148,5319,7382,5761,3971,4503,19048,5300.032366,4353,7383,48839,7246,-4815,2964,7262,55868,56085,44024,51803,56101
54001,WV,7632,5369,4457,8554,4740,3916,5373,5369,4217.453437,6256,8554,35944,5062,-6896,-110,5181,40041,41006,29048,35834,41125
54003,WV,8892,5369,4457,8554,4740,3916,5568,5145,4265.379045,6256,8503,36977,5541,-6416,311,5661,41496,42518,30561,37288,42638
54005,WV,6876,5369,4457,8554,4740,3916,5255,5634,4233.42864,6256,8049,34965,4582,-7376,-532,4701,39167,39547,27589,34433,39666
54007,WV,6876,5369,4457,8554,4740,3916,5255,5369,4249.403842,6256,8554,35220,4582,-7376,-532,4701,39167,39802,27844,34688,39921
54009,WV,7368,5369,4457,8554,4740,3916,5332,5609,4409.155866,6256,7883,35442,4582,-7376,-532,4701,39736,40024,28066,34910,40143
54011,WV,7716,5369,4457,8554,4740,3916,5386,5986,4265.379045,6256,7952,36092,5062,-6896,-110,5181,40138,41154,29196,35982,41273
54013,WV,6876,5369,4457,8554,4740,3916,5255,5369,4153.552628,6256,8554,35125,4582,-7376,-532,4701,39167,39707,27749,34593,39826
54015,WV,8652,5369,4457,8554,4740,3916,5531,6192,4265.379045,6256,8068,37350,5541,-6416,311,5661,41219,42891,30934,37661,43011
54017,WV,7020,5369,4457,8554,4740,3916,5278,5143,4105.62702,6256,8082,34522,4102,-7856,-953,4221,39334,38624,26666,33569,38743
54019,WV,6876,5369,4457,8554,4740,3916,5255,5958,4265.379045,6256,7529,34800,4102,-7856,-953,4221,39167,38902,26944,33847,39021
54021,WV,7032,5369,4457,8554,4740,3916,5279,5369,4281.354247,6256,8554,35408,4582,-7376,-532,4701,39347,39990,28032,34876,40109
54023,WV,8316,5369,4457,8554,4740,3916,5479,5369,4313.304652,6256,8554,36724,5062,-6896,-110,5181,40831,41786,29828,36614,41905
54025,WV,7380,5369,4457,8554,4740,3916,5333,5369,4345.255057,6256,8554,35820,4582,-7376,-532,4701,39749,40402,28444,35288,40521
54027,WV,9648,5369,4457,8554,4740,3916,5685,5081,4265.379045,6256,8486,37653,5541,-6416,311,5661,42369,43194,31237,37964,43314
54029,WV,7368,5369,4457,8554,4740,3916,5332,5288,4600.858295,6256,7868,35297,4582,-7376,-532,4701,39736,39879,27921,34765,39998
54031,WV,7272,5369,4457,8554,4740,3916,5317,5369,4425.131069,6256,8554,35792,4582,-7376,-532,4701,39625,40374,28416,35260,40493
54033,WV,8952,5369,4457,8554,4740,3916,5577,5399,4041.726211,6256,8057,36622,5541,-6416,311,5661,41565,42163,30206,36933,42283
54035,WV,6876,5369,4457,8554,4740,3916,5255,5369,4233.42864,6256,8554,35204,4582,-7376,-532,4701,39167,39786,27828,34672,39905
54037,WV,10728,5369,4457,8554,4740,3916,5853,5016,4345.255057,6256,9695,39956,6809,-5148,1575,6929,43617,46765,34808,41531,46885
54039,WV,8652,5369,4457,8554,4740,3916,5531,4309,4281.354247,6256,8007,35422,4582,-7376,-532,4701,41219,40004,28046,34890,40123
54041,WV,7644,5369,4457,8554,4740,3916,5374,5369,4201.478235,6256,8554,35940,5062,-6896,-110,5181,40054,41002,29044,35830,41121
54043,WV,8652,5369,4457,8554,4740,3916,5531,6633,4968.287951,6256,8003,38428,5541,-6416,311,5661,41219,43969,32012,38739,44089
54045,WV,6876,5369,4457,8554,4740,3916,5255,5160,4169.52783,6256,7309,33686,3626,-8332,-1371,3745,39167,37312,25354,32315,37431
54047,WV,6876,5369,4457,8554,4740,3916,5255,5369,4121.602223,6256,8554,35093,4582,-7376,-532,4701,39167,39675,27717,34561,39794
54049,WV,7788,5369,4457,8554,4740,3916,5397,5675,4680.734307,6256,8162,36478,5062,-6896,-110,5181,40221,41540,29582,36368,41659
54051,WV,7368,5369,4457,8554,4740,3916,5332,6666,4441.106271,6256,7940,36587,5062,-6896,-110,5181,39736,41649,29691,36477,41768
54053,WV,6876,5369,4457,8554,4740,3916,5255,6031,4201.478235,6256,7667,34948,4582,-7376,-532,4701,39167,39530,27572,34416,39649
54055,WV,6876,5369,4457,8554,4740,3916,5255,5518,4265.379045,6256,7345,34177,4102,-7856,-953,4221,39167,38279,26321,33224,38398
54057,WV,7644,5369,4457,8554,4740,3916,5374,5957,4297.329449,6256,7578,35649,4582,-7376,-532,4701,40054,40231,28273,35117,40350
54059,WV,6876,5369,4457,8554,4740,3916,5255,5369,4776.585522,6256,8554,35748,4582,-7376,-532,4701,39167,40330,28372,35216,40449
54061,WV,9024,5369,4457,8554,4740,3916,5589,5440,4473.056676,6256,8268,37377,5541,-6416,311,5661,41649,42918,30961,37688,43038
54063,WV,6876,5369,4457,8554,4740,3916,5255,5369,4473.056676,6256,8554,35444,4582,-7376,-532,4701,39167,40026,28068,34912,40145
54065,WV,8892,5369,4457,8554,4740,3916,5568,5369,4409.155866,6256,8554,37396,5541,-6416,311,5661,41496,42937,30980,37707,43057
54067,WV,6876,5369,4457,8554,4740,3916,5255,5369,4249.403842,6256,8554,35220,4582,-7376,-532,4701,39167,39802,27844,34688,39921
54069,WV,7368,5369,4457,8554,4740,3916,5332,6322,4760.610319,6256,7887,36510,5062,-6896,-110,5181,39736,41572,29614,36400,41691
54071,WV,6876,5369,4457,8554,4740,3916,5255,5369,4409.155866,6256,8554,35380,4582,-7376,-532,4701,39167,39962,28004,34848,40081
54073,WV,7368,5369,4457,8554,4740,3916,5332,5369,4089.651818,6256,8554,35553,4582,-7376,-532,4701,39736,40135,28177,35021,40254
54075,WV,6876,5369,4457,8554,4740,3916,5255,5369,4265.379045,6256,8554,35236,4582,-7376,-532,4701,39167,39818,27860,34704,39937
54077,WV,9024,5369,4457,8554,4740,3916,5589,5763,4345.255057,6256,8311,37615,5541,-6416,311,5661,41649,43156,31199,37926,43276
54079,WV,8652,5369,4457,8554,4740,3916,5531,5149,4712.684712,6256,7993,36678,5062,-6896,-110,5181,41219,41740,29782,36568,41859
54081,WV,7992,5369,4457,8554,4740,3916,5428,5758,4105.62702,6256,7475,35502,4582,-7376,-532,4701,40456,40084,28126,34970,40203
54083,WV,7632,5369,4457,8554,4740,3916,5373,6098,4281.354247,6256,7582,35765,4582,-7376,-532,4701,40041,40347,28389,35233,40466
54085,WV,6876,5369,4457,8554,4740,3916,5255,5369,4057.701413,6256,8554,35029,4582,-7376,-532,4701,39167,39611,27653,34497,39730
54087,WV,6876,5369,4457,8554,4740,3916,5255,5369,4265.379045,6256,8554,35236,4582,-7376,-532,4701,39167,39818,27860,34704,39937
54089,WV,6924,5369,4457,8554,4740,3916,5263,5369,4201.478235,6256,8554,35220,4582,-7376,-532,4701,39223,39802,27844,34688,39921
54091,WV,6876,5369,4457,8554,4740,3916,5255,6419,4329.279854,6256,8070,35866,4582,-7376,-532,4701,39167,40448,28490,35334,40567
54093,WV,6876,5369,4457,8554,4740,3916,5255,5369,4361.230259,6256,8554,35332,4582,-7376,-532,4701,39167,39914,27956,34800,40033
54095,WV,6876,5369,4457,8554,4740,3916,5255,5369,4249.403842,6256,8554,35220,4582,-7376,-532,4701,39167,39802,27844,34688,39921
54097,WV,6876,5369,4457,8554,4740,3916,5255,5369,4233.42864,6256,8554,35204,4582,-7376,-532,4701,39167,39786,27828,34672,39905
54099,WV,7716,5369,4457,8554,4740,3916,5386,6629,4105.62702,6256,7994,36617,5062,-6896,-110,5181,40138,41679,29721,36507,41798
54101,WV,6876,5369,4457,8554,4740,3916,5255,5369,4281.354247,6256,8554,35252,4582,-7376,-532,4701,39167,39834,27876,34720,39953
54103,WV,6972,5369,4457,8554,4740,3916,5270,5369,4233.42864,6256,8554,35300,4582,-7376,-532,4701,39278,39882,27924,34768,40001
54105,WV,7368,5369,4457,8554,4740,3916,5332,5670,4073.676616,6256,8032,35315,4582,-7376,-532,4701,39736,39897,27939,34783,40016
54107,WV,7368,5369,4457,8554,4740,3916,5332,5033,3993.800604,6256,8008,34575,4582,-7376,-532,4701,39736,39157,27199,34043,39276
54109,WV,6876,5369,4457,8554,4740,3916,5255,5369,4920.362344,6256,8554,35891,4582,-7376,-532,4701,39167,40473,28515,35359,40592
55001,WI,7644,5983,4553,8320,5727,3699,6636,5983,4226.697334,6136,8320,36009,5089,-6907,-121,5170,42562,41098,29102,35888,41179
55003,WI,7644,5983,4553,8320,5727,3699,6636,5983,4585.721818,6136,8320,36368,5089,-6907,-121,5170,42562,41457,29461,36247,41538
55005,WI,8052,5983,4553,8320,5727,3699,6707,5983,3851.353555,6136,8320,36041,5089,-6907,-121,5170,43041,41130,29134,35920,41211
55007,WI,7764,5983,4553,8320,5727,3699,6657,5983,4585.721818,6136,8320,36488,5089,-6907,-121,5170,42703,41577,29581,36367,41658
55009,WI,8172,5983,4553,8320,5727,3699,6728,6919,4243.016629,6136,8292,37461,5551,-6445,282,5632,43182,43012,31016,37743,43093
55011,WI,8568,5983,4553,8320,5727,3699,6797,5983,4340.932397,6136,8320,37047,5551,-6445,282,5632,43647,42598,30602,37329,42679
55013,WI,7644,5983,4553,8320,5727,3699,6636,5983,4422.528871,6136,8320,36205,5089,-6907,-121,5170,42562,41294,29298,36084,41375
55015,WI,8040,5983,4553,8320,5727,3699,6705,6296,4063.504387,6136,8591,36826,5551,-6445,282,5632,43027,42377,30381,37108,42458
55017,WI,8880,5983,4553,8320,5727,3699,6851,5179,3883.992145,6136,8212,35990,5089,-6907,-121,5170,44013,41079,29083,35869,41160
55019,WI,7644,5983,4553,8320,5727,3699,6636,5983,4487.80605,6136,8320,36270,5089,-6907,-121,5170,42562,41359,29363,36149,41440
55021,WI,8736,5983,4553,8320,5727,3699,6826,6050,4618.360407,6136,8718,37958,5551,-6445,282,5632,43844,43509,31513,38240,43590
55023,WI,7644,5983,4553,8320,5727,3699,6636,5983,4096.142976,6136,8320,35878,5089,-6907,-121,5170,42562,40967,28971,35757,41048
55025,WI,10776,5983,4553,8320,5727,3699,7180,5963,4602.041113,6136,8730,39907,6475,-5521,1089,6556,46238,46382,34386,40996,46463
55027,WI,8856,5983,4553,8320,5727,3699,6847,5339,4161.420155,6136,8295,36486,5089,-6907,-121,5170,43985,41575,29579,36365,41656
55029,WI,8256,5983,4553,8320,5727,3699,6742,5983,5287.451491,6136,8320,37681,5089,-6907,-121,5170,43280,42770,30774,37560,42851
55031,WI,8304,5983,4553,8320,5727,3699,6751,5280,4683.637586,6136,7896,35999,4627,-7369,-525,4708,43337,40626,28630,35474,40707
55033,WI,8040,5983,4553,8320,5727,3699,6705,5394,3867.67285,6136,8229,35365,5089,-6907,-121,5170,43027,40454,28458,35244,40535
55035,WI,8880,5983,4553,8320,5727,3699,6851,5406,4079.823681,6136,8204,36406,5089,-6907,-121,5170,44013,41495,29499,36285,41576
55037,WI,7644,5983,4553,8320,5727,3699,6636,5581,4063.504387,6136,7815,34939,4627,-7369,-525,4708,42562,39566,27570,34414,39647
55039,WI,8148,5983,4553,8320,5727,3699,6724,7144,4275.655218,6136,8280,37683,5551,-6445,282,5632,43154,43234,31238,37965,43315
55041,WI,7644,5983,4553,8320,5727,3699,6636,5983,4096.142976,6136,8320,35878,5089,-6907,-121,5170,42562,40967,28971,35757,41048
55043,WI,7644,5983,4553,8320,5727,3699,6636,6049,4014.546502,6136,8119,35661,5089,-6907,-121,5170,42562,40750,28754,35540,40831
55045,WI,7920,5983,4553,8320,5727,3699,6684,5654,4047.185092,6136,8722,36178,5089,-6907,-121,5170,42886,41267,29271,36057,41348
55047,WI,7644,5983,4553,8320,5727,3699,6636,5983,4357.251692,6136,8320,36139,5089,-6907,-121,5170,42562,41228,29232,36018,41309
55049,WI,9084,5983,4553,8320,5727,3699,6886,5734,4781.553355,6136,8712,38147,5551,-6445,282,5632,44252,43698,31702,38429,43779
55051,WI,7644,5983,4553,8320,5727,3699,6636,5983,4602.041113,6136,8320,36384,5089,-6907,-121,5170,42562,41473,29477,36263,41554
55053,WI,8124,5983,4553,8320,5727,3699,6719,5983,4471.486755,6136,8320,36733,5089,-6907,-121,5170,43125,41822,29826,36612,41903
55055,WI,9528,5983,4553,8320,5727,3699,6963,5581,4243.016629,6136,8396,37584,5551,-6445,282,5632,44773,43135,31139,37866,43216
55057,WI,7824,5983,4553,8320,5727,3699,6667,5983,4895.788418,6136,8320,36858,5089,-6907,-121,5170,42773,41947,29951,36737,42028
55059,WI,11640,5983,4553,8320,5727,3699,7330,5242,4340.932397,6136,8888,39945,6766,-5230,1493,6847,47252,46711,34715,41438,46792
55061,WI,8172,5983,4553,8320,5727,3699,6728,5516,4553.083228,6136,8297,36373,5089,-6907,-121,5170,43182,41462,29466,36252,41543
55063,WI,8388,5983,4553,8320,5727,3699,6765,5986,4112.462271,6136,8287,36608,5551,-6445,282,5632,43435,42159,30163,36890,42240
55065,WI,7644,5983,4553,8320,5727,3699,6636,5983,4243.016629,6136,8320,36025,5089,-6907,-121,5170,42562,41114,29118,35904,41195
55067,WI,7644,5983,4553,8320,5727,3699,6636,5983,4145.10086,6136,8320,35927,5089,-6907,-121,5170,42562,41016,29020,35806,41097
55069,WI,7644,5983,4553,8320,5727,3699,6636,5477,4487.80605,6136,7952,35396,4627,-7369,-525,4708,42562,40023,28027,34871,40104
55071,WI,7644,5983,4553,8320,5727,3699,6636,7255,4194.058744,6136,8106,37034,5551,-6445,282,5632,42562,42585,30589,37316,42666
55073,WI,7752,5983,4553,8320,5727,3699,6655,5882,4161.420155,6136,8378,36009,5089,-6907,-121,5170,42689,41098,29102,35888,41179
55075,WI,7644,5983,4553,8320,5727,3699,6636,5606,3883.992145,6136,7573,34543,4627,-7369,-525,4708,42562,39170,27174,34018,39251
55077,WI,8268,5983,4553,8320,5727,3699,6744,5983,4357.251692,6136,8320,36763,5089,-6907,-121,5170,43294,41852,29856,36642,41933
55078,WI,8004,5983,4553,8320,5727,3699,6699,6253,4047.185092,6136,8010,36149,5089,-6907,-121,5170,42985,41238,29242,36028,41319
55079,WI,9744,5983,4553,8320,5727,3699,7001,5647,4243.016629,6136,8258,37726,6013,-5983,686,6094,45027,43739,31743,38412,43820
55081,WI,8604,5983,4553,8320,5727,3699,6803,5983,3916.630734,6136,8320,36659,5551,-6445,282,5632,43689,42210,30214,36941,42291
55083,WI,7644,5983,4553,8320,5727,3699,6636,5580,4373.570986,6136,8297,35730,4627,-7369,-525,4708,42562,40357,28361,35205,40438
55085,WI,8376,5983,4553,8320,5727,3699,6763,5983,4079.823681,6136,8320,36594,5551,-6445,282,5632,43421,42145,30149,36876,42226
55087,WI,8040,5983,4553,8320,5727,3699,6705,5374,4373.570986,6136,8601,36223,5089,-6907,-121,5170,43027,41312,29316,36102,41393
55089,WI,9744,5983,4553,8320,5727,3699,7001,5618,4455.16746,6136,8272,37924,6013,-5983,686,6094,45027,43937,31941,38610,44018
55091,WI,7644,5983,4553,8320,5727,3699,6636,5983,4275.655218,6136,8320,36058,5089,-6907,-121,5170,42562,41147,29151,35937,41228
55093,WI,11352,5983,4553,8320,5727,3699,7280,5522,5597.518091,6136,8923,41230,6766,-5230,1493,6847,46914,47996,36000,42723,48077
55095,WI,9084,5983,4553,8320,5727,3699,6886,5983,4634.679702,6136,8320,37857,5551,-6445,282,5632,44252,43408,31412,38139,43489
55097,WI,8316,5983,4553,8320,5727,3699,6753,5601,4357.251692,6136,8191,36300,5089,-6907,-121,5170,43351,41389,29393,36179,41470
55099,WI,7644,5983,4553,8320,5727,3699,6636,5983,4161.420155,6136,8320,35943,5089,-6907,-121,5170,42562,41032,29036,35822,41113
55101,WI,8820,5983,4553,8320,5727,3699,6840,7031,4291.974513,6136,8273,38251,6013,-5983,686,6094,43942,44264,32268,38937,44345
55103,WI,7728,5983,4553,8320,5727,3699,6651,5983,4438.848165,6136,8320,36305,5089,-6907,-121,5170,42661,41394,29398,36184,41475
55105,WI,9252,5983,4553,8320,5727,3699,6915,6575,4014.546502,6136,8123,37800,6013,-5983,686,6094,44449,43813,31817,38486,43894
55107,WI,7644,5983,4553,8320,5727,3699,6636,5983,4030.865797,6136,8320,35813,5089,-6907,-121,5170,42562,40902,28906,35692,40983
55109,WI,11352,5983,4553,8320,5727,3699,7280,6344,4324.613102,6136,8924,40780,7037,-4959,1896,7118,46914,47817,35821,42676,47898
55111,WI,9252,5983,4553,8320,5727,3699,6915,6918,4161.420155,6136,8310,38476,6013,-5983,686,6094,44449,44489,32493,39162,44570
55113,WI,7716,5983,4553,8320,5727,3699,6649,5983,4243.016629,6136,8320,36097,5089,-6907,-121,5170,42647,41186,29190,35976,41267
55115,WI,7644,5983,4553,8320,5727,3699,6636,8294,3818.714966,6136,7999,37590,6013,-5983,686,6094,42562,43603,31607,38276,43684
55117,WI,8628,5983,4553,8320,5727,3699,6807,6865,4487.80605,6136,8278,38093,6013,-5983,686,6094,43717,44106,32110,38779,44187
55119,WI,7644,5983,4553,8320,5727,3699,6636,5983,4520.444639,6136,8320,36302,5089,-6907,-121,5170,42562,41391,29395,36181,41472
55121,WI,7644,5983,4553,8320,5727,3699,6636,5983,4585.721818,6136,8320,36368,5089,-6907,-121,5170,42562,41457,29461,36247,41538
55123,WI,7644,5983,4553,8320,5727,3699,6636,5983,4520.444639,6136,8320,36302,5089,-6907,-121,5170,42562,41391,29395,36181,41472
55125,WI,8532,5983,4553,8320,5727,3699,6790,5983,4765.23406,6136,8320,37435,5551,-6445,282,5632,43604,42986,30990,37717,43067
55127,WI,9432,5983,4553,8320,5727,3699,6947,6370,4487.80605,6136,8360,38484,6013,-5983,686,6094,44661,44497,32501,39170,44578
55129,WI,8628,5983,4553,8320,5727,3699,6807,5983,4308.293808,6136,8320,37074,5551,-6445,282,5632,43717,42625,30629,37356,42706
55131,WI,9744,5983,4553,8320,5727,3699,7001,6799,4406.209576,6136,8272,39056,6475,-5521,1089,6556,45027,45531,33535,40145,45612
55133,WI,9744,5983,4553,8320,5727,3699,7001,6797,4585.721818,6136,8270,39232,6475,-5521,1089,6556,45027,45707,33711,40321,45788
55135,WI,7824,5983,4553,8320,5727,3699,6667,5983,3932.950029,6136,8320,35895,5089,-6907,-121,5170,42773,40984,28988,35774,41065
55137,WI,7740,5983,4553,8320,5727,3699,6653,5983,4536.763934,6136,8320,36415,5089,-6907,-121,5170,42675,41504,29508,36294,41585
55139,WI,7836,5983,4553,8320,5727,3699,6669,6068,4553.083228,6136,8114,36406,5089,-6907,-121,5170,42787,41495,29499,36285,41576
55141,WI,7644,5983,4553,8320,5727,3699,6636,6739,4161.420155,6136,7958,36337,5089,-6907,-121,5170,42562,41426,29430,36216,41507
56001,WY,8952,12528,5319,7382,5641,3971,4438,13597,6329.535056,7641,6999,47490,4254,-6477,1038,5600,48231,51744,41013,48528,53090
56003,WY,7644,12528,5319,7382,5641,3971,4288,12528,5357.22696,7641,7382,44523,3801,-6930,321,5147,46773,48324,37593,44844,49670
56005,WY,10692,12528,5319,7382,5641,3971,4639,14519,5757.589117,7641,8401,50981,6369,-4362,3681,7715,50172,57350,46619,54662,58696
56007,WY,8184,12528,5319,7382,5641,3971,4350,12528,5986.367493,7641,7382,45692,4027,-6704,679,5373,47375,49719,38988,46371,51065
56009,WY,7656,12528,5319,7382,5641,3971,4289,12528,5586.005336,7641,7382,44764,3801,-6930,321,5147,46786,48565,37834,45085,49911
56011,WY,7644,12528,5319,7382,5641,3971,4288,12528,5757.589117,7641,7382,44924,3801,-6930,321,5147,46773,48725,37994,45245,50071
56013,WY,8664,12528,5319,7382,5641,3971,4405,10510,5910.108034,7641,7283,43979,3574,-7157,-38,4920,47910,47553,36822,43941,48899
56015,WY,7644,12528,5319,7382,5641,3971,4288,12528,5414.421554,7641,7382,44580,3801,-6930,321,5147,46773,48381,37650,44901,49727
56017,WY,7644,12528,5319,7382,5641,3971,4288,12528,5833.848576,7641,7382,45000,3801,-6930,321,5147,46773,48801,38070,45321,50147
56019,WY,7644,12528,5319,7382,5641,3971,4288,12528,5700.394523,7641,7382,44866,3801,-6930,321,5147,46773,48667,37936,45187,50013
56021,WY,9468,12528,5319,7382,5641,3971,4498,12192,5376.291825,7641,7460,46109,4254,-6477,1038,5600,48807,50363,39632,47147,51709
56023,WY,9144,12528,5319,7382,5641,3971,4460,12528,5071.253991,7641,7382,45737,4027,-6704,679,5373,48445,49764,39033,46416,51110
56025,WY,9144,12528,5319,7382,5641,3971,4460,10864,5528.810742,7641,7491,44639,3801,-6930,321,5147,48445,48440,37709,44960,49786
56027,WY,7656,12528,5319,7382,5641,3971,4289,12528,5547.875606,7641,7382,44726,3801,-6930,321,5147,46786,48527,37796,45047,49873
56029,WY,7944,12528,5319,7382,5641,3971,4322,12528,5738.524253,7641,7382,45205,3801,-6930,321,5147,47107,49006,38275,45526,50352
56031,WY,7644,12528,5319,7382,5641,3971,4288,12528,5605.0702,7641,7382,44771,3801,-6930,321,5147,46773,48572,37841,45092,49918
56033,WY,9624,12528,5319,7382,5641,3971,4516,11183,6024.497222,7641,7133,45577,3801,-6930,321,5147,48981,49378,38647,45898,50724
56035,WY,11532,12528,5319,7382,5641,3971,4735,12528,6138.88641,7641,7382,49193,5916,-4815,2964,7262,51108,55109,44378,52157,56455
56037,WY,10908,12528,5319,7382,5641,3971,4664,13583,5814.783711,7641,8095,50013,6142,-4589,3322,7488,50413,56155,45424,53335,57501
56039,WY,11916,12528,5319,7382,5641,3971,4780,15937,7549.686392,7641,8200,55214,6822,-3909,4398,8168,51537,62036,51305,59612,63382
56041,WY,7812,12528,5319,7382,5641,3971,4307,12387,5433.486419,7641,7730,44974,3801,-6930,321,5147,46960,48775,38044,45295,50121
56043,WY,7644,12528,5319,7382,5641,3971,4288,12528,5700.394523,7641,7382,44866,3801,-6930,321,5147,46773,48667,37936,45187,50013
56045,WY,7644,12528,5319,7382,5641,3971,4288,12528,5566.940471,7641,7382,44733,3801,-6930,321,5147,46773,48534,37803,45054,49880
