FIPS,State,Housing,ChildCare,Food,Transportation,Medical,Other,Taxes,MIDS ChildCare,MIDS Food,MIDS Medical,MIDS Transportation,MIDS Net,MIDS Taxes All,3x EITC Tax,Basic Income Tax,Mids Taxes Universal,MIT LWC,MIDS LWC,3x EITC,Basic Income,MIDS LWC 2
1001,AL,8520,5062,6898,9859,5407,4284,6213,4639,7565.686685,8774,9573,43355,5158,-6593,-11170,5484,46243,48513,36762,32185,48839
1003,AL,9924,5062,6898,9859,5407,4284,6431,5085,7812.931347,8774,9634,45513,6013,-5738,-10355,6339,47865,51526,39775,35158,51852
1005,AL,6996,5062,6898,9859,5407,4284,5976,5062,7466.788819,8774,9859,42442,4741,-7010,-11528,5067,44482,47183,35432,30914,47509
1007,AL,8916,5062,6898,9859,5407,4284,6274,4913,7491.513286,8774,9624,44003,5622,-6129,-10764,5948,46700,49625,37874,33239,49951
1009,AL,8916,5062,6898,9859,5407,4284,6274,4484,7021.748426,8774,9626,43106,5158,-6593,-11170,5484,46700,48264,36513,31936,48590
1011,AL,6792,5062,6898,9859,5407,4284,5945,5062,7194.81969,8774,9859,41966,4325,-7426,-11887,4651,44247,46291,34540,30079,46617
1013,AL,6792,5062,6898,9859,5407,4284,5945,5062,7219.544157,8774,9859,41991,4325,-7426,-11887,4651,44247,46316,34565,30104,46642
1015,AL,8148,5062,6898,9859,5407,4284,6155,4992,7466.788819,8774,8928,42593,4741,-7010,-11528,5067,45813,47334,35583,31065,47660
1017,AL,7392,5062,6898,9859,5407,4284,6038,4721,6848.677162,8774,8519,40538,3908,-7843,-12245,4234,44940,44446,32695,28293,44772
1019,AL,6792,5062,6898,9859,5407,4284,5945,5062,7194.81969,8774,9859,41966,4325,-7426,-11887,4651,44247,46291,34540,30079,46617
1021,AL,6792,5062,6898,9859,5407,4284,5945,4976,6898.126095,8774,9623,41348,4325,-7426,-11887,4651,44247,45673,33922,29461,45999
1023,AL,8304,5062,6898,9859,5407,4284,6179,5062,7071.197359,8774,9859,43354,5158,-6593,-11170,5484,45993,48512,36761,32184,48838
1025,AL,6792,5062,6898,9859,5407,4284,5945,5062,7244.268623,8774,9859,42015,4741,-7010,-11528,5067,44247,46756,35005,30487,47082
1027,AL,6792,5062,6898,9859,5407,4284,5945,5062,7343.166488,8774,9859,42114,4741,-7010,-11528,5067,44247,46855,35104,30586,47181
1029,AL,7164,5062,6898,9859,5407,4284,6003,5062,7145.370758,8774,9859,42288,4741,-7010,-11528,5067,44677,47029,35278,30760,47355
1031,AL,7176,5062,6898,9859,5407,4284,6004,4952,7318.442022,8774,9525,42030,4741,-7010,-11528,5067,44690,46771,35020,30502,47097
1033,AL,7632,5062,6898,9859,5407,4284,6075,4982,7046.472893,8774,9134,41853,4325,-7426,-11887,4651,45217,46178,34427,29966,46504
1035,AL,6792,5062,6898,9859,5407,4284,5945,5062,7318.442022,8774,9859,42089,4741,-7010,-11528,5067,44247,46830,35079,30561,47156
1037,AL,6792,5062,6898,9859,5407,4284,5945,4606,7392.615421,8774,8687,40535,3908,-7843,-12245,4234,44247,44443,32692,28290,44769
1039,AL,6792,5062,6898,9859,5407,4284,5945,5062,7442.064353,8774,9859,42213,4741,-7010,-11528,5067,44247,46954,35203,30685,47280
1041,AL,6900,5062,6898,9859,5407,4284,5962,5062,7046.472893,8774,9859,41925,4325,-7426,-11887,4651,44372,46250,34499,30038,46576
1043,AL,6924,5062,6898,9859,5407,4284,5965,4719,6601.432499,8774,8922,40225,3908,-7843,-12245,4234,44399,44133,32382,27980,44459
1045,AL,6792,5062,6898,9859,5407,4284,5945,5193,6725.054831,8774,9454,41221,4325,-7426,-11887,4651,44247,45546,33795,29334,45872
1047,AL,6792,5062,6898,9859,5407,4284,5945,4708,7194.81969,8774,8209,39961,-1030,-12781,-17126,-704,44247,38931,27180,22835,39257
1049,AL,7068,5062,6898,9859,5407,4284,5988,5062,7194.81969,8774,9859,42242,4741,-7010,-11528,5067,44566,46983,35232,30714,47309
1051,AL,8520,5062,6898,9859,5407,4284,6213,4797,7516.237752,8774,9578,43469,5158,-6593,-11170,5484,46243,48627,36876,32299,48953
1053,AL,6792,5062,6898,9859,5407,4284,5945,5062,7293.717555,8774,9859,42065,4741,-7010,-11528,5067,44247,46806,35055,30537,47132
1055,AL,7152,5062,6898,9859,5407,4284,6001,4720,6675.605898,8774,8839,40444,3908,-7843,-12245,4234,44663,44352,32601,28199,44678
1057,AL,6792,5062,6898,9859,5407,4284,5945,5062,7268.993089,8774,9859,42040,4741,-7010,-11528,5067,44247,46781,35030,30512,47107
1059,AL,6876,5062,6898,9859,5407,4284,5958,5062,6725.054831,8774,9859,41580,4325,-7426,-11887,4651,44344,45905,34154,29693,46231
1061,AL,6792,5062,6898,9859,5407,4284,5945,5167,7219.544157,8774,9333,41569,4325,-7426,-11887,4651,44247,45894,34143,29682,46220
1063,AL,9780,5062,6898,9859,5407,4284,6409,5062,7466.788819,8774,9859,45226,6013,-5738,-10355,6339,47699,51239,39488,34871,51565
1065,AL,9780,5062,6898,9859,5407,4284,6409,4592,7466.788819,8774,9604,44500,5622,-6129,-10764,5948,47699,50122,38371,33736,50448
1067,AL,6792,5062,6898,9859,5407,4284,5945,4762,7268.993089,8774,9342,41224,4325,-7426,-11887,4651,44247,45549,33798,29337,45875
1069,AL,6792,5062,6898,9859,5407,4284,5945,5668,7343.166488,8774,9291,42152,4741,-7010,-11528,5067,44247,46893,35142,30624,47219
1071,AL,6792,5062,6898,9859,5407,4284,5945,4709,7145.370758,8774,8866,40571,3908,-7843,-12245,4234,44247,44479,32728,28326,44805
1073,AL,8916,5062,6898,9859,5407,4284,6274,5054,6675.605898,8774,9611,43315,5158,-6593,-11170,5484,46700,48473,36722,32145,48799
1075,AL,6792,5062,6898,9859,5407,4284,5945,5062,7071.197359,8774,9859,41842,4325,-7426,-11887,4651,44247,46167,34416,29955,46493
1077,AL,7632,5062,6898,9859,5407,4284,6075,5004,6551.983567,8774,9134,41380,4325,-7426,-11887,4651,45217,45705,33954,29493,46031
1079,AL,7140,5062,6898,9859,5407,4284,5999,4584,7021.748426,8774,9447,41250,4325,-7426,-11887,4651,44649,45575,33824,29363,45901
1081,AL,8688,5062,6898,9859,5407,4284,6239,4888,7615.135617,8774,9459,43707,5158,-6593,-11170,5484,46437,48865,37114,32537,49191
1083,AL,8268,5062,6898,9859,5407,4284,6174,4946,7318.442022,8774,9845,43435,5158,-6593,-11170,5484,45952,48593,36842,32265,48919
1085,AL,8520,5062,6898,9859,5407,4284,6213,4802,7194.81969,8774,9592,43166,5158,-6593,-11170,5484,46243,48324,36573,31996,48650
1087,AL,6792,5062,6898,9859,5407,4284,5945,5062,8010.727078,8774,9859,42782,4741,-7010,-11528,5067,44247,47523,35772,31254,47849
1089,AL,8268,5062,6898,9859,5407,4284,6174,4582,6700.330364,8774,9839,42447,4741,-7010,-11528,5067,45952,47188,35437,30919,47514
1091,AL,6792,5062,6898,9859,5407,4284,5945,5062,7442.064353,8774,9859,42213,4741,-7010,-11528,5067,44247,46954,35203,30685,47280
1093,AL,6792,5062,6898,9859,5407,4284,5945,5062,7021.748426,8774,9859,41793,4325,-7426,-11887,4651,44247,46118,34367,29906,46444
1095,AL,6816,5062,6898,9859,5407,4284,5949,5267,6972.299494,8774,9079,41192,4325,-7426,-11887,4651,44275,45517,33766,29305,45843
1097,AL,9240,5062,6898,9859,5407,4284,6325,5041,7367.890954,8774,9433,44140,5622,-6129,-10764,5948,47075,49762,38011,33376,50088
1099,AL,6792,5062,6898,9859,5407,4284,5945,5062,7268.993089,8774,9859,42040,4741,-7010,-11528,5067,44247,46781,35030,30512,47107
1101,AL,8520,5062,6898,9859,5407,4284,6213,5176,6922.850561,8774,9564,43240,5158,-6593,-11170,5484,46243,48398,36647,32070,48724
1103,AL,7140,5062,6898,9859,5407,4284,5999,5517,6650.881432,8774,9412,41778,4325,-7426,-11887,4651,44649,46103,34352,29891,46429
1105,AL,6792,5062,6898,9859,5407,4284,5945,5062,7244.268623,8774,9859,42015,4741,-7010,-11528,5067,44247,46756,35005,30487,47082
1107,AL,6792,5062,6898,9859,5407,4284,5945,5058,7392.615421,8774,9611,41911,4325,-7426,-11887,4651,44247,46236,34485,30024,46562
1109,AL,6792,5062,6898,9859,5407,4284,5945,5349,7466.788819,8774,8667,41333,4325,-7426,-11887,4651,44247,45658,33907,29446,45984
1111,AL,7344,5062,6898,9859,5407,4284,6030,5062,6898.126095,8774,9859,42221,4741,-7010,-11528,5067,44884,46962,35211,30693,47288
1113,AL,8460,5062,6898,9859,5407,4284,6204,4833,7417.339887,8774,9431,43199,5158,-6593,-11170,5484,46174,48357,36606,32029,48683
1115,AL,8916,5062,6898,9859,5407,4284,6274,6964,7417.339887,8774,9618,45973,6013,-5738,-10355,6339,46700,51986,40235,35618,52312
1117,AL,8916,5062,6898,9859,5407,4284,6274,6261,7392.615421,8774,9619,45247,6013,-5738,-10355,6339,46700,51260,39509,34892,51586
1119,AL,6792,5062,6898,9859,5407,4284,5945,5062,7021.748426,8774,9859,41793,4325,-7426,-11887,4651,44247,46118,34367,29906,46444
1121,AL,6792,5062,6898,9859,5407,4284,5945,7175,7145.370758,8774,8628,42798,4741,-7010,-11528,5067,44247,47539,35788,31270,47865
1123,AL,6876,5062,6898,9859,5407,4284,5958,5062,7318.442022,8774,9859,42173,4741,-7010,-11528,5067,44344,46914,35163,30645,47240
1125,AL,9780,5062,6898,9859,5407,4284,6409,6407,7639.860083,8774,9614,46499,6289,-5462,-9947,6615,47699,52788,41037,36552,53114
1127,AL,6792,5062,6898,9859,5407,4284,5945,5269,7071.197359,8774,9620,41810,4325,-7426,-11887,4651,44247,46135,34384,29923,46461
1129,AL,6792,5062,6898,9859,5407,4284,5945,5062,7268.993089,8774,9859,42040,4741,-7010,-11528,5067,44247,46781,35030,30512,47107
1131,AL,6792,5062,6898,9859,5407,4284,5945,5062,7442.064353,8774,9859,42213,4741,-7010,-11528,5067,44247,46954,35203,30685,47280
1133,AL,6792,5062,6898,9859,5407,4284,5945,5062,7120.646291,8774,9859,41892,4325,-7426,-11887,4651,44247,46217,34466,30005,46543
2013,AK,8556,7977,8234,8509,6397,4344,5071,7977,11746.20755,20566,8509,61698,1034,-5534,-8171,6543,49088,62732,56164,53527,68241
2016,AK,17232,7977,8234,8509,6397,4344,6070,7977,15405.83,20566,8509,74034,4205,-1851,-3152,9714,58763,78239,72183,70882,83748
2020,AK,13752,7977,8234,8509,6397,4344,5669,8759,9355.64772,20566,9534,66311,2393,-4175,-6020,7902,54882,68704,62136,60291,74213
2050,AK,14208,7977,8234,8509,6397,4344,5722,7977,9798.343984,20566,8509,65402,1940,-4628,-6737,7449,55391,67342,60774,58665,72851
2060,AK,12120,7977,8234,8509,6397,4344,5481,7977,9739.317815,20566,8509,63255,1487,-5081,-7454,6996,53062,64742,58174,55801,70251
2068,AK,7644,7977,8234,8509,6397,4344,4966,7977,9680.291647,20566,8509,58720,-9617,-16185,-19086,-4108,48071,49103,42535,39634,54612
2070,AK,12384,7977,8234,8509,6397,4344,5512,7977,9827.857068,20566,8509,63608,1487,-5081,-7454,6996,53357,65095,58527,56154,70604
2090,AK,15912,7977,8234,8509,6397,4344,5918,10067,10241.04025,20566,9174,70304,3299,-3269,-4586,8808,57291,73603,67035,65718,79112
2100,AK,9816,7977,8234,8509,6397,4344,5216,7977,9385.160804,20566,8509,60597,1034,-5534,-8171,6543,50493,61631,55063,52426,67140
2105,AK,8748,7977,8234,8509,6397,4344,5093,7977,8912.951455,20566,8509,59057,-9617,-16185,-19086,-4108,49302,49440,42872,39971,54949
2110,AK,14616,7977,8234,8509,6397,4344,5769,8889,8824.412203,20566,9440,66679,2393,-4175,-6020,7902,55846,69072,62504,60659,74581
2122,AK,9912,7977,8234,8509,6397,4344,5227,7977,12011.82531,20566,8509,63320,1487,-5081,-7454,6996,50600,64807,58239,55866,70316
2130,AK,11580,7977,8234,8509,6397,4344,5419,7219,8588.307528,20566,8939,61236,1034,-5534,-8171,6543,52460,62270,55702,53065,67779
2150,AK,12276,7977,8234,8509,6397,4344,5499,7977,9768.8309,20566,8509,63441,1487,-5081,-7454,6996,53236,64928,58360,55987,70437
2164,AK,8520,7977,8234,8509,6397,4344,5067,7977,9739.317815,20566,8509,59655,-9617,-16185,-19086,-4108,49048,50038,43470,40569,55547
2170,AK,12972,7977,8234,8509,6397,4344,5579,7111,11037.89352,20566,9279,65309,1940,-4628,-6737,7449,54012,67249,60681,58572,72758
2180,AK,16320,7977,8234,8509,6397,4344,5965,7977,11746.20755,20566,8509,69462,2846,-3722,-5303,8355,57746,72308,65740,64159,77817
2185,AK,11232,7977,8234,8509,6397,4344,5379,7977,10359.09259,20566,8509,62987,1487,-5081,-7454,6996,52072,64474,57906,55533,69983
2188,AK,13692,7977,8234,8509,6397,4344,5662,7977,10978.86736,20566,8509,66067,2393,-4175,-6020,7902,54815,68460,61892,60047,73969
2195,AK,9936,7977,8234,8509,6397,4344,5230,7977,8912.951455,20566,8509,60245,1034,-5534,-8171,6543,50627,61279,54711,52074,66788
2198,AK,8700,7977,8234,8509,6397,4344,5087,7977,8912.951455,20566,8509,59009,-9617,-16185,-19086,-4108,49248,49392,42824,39923,54901
2220,AK,13608,7977,8234,8509,6397,4344,5653,7977,9355.64772,20566,8509,64360,1940,-4628,-6737,7449,54722,66300,59732,57623,71809
2230,AK,13428,7977,8234,8509,6397,4344,5632,7977,9178.569214,20566,8509,64003,1940,-4628,-6737,7449,54521,65943,59375,57266,71452
2240,AK,11112,7977,8234,8509,6397,4344,5365,7977,9709.804731,20566,8509,62218,1487,-5081,-7454,6996,51938,63705,57137,54764,69214
2261,AK,10296,7977,8234,8509,6397,4344,5271,7977,9709.804731,20566,8509,61402,1034,-5534,-8171,6543,51028,62436,55868,53231,67945
2270,AK,8712,7977,8234,8509,6397,4344,5089,7977,11746.20755,20566,8509,61854,1034,-5534,-8171,6543,49262,62888,56320,53683,68397
2275,AK,9648,7977,8234,8509,6397,4344,5197,7977,9532.726225,20566,8509,60577,1034,-5534,-8171,6543,50306,61611,55043,52406,67120
2282,AK,8580,7977,8234,8509,6397,4344,5074,7977,9886.883237,20566,8509,59863,-9617,-16185,-19086,-4108,49115,50246,43678,40777,55755
2290,AK,8520,7977,8234,8509,6397,4344,5067,7977,9827.857068,20566,8509,59744,-9617,-16185,-19086,-4108,49048,50127,43559,40658,55636
4001,AZ,7644,12784,8234,8509,6413,4344,5996,12784,8529.28136,6586,8509,48396,6743,-5334,-9555,6743,53924,55139,43062,38841,55139
4003,AZ,9936,12784,8234,8509,6413,4344,6326,12089,8175.124348,6586,7947,49078,6999,-5078,-9167,6999,56546,56077,44000,39911,56077
4005,AZ,12252,12784,8234,8509,6413,4344,6659,11112,8706.359865,6586,8608,51608,7254,-4823,-8780,7254,59195,58862,46785,42828,58862
4007,AZ,8676,12784,8234,8509,6413,4344,6144,11044,8676.846781,6586,7515,46842,6233,-5844,-10329,6233,55104,53075,40998,36513,53075
4009,AZ,7752,12784,8234,8509,6413,4344,6011,12759,8411.229022,6586,8218,48071,6743,-5334,-9555,6743,54047,54814,42737,38516,54814
4011,AZ,7644,12784,8234,8509,6413,4344,5996,12784,8234.150517,6586,8509,48101,6743,-5334,-9555,6743,53924,54844,42767,38546,54844
4012,AZ,7956,12784,8234,8509,6413,4344,6041,12784,8558.794444,6586,8509,48738,6743,-5334,-9555,6743,54281,55481,43404,39183,55481
4013,AZ,11484,12784,8234,8509,6413,4344,6549,16701,8411.229022,6586,8533,56059,8786,-3291,-6456,8786,58317,64845,52768,49603,64845
4015,AZ,8988,12784,8234,8509,6413,4344,6189,12191,8470.255191,6586,7352,47931,6489,-5588,-9941,6489,55461,54420,42343,37990,54420
4017,AZ,7932,12784,8234,8509,6413,4344,6037,14839,8381.715938,6586,7695,49778,6999,-5078,-9167,6999,54253,56777,44700,40611,56777
4019,AZ,10224,12784,8234,8509,6413,4344,6367,13055,8381.715938,6586,8085,50676,7254,-4823,-8780,7254,56875,57930,45853,41896,57930
4021,AZ,11484,12784,8234,8509,6413,4344,6549,13111,8086.585095,6586,8530,52141,7765,-4312,-8005,7765,58317,59906,47829,44136,59906
4023,AZ,7980,12784,8234,8509,6413,4344,6044,17132,7201.192567,6586,8017,51260,7254,-4823,-8780,7254,54308,58514,46437,42480,58514
4025,AZ,9408,12784,8234,8509,6413,4344,6250,14315,8617.820612,6586,7685,50956,7254,-4823,-8780,7254,55942,58210,46133,42176,58210
4027,AZ,9744,12784,8234,8509,6413,4344,6298,11317,7319.244904,6586,7966,47277,6489,-5588,-9941,6489,56326,53766,41689,37336,53766
5001,AR,6984,16670,6898,9859,5571,4284,5370,16670,6972.299494,9410,9859,54179,8153,-3377,-6806,8700,55636,62332,50802,47373,62879
5003,AR,6732,16670,6898,9859,5571,4284,5335,16670,6873.401628,9410,9859,53828,7560,-3970,-7663,8107,55349,61388,49858,46165,61935
5005,AR,7152,16670,6898,9859,5571,4284,5393,20138,6997.02396,9410,8308,56290,8746,-2784,-5949,9293,55827,65036,53506,50341,65583
5007,AR,8220,16670,6898,9859,5571,4284,5543,22271,6700.330364,9410,9760,60645,11040,-490,-3127,11587,57045,71685,60155,57518,72232
5009,AR,6732,16670,6898,9859,5571,4284,5335,18746,5859.698511,9410,8714,53745,7560,-3970,-7663,8107,55349,61305,49775,46082,61852
5011,AR,6732,16670,6898,9859,5571,4284,5335,16670,6947.575027,9410,9859,53903,7560,-3970,-7663,8107,55349,61463,49933,46240,62010
5013,AR,6732,16670,6898,9859,5571,4284,5335,18508,6898.126095,9410,8604,54436,8153,-3377,-6806,8700,55349,62589,51059,47630,63136
5015,AR,7620,16670,6898,9859,5571,4284,5459,16670,6453.085702,9410,9859,54296,8153,-3377,-6806,8700,56361,62449,50919,47490,62996
5017,AR,6732,16670,6898,9859,5571,4284,5335,16670,6972.299494,9410,9859,53927,7560,-3970,-7663,8107,55349,61487,49957,46264,62034
5019,AR,6804,16670,6898,9859,5571,4284,5345,21778,6898.126095,9410,8593,57767,8746,-2784,-5949,9293,55431,66513,54983,51818,67060
5021,AR,6732,16670,6898,9859,5571,4284,5335,16670,6032.769775,9410,9859,52988,7560,-3970,-7663,8107,55349,60548,49018,45325,61095
5023,AR,6996,16670,6898,9859,5571,4284,5372,16670,6997.02396,9410,9859,54216,8153,-3377,-6806,8700,55650,62369,50839,47410,62916
5025,AR,7812,16670,6898,9859,5571,4284,5486,19451,6922.850561,9410,8759,56639,8746,-2784,-5949,9293,56580,65385,53855,50690,65932
5027,AR,6732,16670,6898,9859,5571,4284,5335,17926,7194.81969,9410,8669,54216,8153,-3377,-6806,8700,55349,62369,50839,47410,62916
5029,AR,7440,16670,6898,9859,5571,4284,5434,16670,6378.912303,9410,9859,54042,8153,-3377,-6806,8700,56156,62195,50665,47236,62742
5031,AR,7368,16670,6898,9859,5571,4284,5424,21495,6749.779297,9410,8951,58258,9339,-2191,-5092,9886,56074,67597,56067,53166,68144
5033,AR,7200,16670,6898,9859,5571,4284,5400,19055,6675.605898,9410,9030,55654,8153,-3377,-6806,8700,55882,63807,52277,48848,64354
5035,AR,9360,16670,6898,9859,5571,4284,5703,17653,6972.299494,9410,9784,57463,8746,-2784,-5949,9293,58345,66209,54679,51514,66756
5037,AR,7164,16670,6898,9859,5571,4284,5395,16670,6848.677162,9410,9859,54236,8153,-3377,-6806,8700,55841,62389,50859,47430,62936
5039,AR,6732,16670,6898,9859,5571,4284,5335,16670,6922.850561,9410,9859,53878,7560,-3970,-7663,8107,55349,61438,49908,46215,61985
5041,AR,6732,16670,6898,9859,5571,4284,5335,16670,6873.401628,9410,9859,53828,7560,-3970,-7663,8107,55349,61388,49858,46165,61935
5043,AR,6732,16670,6898,9859,5571,4284,5335,16670,7046.472893,9410,9859,54001,8153,-3377,-6806,8700,55349,62154,50624,47195,62701
5045,AR,8868,16670,6898,9859,5571,4284,5634,20914,7120.646291,9410,9741,60337,11040,-490,-3127,11587,57784,71377,59847,57210,71924
5047,AR,6732,16670,6898,9859,5571,4284,5335,16670,6378.912303,9410,9859,53334,7560,-3970,-7663,8107,55349,60894,49364,45671,61441
5049,AR,6732,16670,6898,9859,5571,4284,5335,16670,6428.361235,9410,9859,53383,7560,-3970,-7663,8107,55349,60943,49413,45720,61490
5051,AR,9444,16670,6898,9859,5571,4284,5715,20887,6725.054831,9410,8679,59429,9339,-2191,-5092,9886,58441,68768,57238,54337,69315
5053,AR,6732,16670,6898,9859,5571,4284,5335,16050,6972.299494,9410,9752,53200,7560,-3970,-7663,8107,55349,60760,49230,45537,61307
5055,AR,7392,16670,6898,9859,5571,4284,5427,18006,6922.850561,9410,8897,54911,8153,-3377,-6806,8700,56101,63064,51534,48105,63611
5057,AR,6732,16670,6898,9859,5571,4284,5335,16670,6428.361235,9410,9859,53383,7560,-3970,-7663,8107,55349,60943,49413,45720,61490
5059,AR,6732,16670,6898,9859,5571,4284,5335,15089,6774.503763,9410,9325,51614,6967,-4563,-8520,7514,55349,58581,47051,43094,59128
5061,AR,6732,16670,6898,9859,5571,4284,5335,16670,6601.432499,9410,9859,53556,7560,-3970,-7663,8107,55349,61116,49586,45893,61663
5063,AR,6828,16670,6898,9859,5571,4284,5348,16252,6650.881432,9410,8794,52219,7560,-3970,-7663,8107,55458,59779,48249,44556,60326
5065,AR,6732,16670,6898,9859,5571,4284,5335,16670,6650.881432,9410,9859,53606,7560,-3970,-7663,8107,55349,61166,49636,45943,61713
5067,AR,6732,16670,6898,9859,5571,4284,5335,16670,6823.952696,9410,9859,53779,7560,-3970,-7663,8107,55349,61339,49809,46116,61886
5069,AR,7812,16670,6898,9859,5571,4284,5486,17715,6873.401628,9410,8646,54740,8153,-3377,-6806,8700,56580,62893,51363,47934,63440
5071,AR,6960,16670,6898,9859,5571,4284,5367,16670,6601.432499,9410,9859,53784,7560,-3970,-7663,8107,55609,61344,49814,46121,61891
5073,AR,6732,16670,6898,9859,5571,4284,5335,16670,6972.299494,9410,9859,53927,7560,-3970,-7663,8107,55349,61487,49957,46264,62034
5075,AR,6732,16670,6898,9859,5571,4284,5335,16670,6700.330364,9410,9859,53655,7560,-3970,-7663,8107,55349,61215,49685,45992,61762
5077,AR,6732,16670,6898,9859,5571,4284,5335,16670,6799.22823,9410,9859,53754,7560,-3970,-7663,8107,55349,61314,49784,46091,61861
5079,AR,7812,16670,6898,9859,5571,4284,5486,16481,6873.401628,9410,8727,53587,7560,-3970,-7663,8107,56580,61147,49617,45924,61694
5081,AR,7428,16670,6898,9859,5571,4284,5432,16120,6551.983567,9410,9384,53178,7560,-3970,-7663,8107,56142,60738,49208,45515,61285
5083,AR,6732,16670,6898,9859,5571,4284,5335,16670,6057.494241,9410,9859,53012,7560,-3970,-7663,8107,55349,60572,49042,45349,61119
5085,AR,8868,16670,6898,9859,5571,4284,5634,16763,7046.472893,9410,9749,56121,8746,-2784,-5949,9293,57784,64867,53337,50172,65414
5087,AR,8220,16670,6898,9859,5571,4284,5543,15494,6650.881432,9410,9759,53818,7560,-3970,-7663,8107,57045,61378,49848,46155,61925
5089,AR,6732,16670,6898,9859,5571,4284,5335,16670,6551.983567,9410,9859,53507,7560,-3970,-7663,8107,55349,61067,49537,45844,61614
5091,AR,8448,16670,6898,9859,5571,4284,5575,17133,6997.02396,9410,9382,55654,8153,-3377,-6806,8700,57305,63807,52277,48848,64354
5093,AR,6744,16670,6898,9859,5571,4284,5336,18702,6774.503763,9410,8865,54779,8153,-3377,-6806,8700,55362,62932,51402,47973,63479
5095,AR,6732,16670,6898,9859,5571,4284,5335,16670,6675.605898,9410,9859,53631,7560,-3970,-7663,8107,55349,61191,49661,45968,61738
5097,AR,6732,16670,6898,9859,5571,4284,5335,16670,6601.432499,9410,9859,53556,7560,-3970,-7663,8107,55349,61116,49586,45893,61663
5099,AR,6732,16670,6898,9859,5571,4284,5335,16670,6700.330364,9410,9859,53655,7560,-3970,-7663,8107,55349,61215,49685,45992,61762
5101,AR,6732,16670,6898,9859,5571,4284,5335,18076,6576.708033,9410,8785,53864,7560,-3970,-7663,8107,55349,61424,49894,46201,61971
5103,AR,6732,16670,6898,9859,5571,4284,5335,17380,6972.299494,9410,8537,53315,7560,-3970,-7663,8107,55349,60875,49345,45652,61422
5105,AR,8868,16670,6898,9859,5571,4284,5634,16076,7046.472893,9410,9754,55439,8153,-3377,-6806,8700,57784,63592,52062,48633,64139
5107,AR,6732,16670,6898,9859,5571,4284,5335,15864,6848.677162,9410,8184,51323,6967,-4563,-8520,7514,55349,58290,46760,42803,58837
5109,AR,6732,16670,6898,9859,5571,4284,5335,16670,6675.605898,9410,9859,53631,7560,-3970,-7663,8107,55349,61191,49661,45968,61738
5111,AR,6732,16670,6898,9859,5571,4284,5335,15926,6601.432499,9410,8990,51944,6967,-4563,-8520,7514,55349,58911,47381,43424,59458
5113,AR,6732,16670,6898,9859,5571,4284,5335,16670,6601.432499,9410,9859,53556,7560,-3970,-7663,8107,55349,61116,49586,45893,61663
5115,AR,7068,16670,6898,9859,5571,4284,5382,16094,6922.850561,9410,9136,52915,7560,-3970,-7663,8107,55732,60475,48945,45252,61022
5117,AR,6732,16670,6898,9859,5571,4284,5335,16670,6972.299494,9410,9859,53927,7560,-3970,-7663,8107,55349,61487,49957,46264,62034
5119,AR,8868,16670,6898,9859,5571,4284,5634,17450,7021.748426,9410,9745,56779,8746,-2784,-5949,9293,57784,65525,53995,50830,66072
5121,AR,6732,16670,6898,9859,5571,4284,5335,16670,6650.881432,9410,9859,53606,7560,-3970,-7663,8107,55349,61166,49636,45943,61713
5123,AR,6732,16670,6898,9859,5571,4284,5335,15380,6873.401628,9410,8411,51090,6967,-4563,-8520,7514,55349,58057,46527,42570,58604
5125,AR,8868,16670,6898,9859,5571,4284,5634,16957,7120.646291,9410,9745,56385,8746,-2784,-5949,9293,57784,65131,53601,50436,65678
5127,AR,6744,16670,6898,9859,5571,4284,5336,16670,6477.810168,9410,9859,53445,7560,-3970,-7663,8107,55362,61005,49475,45782,61552
5129,AR,6732,16670,6898,9859,5571,4284,5335,16670,6551.983567,9410,9859,53507,7560,-3970,-7663,8107,55349,61067,49537,45844,61614
5131,AR,7200,16670,6898,9859,5571,4284,5400,14983,6304.738904,9410,9000,51182,6967,-4563,-8520,7514,55882,58149,46619,42662,58696
5133,AR,6732,16670,6898,9859,5571,4284,5335,16670,6576.708033,9410,9859,53532,7560,-3970,-7663,8107,55349,61092,49562,45869,61639
5135,AR,6732,16670,6898,9859,5571,4284,5335,16670,6502.534634,9410,9859,53458,7560,-3970,-7663,8107,55349,61018,49488,45795,61565
5137,AR,6744,16670,6898,9859,5571,4284,5336,16670,6749.779297,9410,9859,53717,7560,-3970,-7663,8107,55362,61277,49747,46054,61824
5139,AR,7440,16670,6898,9859,5571,4284,5434,17301,6922.850561,9410,8767,54124,8153,-3377,-6806,8700,56156,62277,50747,47318,62824
5141,AR,6732,16670,6898,9859,5571,4284,5335,16670,6997.02396,9410,9859,53952,7560,-3970,-7663,8107,55349,61512,49982,46289,62059
5143,AR,8220,16670,6898,9859,5571,4284,5543,15582,6626.156966,9410,9759,53882,7560,-3970,-7663,8107,57045,61442,49912,46219,61989
5145,AR,7020,16670,6898,9859,5571,4284,5375,13785,7021.748426,9410,9344,50865,6967,-4563,-8520,7514,55677,57832,46302,42345,58379
5147,AR,6732,16670,6898,9859,5571,4284,5335,16670,6848.677162,9410,9859,53804,7560,-3970,-7663,8107,55349,61364,49834,46141,61911
5149,AR,6732,16670,6898,9859,5571,4284,5335,14234,6403.636769,9410,9163,50227,6967,-4563,-8520,7514,55349,57194,45664,41707,57741
6001,CA,18936,7312,8234,8509,6151,4344,7231,8300,10034.44866,7630,9400,58644,9308,-2738,-5639,9339,60717,67952,55906,53005,67983
6003,CA,10956,7312,8234,8509,6151,4344,6152,7312,9473.700057,7630,8509,48225,6643,-5403,-9624,6674,51658,54868,42822,38601,54899
6005,CA,12576,7312,8234,8509,6151,4344,6371,7312,10919.84119,7630,8509,51291,7176,-4870,-8827,7207,53497,58467,46421,42464,58498
6007,CA,10212,7312,8234,8509,6151,4344,6052,6761,8794.899118,7630,7957,45699,5844,-6202,-10819,5875,50814,51543,39497,34880,51574
6009,CA,11136,7312,8234,8509,6151,4344,6177,7312,10624.71034,7630,8509,49556,6910,-5136,-9225,6941,51863,56466,44420,40331,56497
6011,CA,9744,7312,8234,8509,6151,4344,5989,7312,11805.23372,7630,8509,49344,6910,-5136,-9225,6941,50283,56254,44208,40119,56285
6013,CA,18936,7312,8234,8509,6151,4344,7231,8177,9768.8309,7630,9328,58184,9308,-2738,-5639,9339,60717,67492,55446,52545,67523
6015,CA,10440,7312,8234,8509,6151,4344,6083,6499,9562.23931,7630,7479,45954,5844,-6202,-10819,5875,51073,51798,39752,35135,51829
6017,CA,12864,7312,8234,8509,6151,4344,6410,7373,11273.9982,7630,8571,52057,7709,-4337,-8030,7740,53824,59766,47720,44027,59797
6019,CA,9924,7312,8234,8509,6151,4344,6013,6609,7968.532758,7630,8608,45084,5844,-6202,-10819,5875,50487,50928,38882,34265,50959
6021,CA,9888,7312,8234,8509,6151,4344,6008,7312,8617.820612,7630,8509,46301,6110,-5936,-10421,6141,50446,52411,40365,35880,52442
6023,CA,11832,7312,8234,8509,6151,4344,6271,6649,8706.359865,7630,8016,47177,6377,-5669,-10022,6408,52653,53554,41508,37155,53585
6025,CA,9708,7312,8234,8509,6151,4344,5984,6417,7466.810325,7630,8485,44050,5482,-6564,-11199,5513,50242,49532,37486,32851,49563
6027,CA,11544,7312,8234,8509,6151,4344,6232,7312,8558.794444,7630,8509,47898,6377,-5669,-10022,6408,52326,54275,42229,37876,54306
6029,CA,9780,7312,8234,8509,6151,4344,5993,6446,8263.663601,7630,8677,45141,5844,-6202,-10819,5875,50323,50985,38939,34322,51016
6031,CA,10668,7312,8234,8509,6151,4344,6113,6398,8057.072011,7630,8711,45808,5844,-6202,-10819,5875,51331,51652,39606,34989,51683
6033,CA,10524,7312,8234,8509,6151,4344,6094,6716,10270.55333,7630,7190,46675,6110,-5936,-10421,6141,51168,52785,40739,36254,52816
6035,CA,11340,7312,8234,8509,6151,4344,6204,6505,9945.909406,7630,7717,47482,6377,-5669,-10022,6408,52094,53859,41813,37460,53890
6037,CA,16776,7312,8234,8509,6151,4344,6939,8037,9090.029961,7630,9439,55317,8242,-3804,-7233,8273,58265,63559,51513,48084,63590
6039,CA,9420,7312,8234,8509,6151,4344,5945,6293,9827.857068,7630,8300,45815,5844,-6202,-10819,5875,49915,51659,39613,34996,51690
6041,CA,23472,7312,8234,8509,6151,4344,7845,9055,11037.89352,7630,9321,64860,10907,-1139,-3248,10938,65867,75767,63721,61612,75798
6043,CA,9288,7312,8234,8509,6151,4344,5927,7312,8322.68977,7630,8509,45406,5844,-6202,-10819,5875,49765,51250,39204,34587,51281
6045,CA,11124,7312,8234,8509,6151,4344,6175,6830,10329.5795,7630,8070,48328,6643,-5403,-9624,6674,51849,54971,42925,38704,55002
6047,CA,9540,7312,8234,8509,6151,4344,5961,6242,8352.202854,7630,8626,44735,5482,-6564,-11199,5513,50051,50217,38171,33536,50248
6049,CA,7644,7312,8234,8509,6151,4344,5705,7312,8558.794444,7630,8509,43998,5048,-6998,-11575,5079,47899,49046,37000,32423,49077
6051,CA,15024,7312,8234,8509,6151,4344,6702,7312,8440.742107,7630,8509,51260,7176,-4870,-8827,7207,56276,58436,46390,42433,58467
6053,CA,14808,7312,8234,8509,6151,4344,6673,7582,8883.438371,7630,9097,52345,7709,-4337,-8030,7740,56031,60054,48008,44315,60085
6055,CA,16968,7312,8234,8509,6151,4344,6965,7885,10654.22343,7630,9233,56714,8775,-3271,-6436,8806,58483,65489,53443,50278,65520
6057,CA,12564,7312,8234,8509,6151,4344,6370,7116,11864.25988,7630,8117,51635,7176,-4870,-8827,7207,53484,58811,46765,42808,58842
6059,CA,19728,7312,8234,8509,6151,4344,7338,8606,9208.082298,7630,9398,58914,9308,-2738,-5639,9339,61616,68222,56176,53275,68253
6061,CA,12864,7312,8234,8509,6151,4344,6410,7519,9798.343984,7630,8576,50731,7176,-4870,-8827,7207,53824,57907,45861,41904,57938
6063,CA,11196,7312,8234,8509,6151,4344,6185,7312,8912.951455,7630,8509,47904,6377,-5669,-10022,6408,51931,54281,42235,37882,54312
6065,CA,13440,7312,8234,8509,6151,4344,6488,7226,8381.715938,7630,8945,49966,6910,-5136,-9225,6941,54478,56876,44830,40741,56907
6067,CA,12864,7312,8234,8509,6151,4344,6410,7086,8617.820612,7630,8586,49127,6910,-5136,-9225,6941,53824,56037,43991,39902,56068
6069,CA,14352,7312,8234,8509,6151,4344,6612,7499,10536.17109,7630,9687,54048,8242,-3804,-7233,8273,55514,62290,50244,46815,62321
6071,CA,13440,7312,8234,8509,6151,4344,6488,7003,8175.124348,7630,8954,49547,6910,-5136,-9225,6941,54478,56457,44411,40322,56488
6073,CA,16248,7312,8234,8509,6151,4344,6868,8169,9355.64772,7630,9219,54966,8242,-3804,-7233,8273,57666,63208,51162,47733,63239
6075,CA,23472,7312,8234,8509,6151,4344,7845,9383,11569.12904,7630,9653,66051,11440,-606,-2451,11471,65867,77491,65445,63600,77522
6077,CA,11160,7312,8234,8509,6151,4344,6180,6915,8411.229022,7630,8762,47223,6377,-5669,-10022,6408,51890,53600,41554,37201,53631
6079,CA,14580,7312,8234,8509,6151,4344,6642,7551,9857.370153,7630,8421,52384,7709,-4337,-8030,7740,55772,60093,48047,44354,60124
6081,CA,23472,7312,8234,8509,6151,4344,7845,8976,10211.52716,7630,9354,63988,10374,-1672,-4045,10405,65867,74362,62316,59943,74393
6083,CA,15264,7312,8234,8509,6151,4344,6735,7978,9031.003793,7630,9237,53484,7709,-4337,-8030,7740,56549,61193,49147,45454,61224
6085,CA,19788,7312,8234,8509,6151,4344,7346,8914,9886.883237,7630,9926,60488,9841,-2205,-4842,9872,61684,70329,58283,55646,70360
6087,CA,19164,7312,8234,8509,6151,4344,7262,8132,10211.52716,7630,9164,58646,9308,-2738,-5639,9339,60976,67954,55908,53007,67985
6089,CA,11280,7312,8234,8509,6151,4344,6196,6657,8322.68977,7630,7971,46205,6110,-5936,-10421,6141,52026,52315,40269,35784,52346
6091,CA,10380,7312,8234,8509,6151,4344,6074,7312,9237.595383,7630,8509,47413,6377,-5669,-10022,6408,51004,53790,41744,37391,53821
6093,CA,9468,7312,8234,8509,6151,4344,5951,7312,9001.490708,7630,8509,46264,6110,-5936,-10421,6141,49969,52374,40328,35843,52405
6095,CA,13956,7312,8234,8509,6151,4344,6558,7348,8647.333697,7630,9239,51164,7176,-4870,-8827,7207,55064,58340,46294,42337,58371
6097,CA,15012,7312,8234,8509,6151,4344,6701,7691,10034.44866,7630,8897,53608,7709,-4337,-8030,7740,56263,61317,49271,45578,61348
6099,CA,10920,7312,8234,8509,6151,4344,6148,6633,8411.229022,7630,8624,46562,6110,-5936,-10421,6141,51618,52672,40626,36141,52703
6101,CA,9480,7312,8234,8509,6151,4344,5953,6599,7466.810325,7630,8401,43921,5048,-6998,-11575,5079,49983,48969,36923,32346,49000
6103,CA,10080,7312,8234,8509,6151,4344,6034,6467,8824.412203,7630,8016,45361,5844,-6202,-10819,5875,50664,51205,39159,34542,51236
6105,CA,11316,7312,8234,8509,6151,4344,6201,7312,8794.899118,7630,8509,47906,6377,-5669,-10022,6408,52067,54283,42237,37884,54314
6107,CA,8988,7312,8234,8509,6151,4344,5886,6208,8027.558927,7630,8702,43900,5048,-6998,-11575,5079,49424,48948,36902,32325,48979
6109,CA,11328,7312,8234,8509,6151,4344,6203,6671,10624.71034,7630,7705,48303,6643,-5403,-9624,6674,52081,54946,42900,38679,54977
6111,CA,17748,7312,8234,8509,6151,4344,7071,8159,9591.752394,7630,9695,57167,8775,-3271,-6436,8806,59369,65942,53896,50731,65973
6113,CA,13248,7312,8234,8509,6151,4344,6462,7469,9001.490708,7630,8583,50276,7176,-4870,-8827,7207,54260,57452,45406,41449,57483
6115,CA,9480,7312,8234,8509,6151,4344,5953,6524,7791.454252,7630,8404,44173,5482,-6564,-11199,5513,49983,49655,37609,32974,49686
8001,CO,11520,12426,8234,8509,5956,4344,7582,13647,8263.663601,8530,9030,55335,8763,-2733,-6162,9344,58571,64098,52602,49173,64679
8003,CO,7668,12426,8234,8509,5956,4344,6960,12426,8971.977624,8530,8509,50449,7685,-3811,-7768,8266,54097,58134,46638,42681,58715
8005,CO,11520,12426,8234,8509,5956,4344,7582,14521,8883.438371,8530,9043,56842,9302,-2194,-5359,9883,58571,66144,54648,51483,66725
8007,CO,8772,12426,8234,8509,5956,4344,7138,12426,8883.438371,8530,8509,51464,7685,-3811,-7768,8266,55379,59149,47653,43696,59730
8009,CO,7644,12426,8234,8509,5956,4344,6956,12426,7673.401915,8530,8509,49126,7416,-4080,-8169,7997,54069,56542,45046,40957,57123
8011,CO,7644,12426,8234,8509,5956,4344,6956,12426,8116.09818,8530,8509,49569,7416,-4080,-8169,7997,54069,56985,45489,41400,57566
8013,CO,14136,12426,8234,8509,5956,4344,8005,14908,10004.93557,8530,8936,60858,10612,-884,-3521,11193,61610,71470,59974,57337,72051
8014,CO,11520,12426,8234,8509,5956,4344,7582,14515,10418.11875,8530,9018,58346,9841,-1655,-4556,10422,58571,68187,56691,53790,68768
8015,CO,8364,12426,8234,8509,5956,4344,7072,12426,8824.412203,8530,8509,50997,7685,-3811,-7768,8266,54905,58682,47186,43229,59263
8017,CO,7644,12426,8234,8509,5956,4344,6956,12426,8234.150517,8530,8509,49687,7416,-4080,-8169,7997,54069,57103,45607,41518,57684
8019,CO,11520,12426,8234,8509,5956,4344,7582,13027,9149.05613,8530,8972,55541,8763,-2733,-6162,9344,58571,64304,52808,49379,64885
8021,CO,7644,12426,8234,8509,5956,4344,6956,12426,9001.490708,8530,8509,50454,7685,-3811,-7768,8266,54069,58139,46643,42686,58720
8023,CO,7644,12426,8234,8509,5956,4344,6956,12426,9119.543045,8530,8509,50573,7685,-3811,-7768,8266,54069,58258,46762,42805,58839
8025,CO,7644,12426,8234,8509,5956,4344,6956,12426,8588.307528,8530,8509,50041,7685,-3811,-7768,8266,54069,57726,46230,42273,58307
8027,CO,7644,12426,8234,8509,5956,4344,6956,12426,8057.072011,8530,8509,49510,7416,-4080,-8169,7997,54069,56926,45430,41341,57507
8029,CO,9120,12426,8234,8509,5956,4344,7195,12426,8883.438371,8530,8509,51812,7685,-3811,-7768,8266,55784,59497,48001,44044,60078
8031,CO,11520,12426,8234,8509,5956,4344,7582,14429,9178.569214,8530,9075,57077,9302,-2194,-5359,9883,58571,66379,54883,51718,66960
8033,CO,7644,12426,8234,8509,5956,4344,6956,12426,9650.778563,8530,8509,51104,7685,-3811,-7768,8266,54069,58789,47293,43336,59370
8035,CO,11520,12426,8234,8509,5956,4344,7582,15239,9090.029961,8530,9005,57729,9302,-2194,-5359,9883,58571,67031,55535,52370,67612
8037,CO,14328,12426,8234,8509,5956,4344,8036,17353,8765.386034,8530,9824,63145,11151,-345,-2718,11732,61833,74296,62800,60427,74877
8039,CO,11520,12426,8234,8509,5956,4344,7582,14117,9444.186973,8530,8976,56931,9302,-2194,-5359,9883,58571,66233,54737,51572,66814
8041,CO,9684,12426,8234,8509,5956,4344,7286,13348,8529.28136,8530,8622,53057,8224,-3272,-6965,8805,56439,61281,49785,46092,61862
8043,CO,7968,12426,8234,8509,5956,4344,7008,11907,8411.229022,8530,6971,48132,7146,-4350,-8571,7727,54445,55278,43782,39561,55859
8045,CO,13440,12426,8234,8509,5956,4344,7892,14843,9444.186973,8530,9088,59689,9841,-1655,-4556,10422,60801,69530,58034,55133,70111
8047,CO,11520,12426,8234,8509,5956,4344,7582,12832,9119.543045,8530,8959,55304,8763,-2733,-6162,9344,58571,64067,52571,49142,64648
8049,CO,10680,12426,8234,8509,5956,4344,7446,12426,9237.595383,8530,8509,53727,8224,-3272,-6965,8805,57595,61951,50455,46762,62532
8051,CO,10716,12426,8234,8509,5956,4344,7452,12426,9178.569214,8530,8509,53704,8224,-3272,-6965,8805,57637,61928,50432,46739,62509
8053,CO,10344,12426,8234,8509,5956,4344,7392,12426,10063.96174,8530,8509,54217,8763,-2733,-6162,9344,57205,62980,51484,48055,63561
8055,CO,8364,12426,8234,8509,5956,4344,7072,12426,8322.68977,8530,8509,50496,7685,-3811,-7768,8266,54905,58181,46685,42728,58762
8057,CO,8340,12426,8234,8509,5956,4344,7069,12426,10063.96174,8530,8509,52213,8224,-3272,-6965,8805,54878,60437,48941,45248,61018
8059,CO,11520,12426,8234,8509,5956,4344,7582,14264,9149.05613,8530,9028,56835,9302,-2194,-5359,9883,58571,66137,54641,51476,66718
8061,CO,7644,12426,8234,8509,5956,4344,6956,12426,8175.124348,8530,8509,49628,7416,-4080,-8169,7997,54069,57044,45548,41459,57625
8063,CO,7644,12426,8234,8509,5956,4344,6956,12426,8204.637432,8530,8509,49658,7416,-4080,-8169,7997,54069,57074,45578,41489,57655
8065,CO,11772,12426,8234,8509,5956,4344,7623,12426,9857.370153,8530,8509,55438,8763,-2733,-6162,9344,58864,64201,52705,49276,64782
8067,CO,11064,12426,8234,8509,5956,4344,7508,14066,10447.63184,8530,8480,56932,9302,-2194,-5359,9883,58041,66234,54738,51573,66815
8069,CO,10752,12426,8234,8509,5956,4344,7458,13620,9237.595383,8530,8548,55032,8763,-2733,-6162,9344,57679,63795,52299,48870,64376
8071,CO,8208,12426,8234,8509,5956,4344,7047,12426,8263.663601,8530,8509,50281,7685,-3811,-7768,8266,54724,57966,46470,42513,58547
8073,CO,8256,12426,8234,8509,5956,4344,7055,12426,8971.977624,8530,8509,51037,7685,-3811,-7768,8266,54780,58722,47226,43269,59303
8075,CO,7716,12426,8234,8509,5956,4344,6968,11347,8234.150517,8530,8321,48492,7146,-4350,-8571,7727,54153,55638,44142,39921,56219
8077,CO,9180,12426,8234,8509,5956,4344,7204,12853,8647.333697,8530,8247,51801,7685,-3811,-7768,8266,55853,59486,47990,44033,60067
8079,CO,9468,12426,8234,8509,5956,4344,7251,12426,9827.857068,8530,8509,53105,8224,-3272,-6965,8805,56188,61329,49833,46140,61910
8081,CO,8856,12426,8234,8509,5956,4344,7152,12793,9178.569214,8530,8627,52329,8224,-3272,-6965,8805,55477,60553,49057,45364,61134
8083,CO,7644,12426,8234,8509,5956,4344,6956,12426,8794.899118,8530,8509,50248,7685,-3811,-7768,8266,54069,57933,46437,42480,58514
8085,CO,9120,12426,8234,8509,5956,4344,7195,12635,9090.029961,8530,8064,51783,7685,-3811,-7768,8266,55784,59468,47972,44015,60049
8087,CO,7920,12426,8234,8509,5956,4344,7001,12051,8234.150517,8530,8347,49426,7416,-4080,-8169,7997,54390,56842,45346,41257,57423
8089,CO,7644,12426,8234,8509,5956,4344,6956,12426,8027.558927,8530,8509,49481,7416,-4080,-8169,7997,54069,56897,45401,41312,57478
8091,CO,12168,12426,8234,8509,5956,4344,7687,12426,9208.082298,8530,8509,55185,8763,-2733,-6162,9344,59324,63948,52452,49023,64529
8093,CO,11520,12426,8234,8509,5956,4344,7582,12359,8883.438371,8530,8944,54580,8763,-2733,-6162,9344,58571,63343,51847,48418,63924
8095,CO,7920,12426,8234,8509,5956,4344,7001,12426,8558.794444,8530,8509,50288,7685,-3811,-7768,8266,54390,57973,46477,42520,58554
8097,CO,15972,12426,8234,8509,5956,4344,8301,16274,9562.23931,8530,9084,63766,11151,-345,-2718,11732,63742,74917,63421,61048,75498
8099,CO,7644,12426,8234,8509,5956,4344,6956,12426,8086.585095,8530,8509,49540,7416,-4080,-8169,7997,54069,56956,45460,41371,57537
8101,CO,8316,12426,8234,8509,5956,4344,7065,11620,7968.532758,8530,7962,48740,7146,-4350,-8571,7727,54850,55886,44390,40169,56467
8103,CO,8604,12426,8234,8509,5956,4344,7111,12426,9296.621551,8530,8509,51710,7685,-3811,-7768,8266,55184,59395,47899,43942,59976
8105,CO,7644,12426,8234,8509,5956,4344,6956,12426,9208.082298,8530,8509,50661,7685,-3811,-7768,8266,54069,58346,46850,42893,58927
8107,CO,12960,12426,8234,8509,5956,4344,7815,15274,11362.53745,8530,9002,61473,10612,-884,-3521,11193,60244,72085,60589,57952,72666
8109,CO,7644,12426,8234,8509,5956,4344,6956,12426,9119.543045,8530,8509,50573,7685,-3811,-7768,8266,54069,58258,46762,42805,58839
8111,CO,10104,12426,8234,8509,5956,4344,7353,12426,9945.909406,8530,8509,53859,8224,-3272,-6965,8805,56926,62083,50587,46894,62664
8113,CO,13428,12426,8234,8509,5956,4344,7890,12426,9031.003793,8530,8509,56268,9302,-2194,-5359,9883,60787,65570,54074,50909,66151
8115,CO,7644,12426,8234,8509,5956,4344,6956,12426,8676.846781,8530,8509,50130,7685,-3811,-7768,8266,54069,57815,46319,42362,58396
8117,CO,14796,12426,8234,8509,5956,4344,8111,16388,11333.02437,8530,9200,64591,11690,194,-1915,12271,62376,76281,64785,62676,76862
8119,CO,10332,12426,8234,8509,5956,4344,7390,12484,9591.752394,8530,8602,53884,8224,-3272,-6965,8805,57191,62108,50612,46919,62689
8121,CO,7740,12426,8234,8509,5956,4344,6972,12426,8617.820612,8530,8509,50167,7685,-3811,-7768,8266,54181,57852,46356,42399,58433
8123,CO,8508,12426,8234,8509,5956,4344,7096,12931,8676.846781,8530,8783,51773,7685,-3811,-7768,8266,55073,59458,47962,44005,60039
8125,CO,7644,12426,8234,8509,5956,4344,6956,12426,8234.150517,8530,8509,49687,7416,-4080,-8169,7997,54069,57103,45607,41518,57684
9001,CT,16851,12733,8011,7901,7178,3987,8836,17369,9360.694407,9647,8837,66052,11574,-405,-2250,11672,65497,77626,65647,63802,77724
9003,CT,14040,12733,8011,7901,7178,3987,8372,14124,8326.998092,9647,8391,58516,8038,-3941,-6842,8136,62222,66554,54575,51674,66652
9005,CT,11736,12733,8011,7901,7178,3987,7992,11760,8929.987609,9647,8440,54501,6932,-5047,-8476,7030,59538,61433,49454,46025,61531
9007,CT,14512,12733,8011,7901,7178,3987,8450,12960,9475.549553,9647,8361,58943,8038,-3941,-6842,8136,62772,66981,55002,52101,67079
9009,CT,13945,12733,8011,7901,7178,3987,8356,14887,8384.425665,9647,8323,59174,8038,-3941,-6842,8136,62111,67212,55233,52332,67310
9011,CT,12499,12733,8011,7901,7178,3987,8118,12561,9331.98062,9647,8318,56343,7485,-4494,-7659,7583,60427,63828,51849,48684,63926
9013,CT,14040,12733,8011,7901,7178,3987,8372,12257,8958.701396,9647,8365,57255,7485,-4494,-7659,7583,62222,64740,52761,49596,64838
9015,CT,11256,12733,8011,7901,7178,3987,7912,11746,8011.14644,9647,8407,53055,6379,-5600,-9293,6477,58978,59434,47455,43762,59532
10001,DE,10920,9562,6898,9859,6601,4284,6877,7929,6898.126095,10670,10020,50722,5923,-6154,-10111,5923,55001,56645,44568,40611,56645
10003,DE,13620,9562,6898,9859,6601,4284,7293,13553,7540.962218,10670,10420,60088,8179,-3898,-6799,8179,58117,68267,56190,53289,68267
10005,DE,10008,9562,6898,9859,6601,4284,6736,8096,7516.237752,10670,9702,50276,5641,-6436,-10525,5641,53948,55917,43840,39751,55917
12001,FL,10428,21631,6898,9859,7312,4284,5216,24202,7862.38028,8090,9292,64158,9065,-3012,-5385,9065,65628,73223,61146,58773,73223
12003,FL,8772,21631,6898,9859,7312,4284,5025,22757,6848.677162,8090,9837,60589,8612,-3465,-6102,8612,63781,69201,57124,54487,69201
12005,FL,10344,21631,6898,9859,7312,4284,5206,23630,7516.237752,8090,9542,63406,9065,-3012,-5385,9065,65534,72471,60394,58021,72471
12007,FL,7644,21631,6898,9859,7312,4284,4895,21631,6477.810168,8090,9859,57986,8159,-3918,-6819,8159,62523,66145,54068,51167,66145
12009,FL,10344,21631,6898,9859,7312,4284,5206,22485,7145.370758,8090,9342,61691,8612,-3465,-6102,8612,65534,70303,58226,55589,70303
12011,FL,15120,21631,6898,9859,7312,4284,5756,28522,7714.033482,8090,9913,73643,11330,-555,-1800,11330,70860,84973,73088,71843,84973
12013,FL,7644,21631,6898,9859,7312,4284,4895,21631,7367.890954,8090,9859,58876,8159,-3918,-6819,8159,62523,67035,54958,52057,67035
12015,FL,10308,21631,6898,9859,7312,4284,5202,22002,7417.339887,8090,8675,60777,8612,-3465,-6102,8612,65494,69389,57312,54675,69389
12017,FL,8964,21631,6898,9859,7312,4284,5047,20367,7516.237752,8090,8234,57455,7706,-4371,-7536,7706,63995,65161,53084,49919,65161
12019,FL,11220,21631,6898,9859,7312,4284,5307,22347,7442.064353,8090,9837,63221,9065,-3012,-5385,9065,66511,72286,60209,57836,72286
12021,FL,12072,21631,6898,9859,7312,4284,5405,29285,7664.58455,8090,9655,71051,10877,-1200,-2517,10877,67461,81928,69851,68534,81928
12023,FL,9372,21631,6898,9859,7312,4284,5094,22024,6972.299494,8090,8847,59589,8159,-3918,-6819,8159,64450,67748,55671,52770,67748
12027,FL,7848,21631,6898,9859,7312,4284,4919,22861,6823.952696,8090,8926,58833,8159,-3918,-6819,8159,62751,66992,54915,52014,66992
12029,FL,7644,21631,6898,9859,7312,4284,4895,21631,6898.126095,8090,9859,58406,8159,-3918,-6819,8159,62523,66565,54488,51587,66565
12031,FL,11220,21631,6898,9859,7312,4284,5307,23087,7318.442022,8090,9836,63836,9065,-3012,-5385,9065,66511,72901,60824,58451,72901
12033,FL,9960,21631,6898,9859,7312,4284,5162,21103,7120.646291,8090,9546,60104,8159,-3918,-6819,8159,65106,68263,56186,53285,68263
12035,FL,11988,21631,6898,9859,7312,4284,5396,21106,7738.757949,8090,9197,62404,8612,-3465,-6102,8612,67368,71016,58939,56302,71016
12037,FL,8436,21631,6898,9859,7312,4284,4986,21631,6823.952696,8090,9859,59124,8159,-3918,-6819,8159,63406,67283,55206,52305,67283
12039,FL,10920,21631,6898,9859,7312,4284,5273,20691,6774.503763,8090,9502,60261,8612,-3465,-6102,8612,66177,68873,56796,54159,68873
12041,FL,10428,21631,6898,9859,7312,4284,5216,23348,7540.962218,8090,9333,63024,9065,-3012,-5385,9065,65628,72089,60012,57639,72089
12043,FL,8952,21631,6898,9859,7312,4284,5046,21631,7639.860083,8090,9859,60456,8159,-3918,-6819,8159,63982,68615,56538,53637,68615
12045,FL,8484,21631,6898,9859,7312,4284,4992,21891,7466.788819,8090,9552,59768,8159,-3918,-6819,8159,63460,67927,55850,52949,67927
12047,FL,7644,21631,6898,9859,7312,4284,4895,21631,6799.22823,8090,9859,58307,8159,-3918,-6819,8159,62523,66466,54389,51488,66466
12049,FL,8136,21631,6898,9859,7312,4284,4952,21452,6527.2591,8090,9516,58005,8159,-3918,-6819,8159,63072,66164,54087,51186,66164
12051,FL,9336,21631,6898,9859,7312,4284,5090,21761,6799.22823,8090,9297,59566,8159,-3918,-6819,8159,64410,67725,55648,52747,67725
12053,FL,11412,21631,6898,9859,7312,4284,5329,20007,7145.370758,8090,9437,60376,8612,-3465,-6102,8612,66725,68988,56911,54274,68988
12055,FL,8364,21631,6898,9859,7312,4284,4978,21288,7145.370758,8090,8266,57437,7706,-4371,-7536,7706,63326,65143,53066,49901,65143
12057,FL,11412,21631,6898,9859,7312,4284,5329,24408,7343.166488,8090,9379,64916,9518,-2559,-4668,9518,66725,74434,62357,60248,74434
12059,FL,7644,21631,6898,9859,7312,4284,4895,21631,7763.482415,8090,9859,59271,8159,-3918,-6819,8159,62523,67430,55353,52452,67430
12061,FL,10368,21631,6898,9859,7312,4284,5209,23470,7837.655814,8090,8968,63018,9065,-3012,-5385,9065,65561,72083,60006,57633,72083
12063,FL,7644,21631,6898,9859,7312,4284,4895,21631,7244.268623,8090,9859,58752,8159,-3918,-6819,8159,62523,66911,54834,51933,66911
12065,FL,10920,21631,6898,9859,7312,4284,5273,21374,7145.370758,8090,9509,61322,8612,-3465,-6102,8612,66177,69934,57857,55220,69934
12067,FL,7644,21631,6898,9859,7312,4284,4895,21631,6873.401628,8090,9859,58381,8159,-3918,-6819,8159,62523,66540,54463,51562,66540
12069,FL,11796,21631,6898,9859,7312,4284,5373,22205,7170.095224,8090,9964,63510,9065,-3012,-5385,9065,67153,72575,60498,58125,72575
12071,FL,10716,21631,6898,9859,7312,4284,5249,24679,7392.615421,8090,9361,64522,9518,-2559,-4668,9518,65949,74040,61963,59854,74040
12073,FL,10920,21631,6898,9859,7312,4284,5273,24189,7417.339887,8090,9474,64374,9065,-3012,-5385,9065,66177,73439,61362,58989,73439
12075,FL,7644,21631,6898,9859,7312,4284,4895,21631,6898.126095,8090,9859,58406,8159,-3918,-6819,8159,62523,66565,54488,51587,66565
12077,FL,7644,21631,6898,9859,7312,4284,4895,21631,7318.442022,8090,9859,58826,8159,-3918,-6819,8159,62523,66985,54908,52007,66985
12079,FL,7884,21631,6898,9859,7312,4284,4923,21631,7120.646291,8090,9859,58869,8159,-3918,-6819,8159,62791,67028,54951,52050,67028
12081,FL,12132,21631,6898,9859,7312,4284,5412,25220,7738.757949,8090,9080,66545,9518,-2559,-4668,9518,67528,76063,63986,61877,76063
12083,FL,9444,21631,6898,9859,7312,4284,5102,20811,6922.850561,8090,8574,58126,8159,-3918,-6819,8159,64530,66285,54208,51307,66285
12085,FL,11112,21631,6898,9859,7312,4284,5295,26656,8505.216404,8090,9240,67887,9971,-2106,-3951,9971,66391,77858,65781,63936,77858
12086,FL,13992,21631,6898,9859,7312,4284,5626,28063,7837.655814,8090,9916,72183,10877,-1200,-2517,10877,69602,83060,70983,69666,83060
12087,FL,16392,21631,6898,9859,7312,4284,5903,29295,8974.981263,8090,9935,76971,11783,218,-1083,11783,72279,88754,77189,75888,88754
12089,FL,11220,21631,6898,9859,7312,4284,5307,24041,7936.553679,8090,9838,65409,9518,-2559,-4668,9518,66511,74927,62850,60741,74927
12091,FL,10668,21631,6898,9859,7312,4284,5243,22988,7565.686685,8090,9702,63298,9065,-3012,-5385,9065,65895,72363,60286,57913,72363
12093,FL,9108,21631,6898,9859,7312,4284,5064,22235,6873.401628,8090,8845,59436,8159,-3918,-6819,8159,64156,67595,55518,52617,67595
12095,FL,11796,21631,6898,9859,7312,4284,5373,24720,7194.81969,8090,9979,66065,9518,-2559,-4668,9518,67153,75583,63506,61397,75583
12097,FL,11796,21631,6898,9859,7312,4284,5373,23474,6823.952696,8090,9971,64439,9518,-2559,-4668,9518,67153,73957,61880,59771,73957
12099,FL,14424,21631,6898,9859,7312,4284,5676,27979,7887.104746,8090,9908,72573,10877,-1200,-2517,10877,70084,83450,71373,70056,83450
12101,FL,11412,21631,6898,9859,7312,4284,5329,22643,7367.890954,8090,9412,63208,9065,-3012,-5385,9065,66725,72273,60196,57823,72273
12103,FL,11412,21631,6898,9859,7312,4284,5329,25370,7466.788819,8090,9351,65973,9518,-2559,-4668,9518,66725,75491,63414,61305,75491
12105,FL,9684,21631,6898,9859,7312,4284,5130,22130,6922.850561,8090,9457,60568,8612,-3465,-6102,8612,64798,69180,57103,54466,69180
12107,FL,7812,21631,6898,9859,7312,4284,4914,21910,6922.850561,8090,8440,57459,7706,-4371,-7536,7706,62710,65165,53088,49923,65165
12109,FL,11220,21631,6898,9859,7312,4284,5307,25451,8406.318538,8090,9837,67288,9518,-2559,-4668,9518,66511,76806,64729,62620,76806
12111,FL,11112,21631,6898,9859,7312,4284,5295,21831,7343.166488,8090,9266,61927,8612,-3465,-6102,8612,66391,70539,58462,55825,70539
12113,FL,9960,21631,6898,9859,7312,4284,5162,21504,7862.38028,8090,9555,61256,8612,-3465,-6102,8612,65106,69868,57791,55154,69868
12115,FL,12132,21631,6898,9859,7312,4284,5412,24409,7911.829213,8090,9089,65916,9518,-2559,-4668,9518,67528,75434,63357,61248,75434
12117,FL,11796,21631,6898,9859,7312,4284,5373,24251,7219.544157,8090,9974,65615,9518,-2559,-4668,9518,67153,75133,63056,60947,75133
12119,FL,8556,21631,6898,9859,7312,4284,5000,19147,7466.788819,8090,7994,55538,7253,-4824,-8253,7253,63540,62791,50714,47285,62791
12121,FL,7728,21631,6898,9859,7312,4284,4905,21631,6823.952696,8090,9859,58416,8159,-3918,-6819,8159,62617,66575,54498,51597,66575
12123,FL,7644,21631,6898,9859,7312,4284,4895,21631,6972.299494,8090,9859,58480,8159,-3918,-6819,8159,62523,66639,54562,51661,66639
12125,FL,7644,21631,6898,9859,7312,4284,4895,21631,7540.962218,8090,9859,59049,8159,-3918,-6819,8159,62523,67208,55131,52230,67208
12127,FL,10536,21631,6898,9859,7312,4284,5228,22165,7516.237752,8090,9189,61780,8612,-3465,-6102,8612,65748,70392,58315,55678,70392
12129,FL,9108,21631,6898,9859,7312,4284,5064,22306,7046.472893,8090,9502,60336,8612,-3465,-6102,8612,64156,68948,56871,54234,68948
12131,FL,10620,21631,6898,9859,7312,4284,5238,23230,8332.14514,8090,9712,64269,9065,-3012,-5385,9065,65842,73334,61257,58884,73334
12133,FL,7644,21631,6898,9859,7312,4284,4895,21631,6799.22823,8090,9859,58307,8159,-3918,-6819,8159,62523,66466,54389,51488,66466
13001,GA,7632,6494,6898,9859,6066,4284,5430,6494,6527.2591,7874,9859,42670,5666,-6400,-10977,5677,46663,48336,36270,31693,48347
13003,GA,7632,6494,6898,9859,6066,4284,5430,6494,6378.912303,7874,9859,42522,5666,-6400,-10977,5677,46663,48188,36122,31545,48199
13005,GA,7632,6494,6898,9859,6066,4284,5430,6494,6428.361235,7874,9859,42571,5666,-6400,-10977,5677,46663,48237,36171,31594,48248
13007,GA,8400,6494,6898,9859,6066,4284,5534,7031,6922.850561,7874,8887,43399,5666,-6400,-10977,5677,47535,49065,36999,32422,49076
13009,GA,8520,6494,6898,9859,6066,4284,5550,6810,7046.472893,7874,8446,42981,5239,-6827,-11345,5250,47671,48220,36154,31636,48231
13011,GA,8424,6494,6898,9859,6066,4284,5537,6494,6997.02396,7874,9859,43932,5666,-6400,-10977,5677,47562,49598,37532,32955,49609
13013,GA,10752,6494,6898,9859,6066,4284,5852,6309,6576.708033,7874,10081,45876,6827,-5239,-9724,6838,50205,52703,40637,36152,52714
13015,GA,10752,6494,6898,9859,6066,4284,5852,6607,6898.126095,7874,10088,46504,6827,-5239,-9724,6838,50205,53331,41265,36780,53342
13017,GA,7956,6494,6898,9859,6066,4284,5474,6235,6675.605898,7874,8451,41476,4813,-7253,-11714,4824,47031,46289,34223,29762,46300
13019,GA,7632,6494,6898,9859,6066,4284,5430,6494,6774.503763,7874,9859,42918,5666,-6400,-10977,5677,46663,48584,36518,31941,48595
13021,GA,8760,6494,6898,9859,6066,4284,5582,6515,6626.156966,7874,9366,43425,5666,-6400,-10977,5677,47943,49091,37025,32448,49102
13023,GA,7632,6494,6898,9859,6066,4284,5430,6494,6823.952696,7874,9859,42967,5666,-6400,-10977,5677,46663,48633,36567,31990,48644
13025,GA,8040,6494,6898,9859,6066,4284,5485,6849,7095.921825,7874,9439,43582,5666,-6400,-10977,5677,47126,49248,37182,32605,49259
13027,GA,8628,6494,6898,9859,6066,4284,5564,6397,6873.401628,7874,9062,43118,5666,-6400,-10977,5677,47793,48784,36718,32141,48795
13029,GA,10320,6494,6898,9859,6066,4284,5793,7108,7763.482415,7874,9774,47123,6827,-5239,-9724,6838,49714,53950,41884,37399,53961
13031,GA,8700,6494,6898,9859,6066,4284,5574,6985,7145.370758,7874,8899,43887,5666,-6400,-10977,5677,47875,49553,37487,32910,49564
13033,GA,8760,6494,6898,9859,6066,4284,5582,6485,6477.810168,7874,9611,43492,5666,-6400,-10977,5677,47943,49158,37092,32515,49169
13035,GA,9228,6494,6898,9859,6066,4284,5646,6285,8628.838735,7874,10078,46378,6140,-5926,-10561,6151,48475,52518,40452,35817,52529
13037,GA,7632,6494,6898,9859,6066,4284,5430,6494,6922.850561,7874,9859,43066,5666,-6400,-10977,5677,46663,48732,36666,32089,48743
13039,GA,9756,6494,6898,9859,6066,4284,5717,7044,7170.095224,7874,9954,46082,6541,-5525,-10142,6552,49074,52623,40557,35940,52634
13043,GA,7632,6494,6898,9859,6066,4284,5430,6494,6823.952696,7874,9859,42967,5666,-6400,-10977,5677,46663,48633,36567,31990,48644
13045,GA,10752,6494,6898,9859,6066,4284,5852,6485,7120.646291,7874,10088,46604,6827,-5239,-9724,6838,50205,53431,41365,36880,53442
13047,GA,8148,6494,6898,9859,6066,4284,5499,6453,6551.983567,7874,9508,42819,5666,-6400,-10977,5677,47248,48485,36419,31842,48496
13049,GA,7704,6494,6898,9859,6066,4284,5439,6494,7491.513286,7874,9859,43707,5666,-6400,-10977,5677,46744,49373,37307,32730,49384
13051,GA,10320,6494,6898,9859,6066,4284,5793,7283,7293.717555,7874,9767,46822,6827,-5239,-9724,6838,49714,53649,41583,37098,53660
13053,GA,8460,6494,6898,9859,6066,4284,5542,7559,7392.615421,7874,9413,44983,6140,-5926,-10561,6151,47603,51123,39057,34422,51134
13055,GA,7632,6494,6898,9859,6066,4284,5430,6131,6626.156966,7874,8546,41093,4813,-7253,-11714,4824,46663,45906,33840,29379,45917
13057,GA,10752,6494,6898,9859,6066,4284,5852,7079,7244.268623,7874,10077,47311,6827,-5239,-9724,6838,50205,54138,42072,37587,54149
13059,GA,8652,6494,6898,9859,6066,4284,5568,7204,6972.299494,7874,9566,44552,6140,-5926,-10561,6151,47821,50692,38626,33991,50703
13061,GA,7932,6494,6898,9859,6066,4284,5470,6494,7170.095224,7874,9859,43613,5666,-6400,-10977,5677,47003,49279,37213,32636,49290
13063,GA,10752,6494,6898,9859,6066,4284,5852,6823,5909.147443,7874,10099,45741,6827,-5239,-9724,6838,50205,52568,40502,36017,52579
13065,GA,7632,6494,6898,9859,6066,4284,5430,6494,6774.503763,7874,9859,42918,5666,-6400,-10977,5677,46663,48584,36518,31941,48595
13067,GA,10752,6494,6898,9859,6066,4284,5852,7561,7244.268623,7874,10099,47814,7114,-4952,-9305,7125,50205,54928,42862,38509,54939
13069,GA,7632,6494,6898,9859,6066,4284,5430,6516,6502.534634,7874,8863,41671,5239,-6827,-11345,5250,46663,46910,34844,30326,46921
13071,GA,7632,6494,6898,9859,6066,4284,5430,6560,6551.983567,7874,8986,41888,5239,-6827,-11345,5250,46663,47127,35061,30543,47138
13073,GA,8760,6494,6898,9859,6066,4284,5582,6898,7194.81969,7874,9620,44631,6140,-5926,-10561,6151,47943,50771,38705,34070,50782
13075,GA,7860,6494,6898,9859,6066,4284,5461,6494,6823.952696,7874,9859,43195,5666,-6400,-10977,5677,46922,48861,36795,32218,48872
13077,GA,10752,6494,6898,9859,6066,4284,5852,6583,7318.442022,7874,10074,46886,6827,-5239,-9724,6838,50205,53713,41647,37162,53724
13079,GA,8760,6494,6898,9859,6066,4284,5582,6920,6700.330364,7874,9392,43931,6140,-5926,-10561,6151,47943,50071,38005,33370,50082
13081,GA,7704,6494,6898,9859,6066,4284,5439,6311,6799.22823,7874,8745,41717,4813,-7253,-11714,4824,46744,46530,34464,30003,46541
13083,GA,8148,6494,6898,9859,6066,4284,5499,6309,6848.677162,7874,9510,42973,5666,-6400,-10977,5677,47248,48639,36573,31996,48650
13085,GA,10752,6494,6898,9859,6066,4284,5852,7010,7021.748426,7874,10077,47019,6827,-5239,-9724,6838,50205,53846,41780,37295,53857
13087,GA,7848,6494,6898,9859,6066,4284,5459,6392,7170.095224,7874,8541,42109,4813,-7253,-11714,4824,46908,46922,34856,30395,46933
13089,GA,10752,6494,6898,9859,6066,4284,5852,7732,7145.370758,7874,10125,47912,7114,-4952,-9305,7125,50205,55026,42960,38607,55037
13091,GA,7632,6494,6898,9859,6066,4284,5430,6494,6675.605898,7874,9859,42819,5666,-6400,-10977,5677,46663,48485,36419,31842,48496
13093,GA,7632,6494,6898,9859,6066,4284,5430,6494,6848.677162,7874,9859,42992,5666,-6400,-10977,5677,46663,48658,36592,32015,48669
13095,GA,8400,6494,6898,9859,6066,4284,5534,6547,6799.22823,7874,8752,42656,5239,-6827,-11345,5250,47535,47895,35829,31311,47906
13097,GA,10752,6494,6898,9859,6066,4284,5852,6837,6650.881432,7874,10081,46479,6827,-5239,-9724,6838,50205,53306,41240,36755,53317
13099,GA,7632,6494,6898,9859,6066,4284,5430,6494,7145.370758,7874,9859,43288,5666,-6400,-10977,5677,46663,48954,36888,32311,48965
13101,GA,8628,6494,6898,9859,6066,4284,5564,7108,6922.850561,7874,9068,43885,5666,-6400,-10977,5677,47793,49551,37485,32908,49562
13103,GA,10320,6494,6898,9859,6066,4284,5793,7108,6898.126095,7874,9771,46255,6827,-5239,-9724,6838,49714,53082,41016,36531,53093
13105,GA,7632,6494,6898,9859,6066,4284,5430,6494,6898.126095,7874,9859,43041,5666,-6400,-10977,5677,46663,48707,36641,32064,48718
13107,GA,7632,6494,6898,9859,6066,4284,5430,6494,6329.46337,7874,9859,42472,5666,-6400,-10977,5677,46663,48138,36072,31495,48149
13109,GA,7632,6494,6898,9859,6066,4284,5430,6494,7021.748426,7874,9859,43165,5666,-6400,-10977,5677,46663,48831,36765,32188,48842
13111,GA,7632,6494,6898,9859,6066,4284,5430,6494,7392.615421,7874,9859,43536,5666,-6400,-10977,5677,46663,49202,37136,32559,49213
13113,GA,10752,6494,6898,9859,6066,4284,5852,7476,7516.237752,7874,10086,47989,7114,-4952,-9305,7125,50205,55103,43037,38684,55114
13115,GA,8088,6494,6898,9859,6066,4284,5491,6373,6700.330364,7874,9385,42704,5239,-6827,-11345,5250,47180,47943,35877,31359,47954
13117,GA,10752,6494,6898,9859,6066,4284,5852,7619,8332.14514,7874,10079,48940,7114,-4952,-9305,7125,50205,56054,43988,39635,56065
13119,GA,7632,6494,6898,9859,6066,4284,5430,6494,7194.81969,7874,9859,43338,5666,-6400,-10977,5677,46663,49004,36938,32361,49015
13121,GA,10752,6494,6898,9859,6066,4284,5852,8394,7639.860083,7874,10129,49073,7400,-4666,-8887,7411,50205,56473,44407,40186,56484
13123,GA,8340,6494,6898,9859,6066,4284,5525,6494,6898.126095,7874,9859,43749,5666,-6400,-10977,5677,47466,49415,37349,32772,49426
13125,GA,7632,6494,6898,9859,6066,4284,5430,6494,6675.605898,7874,9859,42819,5666,-6400,-10977,5677,46663,48485,36419,31842,48496
13127,GA,8040,6494,6898,9859,6066,4284,5485,7147,7689.309016,7874,9400,44434,5666,-6400,-10977,5677,47126,50100,38034,33457,50111
13129,GA,8460,6494,6898,9859,6066,4284,5542,6381,6799.22823,7874,9690,43489,5666,-6400,-10977,5677,47603,49155,37089,32512,49166
13131,GA,7632,6494,6898,9859,6066,4284,5430,6494,6626.156966,7874,9859,42769,5666,-6400,-10977,5677,46663,48435,36369,31792,48446
13133,GA,7836,6494,6898,9859,6066,4284,5457,6494,7095.921825,7874,9859,43443,5666,-6400,-10977,5677,46894,49109,37043,32466,49120
13135,GA,10752,6494,6898,9859,6066,4284,5852,7299,6823.952696,7874,10092,47125,7114,-4952,-9305,7125,50205,54239,42173,37820,54250
13137,GA,7632,6494,6898,9859,6066,4284,5430,6433,7021.748426,7874,9064,42309,5239,-6827,-11345,5250,46663,47548,35482,30964,47559
13139,GA,9780,6494,6898,9859,6066,4284,5720,6878,6922.850561,7874,10096,45835,6541,-5525,-10142,6552,49101,52376,40310,35693,52387
13141,GA,7632,6494,6898,9859,6066,4284,5430,6726,7120.646291,7874,8548,42185,4813,-7253,-11714,4824,46663,46998,34932,30471,47009
13143,GA,7632,6494,6898,9859,6066,4284,5430,6397,6823.952696,7874,10080,43091,5666,-6400,-10977,5677,46663,48757,36691,32114,48768
13145,GA,8460,6494,6898,9859,6066,4284,5542,6727,7590.411151,7874,9454,44389,5666,-6400,-10977,5677,47603,50055,37989,33412,50066
13147,GA,7632,6494,6898,9859,6066,4284,5430,6494,6823.952696,7874,9859,42967,5666,-6400,-10977,5677,46663,48633,36567,31990,48644
13149,GA,10752,6494,6898,9859,6066,4284,5852,6692,7120.646291,7874,10075,46798,6827,-5239,-9724,6838,50205,53625,41559,37074,53636
13151,GA,10752,6494,6898,9859,6066,4284,5852,6733,6675.605898,7874,10083,46402,6827,-5239,-9724,6838,50205,53229,41163,36678,53240
13153,GA,9120,6494,6898,9859,6066,4284,5631,6488,6823.952696,7874,9876,44465,6140,-5926,-10561,6151,48352,50605,38539,33904,50616
13155,GA,7632,6494,6898,9859,6066,4284,5430,6494,6650.881432,7874,9859,42794,5666,-6400,-10977,5677,46663,48460,36394,31817,48471
13157,GA,9324,6494,6898,9859,6066,4284,5658,6782,7714.033482,7874,9941,45919,6541,-5525,-10142,6552,48583,52460,40394,35777,52471
13159,GA,10752,6494,6898,9859,6066,4284,5852,6322,6675.605898,7874,10069,45977,6827,-5239,-9724,6838,50205,52804,40738,36253,52815
13161,GA,7632,6494,6898,9859,6066,4284,5430,6494,6551.983567,7874,9859,42695,5666,-6400,-10977,5677,46663,48361,36295,31718,48372
13163,GA,7632,6494,6898,9859,6066,4284,5430,6494,6799.22823,7874,9859,42942,5666,-6400,-10977,5677,46663,48608,36542,31965,48619
13165,GA,7632,6494,6898,9859,6066,4284,5430,6494,6848.677162,7874,9859,42992,5666,-6400,-10977,5677,46663,48658,36592,32015,48669
13167,GA,7632,6494,6898,9859,6066,4284,5430,6005,6601.432499,7874,8820,41217,4813,-7253,-11714,4824,46663,46030,33964,29503,46041
13169,GA,8760,6494,6898,9859,6066,4284,5582,6732,5859.698511,7874,9412,42922,5666,-6400,-10977,5677,47943,48588,36522,31945,48599
13171,GA,7632,6494,6898,9859,6066,4284,5430,6539,6823.952696,7874,10081,43234,5666,-6400,-10977,5677,46663,48900,36834,32257,48911
13173,GA,8628,6494,6898,9859,6066,4284,5564,6659,6823.952696,7874,9048,43317,5666,-6400,-10977,5677,47793,48983,36917,32340,48994
13175,GA,7632,6494,6898,9859,6066,4284,5430,6484,6823.952696,7874,8770,41867,4813,-7253,-11714,4824,46663,46680,34614,30153,46691
13177,GA,8400,6494,6898,9859,6066,4284,5534,6718,7392.615421,7874,8845,43514,5666,-6400,-10977,5677,47535,49180,37114,32537,49191
13179,GA,8964,6494,6898,9859,6066,4284,5610,7118,6774.503763,7874,9740,44754,6140,-5926,-10561,6151,48175,50894,38828,34193,50905
13181,GA,7632,6494,6898,9859,6066,4284,5430,6859,7120.646291,7874,9613,43383,5666,-6400,-10977,5677,46663,49049,36983,32406,49060
13183,GA,7632,6494,6898,9859,6066,4284,5430,7197,6650.881432,7874,9750,43388,5666,-6400,-10977,5677,46663,49054,36988,32411,49065
13185,GA,8628,6494,6898,9859,6066,4284,5564,6565,6972.299494,7874,9004,43327,5666,-6400,-10977,5677,47793,48993,36927,32350,49004
13187,GA,8952,6494,6898,9859,6066,4284,5608,6494,7417.339887,7874,9859,44880,6140,-5926,-10561,6151,48161,51020,38954,34319,51031
13189,GA,8760,6494,6898,9859,6066,4284,5582,6452,6725.054831,7874,9606,43701,5666,-6400,-10977,5677,47943,49367,37301,32724,49378
13191,GA,8040,6494,6898,9859,6066,4284,5485,7220,7170.095224,7874,9435,44023,5666,-6400,-10977,5677,47126,49689,37623,33046,49700
13193,GA,7632,6494,6898,9859,6066,4284,5430,6494,6848.677162,7874,9859,42992,5666,-6400,-10977,5677,46663,48658,36592,32015,48669
13195,GA,8652,6494,6898,9859,6066,4284,5568,6527,7244.268623,7874,9586,44167,5666,-6400,-10977,5677,47821,49833,37767,33190,49844
13197,GA,8460,6494,6898,9859,6066,4284,5542,6728,6626.156966,7874,9425,43397,5666,-6400,-10977,5677,47603,49063,36997,32420,49074
13199,GA,7632,6494,6898,9859,6066,4284,5430,6269,7540.962218,7874,10075,43675,5666,-6400,-10977,5677,46663,49341,37275,32698,49352
13201,GA,7632,6494,6898,9859,6066,4284,5430,6494,7021.748426,7874,9859,43165,5666,-6400,-10977,5677,46663,48831,36765,32188,48842
13205,GA,8268,6494,6898,9859,6066,4284,5516,6494,6823.952696,7874,9859,43603,5666,-6400,-10977,5677,47385,49269,37203,32626,49280
13207,GA,7812,6494,6898,9859,6066,4284,5454,6822,6898.126095,7874,9384,43074,5666,-6400,-10977,5677,46867,48740,36674,32097,48751
13209,GA,7632,6494,6898,9859,6066,4284,5430,6547,6502.534634,7874,8698,41538,4813,-7253,-11714,4824,46663,46351,34285,29824,46362
13211,GA,8388,6494,6898,9859,6066,4284,5532,6600,6922.850561,7874,10072,44140,6140,-5926,-10561,6151,47521,50280,38214,33579,50291
13213,GA,8004,6494,6898,9859,6066,4284,5480,6629,7120.646291,7874,9367,43279,5666,-6400,-10977,5677,47085,48945,36879,32302,48956
13215,GA,8460,6494,6898,9859,6066,4284,5542,6651,7639.860083,7874,9393,44301,5666,-6400,-10977,5677,47603,49967,37901,33324,49978
13217,GA,10752,6494,6898,9859,6066,4284,5852,6350,6576.708033,7874,10081,45917,6827,-5239,-9724,6838,50205,52744,40678,36193,52755
13219,GA,8652,6494,6898,9859,6066,4284,5568,7074,7565.686685,7874,9610,45059,6140,-5926,-10561,6151,47821,51199,39133,34498,51210
13221,GA,8652,6494,6898,9859,6066,4284,5568,6610,7244.268623,7874,9600,44264,5666,-6400,-10977,5677,47821,49930,37864,33287,49941
13223,GA,10752,6494,6898,9859,6066,4284,5852,6348,6700.330364,7874,10076,46034,6827,-5239,-9724,6838,50205,52861,40795,36310,52872
13225,GA,7692,6494,6898,9859,6066,4284,5438,6458,6453.085702,7874,9875,42636,5666,-6400,-10977,5677,46731,48302,36236,31659,48313
13227,GA,10752,6494,6898,9859,6066,4284,5852,6755,7244.268623,7874,10080,46989,6827,-5239,-9724,6838,50205,53816,41750,37265,53827
13229,GA,7632,6494,6898,9859,6066,4284,5430,6447,6428.361235,7874,8712,41377,4813,-7253,-11714,4824,46663,46190,34124,29663,46201
13231,GA,10752,6494,6898,9859,6066,4284,5852,6671,6823.952696,7874,10072,46477,6827,-5239,-9724,6838,50205,53304,41238,36753,53315
13233,GA,8052,6494,6898,9859,6066,4284,5487,6293,6749.779297,7874,9106,42359,5239,-6827,-11345,5250,47140,47598,35532,31014,47609
13235,GA,7632,6494,6898,9859,6066,4284,5430,6237,6774.503763,7874,9875,42676,5239,-6827,-11345,5250,46663,47915,35849,31331,47926
13237,GA,9684,6494,6898,9859,6066,4284,5707,6494,6848.677162,7874,9859,45044,6541,-5525,-10142,6552,48992,51585,39519,34902,51596
13239,GA,7632,6494,6898,9859,6066,4284,5430,6494,7318.442022,7874,9859,43461,5666,-6400,-10977,5677,46663,49127,37061,32484,49138
13241,GA,9204,6494,6898,9859,6066,4284,5642,6494,6922.850561,7874,9859,44638,6140,-5926,-10561,6151,48447,50778,38712,34077,50789
13243,GA,7632,6494,6898,9859,6066,4284,5430,6494,7293.717555,7874,9859,43437,5666,-6400,-10977,5677,46663,49103,37037,32460,49114
13245,GA,8760,6494,6898,9859,6066,4284,5582,6662,6700.330364,7874,9609,43889,6140,-5926,-10561,6151,47943,50029,37963,33328,50040
13247,GA,10752,6494,6898,9859,6066,4284,5852,6745,6551.983567,7874,10081,46288,6827,-5239,-9724,6838,50205,53115,41049,36564,53126
13249,GA,7632,6494,6898,9859,6066,4284,5430,6633,6873.401628,7874,8871,42167,5239,-6827,-11345,5250,46663,47406,35340,30822,47417
13251,GA,7632,6494,6898,9859,6066,4284,5430,6494,6848.677162,7874,9859,42992,5666,-6400,-10977,5677,46663,48658,36592,32015,48669
13253,GA,7632,6494,6898,9859,6066,4284,5430,6494,7170.095224,7874,9859,43313,5666,-6400,-10977,5677,46663,48979,36913,32336,48990
13255,GA,10752,6494,6898,9859,6066,4284,5852,6405,6873.401628,7874,10089,46277,6827,-5239,-9724,6838,50205,53104,41038,36553,53115
13257,GA,8232,6494,6898,9859,6066,4284,5511,6489,6947.575027,7874,8996,42822,5239,-6827,-11345,5250,47344,48061,35995,31477,48072
13259,GA,7632,6494,6898,9859,6066,4284,5430,6494,7318.442022,7874,9859,43461,5666,-6400,-10977,5677,46663,49127,37061,32484,49138
13261,GA,7632,6494,6898,9859,6066,4284,5430,6410,6972.299494,7874,8819,41991,4813,-7253,-11714,4824,46663,46804,34738,30277,46815
13263,GA,8568,6494,6898,9859,6066,4284,5556,6494,7343.166488,7874,9859,44422,5666,-6400,-10977,5677,47725,50088,38022,33445,50099
13265,GA,9840,6494,6898,9859,6066,4284,5728,6494,7442.064353,7874,9859,45793,6541,-5525,-10142,6552,49169,52334,40268,35651,52345
13267,GA,7632,6494,6898,9859,6066,4284,5430,6494,6428.361235,7874,9859,42571,5666,-6400,-10977,5677,46663,48237,36171,31594,48248
13269,GA,7632,6494,6898,9859,6066,4284,5430,6494,6848.677162,7874,9859,42992,5666,-6400,-10977,5677,46663,48658,36592,32015,48669
13271,GA,7632,6494,6898,9859,6066,4284,5430,6494,6576.708033,7874,9859,42720,5666,-6400,-10977,5677,46663,48386,36320,31743,48397
13273,GA,8400,6494,6898,9859,6066,4284,5534,5821,6922.850561,7874,8854,42156,5239,-6827,-11345,5250,47535,47395,35329,30811,47406
13275,GA,8376,6494,6898,9859,6066,4284,5530,6460,7219.544157,7874,8576,42789,5239,-6827,-11345,5250,47507,48028,35962,31444,48039
13277,GA,7848,6494,6898,9859,6066,4284,5459,6663,6972.299494,7874,8981,42623,5239,-6827,-11345,5250,46908,47862,35796,31278,47873
13279,GA,7632,6494,6898,9859,6066,4284,5430,6378,6650.881432,7874,8651,41470,4813,-7253,-11714,4824,46663,46283,34217,29756,46294
13281,GA,8184,6494,6898,9859,6066,4284,5504,6494,7219.544157,7874,9859,43915,5666,-6400,-10977,5677,47289,49581,37515,32938,49592
13283,GA,7632,6494,6898,9859,6066,4284,5430,6494,6626.156966,7874,9859,42769,5666,-6400,-10977,5677,46663,48435,36369,31792,48446
13285,GA,8400,6494,6898,9859,6066,4284,5534,6322,7293.717555,7874,9463,43637,5666,-6400,-10977,5677,47535,49303,37237,32660,49314
13287,GA,7632,6494,6898,9859,6066,4284,5430,6494,6749.779297,7874,9859,42893,5666,-6400,-10977,5677,46663,48559,36493,31916,48570
13289,GA,8760,6494,6898,9859,6066,4284,5582,6774,6700.330364,7874,9403,43795,5666,-6400,-10977,5677,47943,49461,37395,32818,49472
13291,GA,8664,6494,6898,9859,6066,4284,5569,6494,7442.064353,7874,9859,44617,6140,-5926,-10561,6151,47834,50757,38691,34056,50768
13293,GA,7632,6494,6898,9859,6066,4284,5430,6063,6650.881432,7874,8726,41230,4813,-7253,-11714,4824,46663,46043,33977,29516,46054
13295,GA,8148,6494,6898,9859,6066,4284,5499,6085,7021.748426,7874,9499,42912,5239,-6827,-11345,5250,47248,48151,36085,31567,48162
13297,GA,10752,6494,6898,9859,6066,4284,5852,6522,7170.095224,7874,10082,46685,6827,-5239,-9724,6838,50205,53512,41446,36961,53523
13299,GA,7680,6494,6898,9859,6066,4284,5436,6280,6403.636769,7874,8660,41181,4813,-7253,-11714,4824,46717,45994,33928,29467,46005
13301,GA,7632,6494,6898,9859,6066,4284,5430,6494,6774.503763,7874,9859,42918,5666,-6400,-10977,5677,46663,48584,36518,31941,48595
13303,GA,7632,6494,6898,9859,6066,4284,5430,6494,6626.156966,7874,9859,42769,5666,-6400,-10977,5677,46663,48435,36369,31792,48446
13305,GA,7632,6494,6898,9859,6066,4284,5430,6679,6576.708033,7874,8860,41906,5239,-6827,-11345,5250,46663,47145,35079,30561,47156
13307,GA,7632,6494,6898,9859,6066,4284,5430,6494,6898.126095,7874,9859,43041,5666,-6400,-10977,5677,46663,48707,36641,32064,48718
13309,GA,7632,6494,6898,9859,6066,4284,5430,6494,6650.881432,7874,9859,42794,5666,-6400,-10977,5677,46663,48460,36394,31817,48471
13311,GA,7788,6494,6898,9859,6066,4284,5451,6494,7021.748426,7874,9859,43321,5666,-6400,-10977,5677,46840,48987,36921,32344,48998
13313,GA,8364,6494,6898,9859,6066,4284,5529,6590,6354.187836,7874,9349,42815,5666,-6400,-10977,5677,47494,48481,36415,31838,48492
13315,GA,7632,6494,6898,9859,6066,4284,5430,6494,6774.503763,7874,9859,42918,5666,-6400,-10977,5677,46663,48584,36518,31941,48595
13317,GA,7632,6494,6898,9859,6066,4284,5430,6494,7318.442022,7874,9859,43461,5666,-6400,-10977,5677,46663,49127,37061,32484,49138
13319,GA,7632,6494,6898,9859,6066,4284,5430,6494,6725.054831,7874,9859,42868,5666,-6400,-10977,5677,46663,48534,36468,31891,48545
13321,GA,8400,6494,6898,9859,6066,4284,5534,6866,6527.2591,7874,8843,42794,5666,-6400,-10977,5677,47535,48460,36394,31817,48471
15001,HI,11400,14267,8234,8509,4732,4344,6593,14366,8942.46454,8086,8518,55656,7890,-1937,-5366,10140,58079,63546,53719,50290,65796
15003,HI,21840,14267,8234,8509,4732,4344,8129,20222,9119.543045,8086,9841,73452,13316,3681,2436,15566,70055,86768,77133,75888,89018
15005,HI,7644,14267,8234,8509,4732,4344,6040,12428,9149.05613,8086,9298,50949,6696,-3131,-7088,8946,53770,57645,47818,43861,59895
15007,HI,19164,14267,8234,8509,4732,4344,7735,16400,8440.742107,8086,9325,65759,10896,1069,-1040,13146,66985,76655,66828,64719,78905
15009,HI,15144,14267,8234,8509,4732,4344,7144,18170,9709.804731,8086,9396,64850,10291,464,-1909,12541,62374,75141,65314,62941,77391
16001,ID,8628,7568,8234,8509,5210,4344,6069,6566,8617.820612,8398,8469,45022,5608,-6207,-10842,5870,48562,50630,38815,34180,50892
16003,ID,7644,7568,8234,8509,5210,4344,5920,7568,9503.213141,8398,8509,45966,5608,-6207,-10842,5870,47429,51574,39759,35124,51836
16005,ID,7644,7568,8234,8509,5210,4344,5920,8997,8027.558927,8398,8348,45758,6020,-5795,-10412,6282,47429,51778,39963,35346,52040
16007,ID,7644,7568,8234,8509,5210,4344,5920,7568,8352.202854,8398,8509,44815,5608,-6207,-10842,5870,47429,50423,38608,33973,50685
16009,ID,7644,7568,8234,8509,5210,4344,5920,7568,8735.87295,8398,8509,45199,5608,-6207,-10842,5870,47429,50807,38992,34357,51069
16011,ID,7644,7568,8234,8509,5210,4344,5920,6572,8057.072011,8398,8680,43695,5123,-6692,-11269,5385,47429,48818,37003,32426,49080
16013,ID,11112,7568,8234,8509,5210,4344,6445,10063,12129.87764,8398,8502,54549,7519,-4296,-8253,7781,51422,62068,50253,46296,62330
16015,ID,8628,7568,8234,8509,5210,4344,6069,6803,8322.68977,8398,8476,44971,5608,-6207,-10842,5870,48562,50579,38764,34129,50841
16017,ID,8268,7568,8234,8509,5210,4344,6015,6322,9326.134635,8398,7772,44430,5123,-6692,-11269,5385,48148,49553,37738,33161,49815
16019,ID,7920,7568,8234,8509,5210,4344,5962,6338,7820.967337,8398,8748,43568,5123,-6692,-11269,5385,47747,48691,36876,32299,48953
16021,ID,7644,7568,8234,8509,5210,4344,5920,7568,9326.134635,8398,8509,45789,5608,-6207,-10842,5870,47429,51397,39582,34947,51659
16023,ID,7644,7568,8234,8509,5210,4344,5920,8550,7968.532758,8398,8695,45600,6020,-5795,-10412,6282,47429,51620,39805,35188,51882
16025,ID,7644,7568,8234,8509,5210,4344,5920,6269,8057.072011,8398,8504,43216,5123,-6692,-11269,5385,47429,48339,36524,31947,48601
16027,ID,8628,7568,8234,8509,5210,4344,6069,6327,7732.428084,8398,8471,43901,5608,-6207,-10842,5870,48562,49509,37694,33059,49771
16029,ID,7644,7568,8234,8509,5210,4344,5920,7568,7998.045842,8398,8509,44461,5608,-6207,-10842,5870,47429,50069,38254,33619,50331
16031,ID,7644,7568,8234,8509,5210,4344,5920,6474,8735.87295,8398,8434,44030,5123,-6692,-11269,5385,47429,49153,37338,32761,49415
16033,ID,7644,7568,8234,8509,5210,4344,5920,7568,8234.150517,8398,8509,44697,5608,-6207,-10842,5870,47429,50305,38490,33855,50567
16035,ID,7644,7568,8234,8509,5210,4344,5920,7568,8765.386034,8398,8509,45228,5608,-6207,-10842,5870,47429,50836,39021,34386,51098
16037,ID,7644,7568,8234,8509,5210,4344,5920,7568,9355.64772,8398,8509,45819,5608,-6207,-10842,5870,47429,51427,39612,34977,51689
16039,ID,7644,7568,8234,8509,5210,4344,5920,8226,8293.176685,8398,8354,45259,6020,-5795,-10412,6282,47429,51279,39464,34847,51541
16041,ID,7644,7568,8234,8509,5210,4344,5920,7408,8175.124348,8398,8878,44848,5608,-6207,-10842,5870,47429,50456,38641,34006,50718
16043,ID,7716,7568,8234,8509,5210,4344,5931,6980,8529.28136,8398,8266,44233,5123,-6692,-11269,5385,47512,49356,37541,32964,49618
16045,ID,7668,7568,8234,8509,5210,4344,5924,9207,8293.176685,8398,8465,46375,6317,-5498,-9983,6579,47457,52692,40877,36392,52954
16047,ID,7644,7568,8234,8509,5210,4344,5920,7568,7968.532758,8398,8509,44432,5608,-6207,-10842,5870,47429,50040,38225,33590,50302
16049,ID,7644,7568,8234,8509,5210,4344,5920,7568,9001.490708,8398,8509,45464,5608,-6207,-10842,5870,47429,51072,39257,34622,51334
16051,ID,7920,7568,8234,8509,5210,4344,5962,7811,9355.64772,8398,8718,46547,6020,-5795,-10412,6282,47747,52567,40752,36135,52829
16053,ID,7692,7568,8234,8509,5210,4344,5928,9181,7998.045842,8398,8351,45964,6317,-5498,-9983,6579,47485,52281,40466,35981,52543
16055,ID,9036,7568,8234,8509,5210,4344,6131,6551,8617.820612,8398,8216,45163,5608,-6207,-10842,5870,49032,50771,38956,34321,51033
16057,ID,7860,7568,8234,8509,5210,4344,5953,9881,8647.333697,8398,7992,47122,6317,-5498,-9983,6579,47678,53439,41624,37139,53701
16059,ID,7644,7568,8234,8509,5210,4344,5920,7568,9768.8309,8398,8509,46232,5608,-6207,-10842,5870,47429,51840,40025,35390,52102
16061,ID,7644,7568,8234,8509,5210,4344,5920,7568,8647.333697,8398,8509,45110,5608,-6207,-10842,5870,47429,50718,38903,34268,50980
16063,ID,7644,7568,8234,8509,5210,4344,5920,7062,8027.558927,8398,8503,43979,5608,-6207,-10842,5870,47429,49587,37772,33137,49849
16065,ID,7824,7568,8234,8509,5210,4344,5948,7023,8971.977624,8398,8263,44824,5608,-6207,-10842,5870,47637,50432,38617,33982,50694
16067,ID,7644,7568,8234,8509,5210,4344,5920,6973,7879.993505,8398,8434,43673,5608,-6207,-10842,5870,47429,49281,37466,32831,49543
16069,ID,7908,7568,8234,8509,5210,4344,5960,6605,10536.17109,8398,8050,45841,5123,-6692,-11269,5385,47733,50964,39149,34572,51226
16071,ID,7644,7568,8234,8509,5210,4344,5920,7568,8027.558927,8398,8509,44491,5608,-6207,-10842,5870,47429,50099,38284,33649,50361
16073,ID,8628,7568,8234,8509,5210,4344,6069,7492,8381.715938,8398,8471,45714,6020,-5795,-10412,6282,48562,51734,39919,35302,51996
16075,ID,7848,7568,8234,8509,5210,4344,5951,8775,9562.23931,8398,7697,46624,6020,-5795,-10412,6282,47664,52644,40829,36212,52906
16077,ID,7644,7568,8234,8509,5210,4344,5920,7568,8027.558927,8398,8509,44491,5608,-6207,-10842,5870,47429,50099,38284,33649,50361
16079,ID,7644,7568,8234,8509,5210,4344,5920,7568,8735.87295,8398,8509,45199,5608,-6207,-10842,5870,47429,50807,38992,34357,51069
16081,ID,8280,7568,8234,8509,5210,4344,6017,8368,8322.68977,8398,9422,47135,6618,-5197,-9550,6880,48162,53753,41938,37585,54015
16083,ID,7944,7568,8234,8509,5210,4344,5966,6770,7909.50659,8398,8343,43709,5608,-6207,-10842,5870,47775,49317,37502,32867,49579
16085,ID,8256,7568,8234,8509,5210,4344,6013,7568,8381.715938,8398,8509,45457,6020,-5795,-10412,6282,48134,51477,39662,35045,51739
16087,ID,7644,7568,8234,8509,5210,4344,5920,7568,7879.993505,8398,8509,44343,5608,-6207,-10842,5870,47429,49951,38136,33501,50213
17001,IL,7644,15136,7047,9589,6110,4046,6905,14460,6238.855979,6586,9230,48205,5101,-4357,-8446,7720,56477,53306,43848,39759,55925
17003,IL,8148,15136,7047,9589,6110,4046,6989,16023,6466.182715,6586,9242,50511,5365,-4094,-8051,7983,57065,55876,46417,42460,58494
17005,IL,8244,15136,7047,9589,6110,4046,7004,16304,6440.924189,6586,9537,51158,5365,-4094,-8051,7983,57176,56523,47064,43107,59141
17007,IL,9048,15136,7047,9589,6110,4046,7137,13362,5910.495138,6586,9438,48391,5101,-4357,-8446,7720,58113,53492,44034,39945,56111
17009,IL,9336,15136,7047,9589,6110,4046,7185,15136,6188.338927,6586,9589,50881,5365,-4094,-8051,7983,58449,56246,46787,42830,58864
17011,IL,7980,15136,7047,9589,6110,4046,6961,16140,7173.42145,6586,9426,51351,5365,-4094,-8051,7983,56869,56716,47257,43300,59334
17013,IL,9768,15136,7047,9589,6110,4046,7256,15099,6794.543556,6586,9541,51835,5893,-3566,-7259,8511,58952,57728,48269,44576,60346
17015,IL,7644,15136,7047,9589,6110,4046,6905,15136,6264.114505,6586,9589,49265,5365,-4094,-8051,7983,56477,54630,45171,41214,57248
17017,IL,7812,15136,7047,9589,6110,4046,6933,15136,6642.992399,6586,9589,49812,5365,-4094,-8051,7983,56673,55177,45718,41761,57795
17019,IL,10344,15136,7047,9589,6110,4046,7351,13287,6946.094714,6586,9225,50435,5365,-4094,-8051,7983,59623,55800,46341,42384,58418
17021,IL,8064,15136,7047,9589,6110,4046,6975,16752,5910.495138,6586,9039,50397,5365,-4094,-8051,7983,56967,55762,46303,42346,58380
17023,IL,8364,15136,7047,9589,6110,4046,7024,15136,6289.373032,6586,9589,50010,5365,-4094,-8051,7983,57316,55375,45916,41959,57993
17025,IL,7644,15136,7047,9589,6110,4046,6905,15136,6163.0804,6586,9589,49164,5365,-4094,-8051,7983,56477,54529,45070,41113,57147
17027,IL,9768,15136,7047,9589,6110,4046,7256,15750,5859.978086,6586,9537,51548,5893,-3566,-7259,8511,58952,57441,47982,44289,60059
17029,IL,8004,15136,7047,9589,6110,4046,6965,15615,6264.114505,6586,8569,49084,5101,-4357,-8446,7720,56897,54185,44727,40638,56804
17031,IL,11748,15136,7047,9589,6110,4046,7583,16861,6693.509451,6586,10353,56288,6949,-2510,-5675,9567,61259,63237,53778,50613,65855
17033,IL,7644,15136,7047,9589,6110,4046,6905,15136,6516.699768,6586,9589,49518,5365,-4094,-8051,7983,56477,54883,45424,41467,57501
17035,IL,7644,15136,7047,9589,6110,4046,6905,14083,6238.855979,6586,8651,47249,4837,-4622,-8843,7455,56477,52086,42627,38406,54704
17037,IL,10512,15136,7047,9589,6110,4046,7379,14922,7122.904397,6586,10232,53421,5893,-3566,-7259,8511,59819,59314,49855,46162,61932
17039,IL,7644,15136,7047,9589,6110,4046,6905,16645,6718.767977,6586,10175,51815,5893,-3566,-7259,8511,56477,57708,48249,44556,60326
17041,IL,8328,15136,7047,9589,6110,4046,7018,15136,6617.733873,6586,9589,50303,5365,-4094,-8051,7983,57274,55668,46209,42252,58286
17043,IL,11748,15136,7047,9589,6110,4046,7583,17754,6971.35324,6586,10274,57379,6949,-2510,-5675,9567,61259,64328,54869,51704,66946
17045,IL,7644,15136,7047,9589,6110,4046,6905,15136,6567.21682,6586,9589,49568,5365,-4094,-8051,7983,56477,54933,45474,41517,57551
17047,IL,7644,15136,7047,9589,6110,4046,6905,15136,6845.060609,6586,9589,49846,5365,-4094,-8051,7983,56477,55211,45752,41795,57829
17049,IL,7644,15136,7047,9589,6110,4046,6905,17293,5986.270717,6586,9614,51170,5893,-3566,-7259,8511,56477,57063,47604,43911,59681
17051,IL,7644,15136,7047,9589,6110,4046,6905,15136,5607.392823,6586,9589,48608,5365,-4094,-8051,7983,56477,53973,44514,40557,56591
17053,IL,10344,15136,7047,9589,6110,4046,7351,14563,6769.28503,6586,9271,51579,5365,-4094,-8051,7983,59623,56944,47485,43528,59562
17055,IL,7644,15136,7047,9589,6110,4046,6905,15136,6895.577661,6586,9589,49897,5365,-4094,-8051,7983,56477,55262,45803,41846,57880
17057,IL,7704,15136,7047,9589,6110,4046,6915,12799,5935.753664,6586,8986,46057,4573,-4885,-9238,7192,56547,50630,41172,36819,53249
17059,IL,7644,15136,7047,9589,6110,4046,6905,15136,6188.338927,6586,9589,49189,5365,-4094,-8051,7983,56477,54554,45095,41138,57172
17061,IL,7644,15136,7047,9589,6110,4046,6905,15136,6339.890084,6586,9589,49341,5365,-4094,-8051,7983,56477,54706,45247,41290,57324
17063,IL,10956,15136,7047,9589,6110,4046,7453,15648,6870.319135,6586,10236,54342,6421,-3038,-6467,9039,60337,60763,51304,47875,63381
17065,IL,7644,15136,7047,9589,6110,4046,6905,15136,6264.114505,6586,9589,49265,5365,-4094,-8051,7983,56477,54630,45171,41214,57248
17067,IL,7644,15136,7047,9589,6110,4046,6905,15011,6112.563348,6586,9098,48497,5101,-4357,-8446,7720,56477,53598,44140,40051,56217
17069,IL,7644,15136,7047,9589,6110,4046,6905,15136,6112.563348,6586,9589,49114,5365,-4094,-8051,7983,56477,54479,45020,41063,57097
17071,IL,7644,15136,7047,9589,6110,4046,6905,14244,6087.304822,6586,9051,47658,4837,-4622,-8843,7455,56477,52495,43036,38815,55113
17073,IL,8196,15136,7047,9589,6110,4046,6997,14687,6011.529243,6586,9393,48920,5101,-4357,-8446,7720,57121,54021,44563,40474,56640
17075,IL,7788,15136,7047,9589,6110,4046,6929,15136,6920.836187,6586,9589,50066,5365,-4094,-8051,7983,56645,55431,45972,42015,58049
17077,IL,8184,15136,7047,9589,6110,4046,6995,20180,6642.992399,6586,8546,54185,6421,-3038,-6467,9039,57107,60606,51147,47718,63224
17079,IL,7644,15136,7047,9589,6110,4046,6905,15136,6390.407136,6586,9589,49391,5365,-4094,-8051,7983,56477,54756,45297,41340,57374
17081,IL,7644,15136,7047,9589,6110,4046,6905,16080,6163.0804,6586,8983,49502,5365,-4094,-8051,7983,56477,54867,45408,41451,57485
17083,IL,9768,15136,7047,9589,6110,4046,7256,17733,6920.836187,6586,9538,54592,6421,-3038,-6467,9039,58952,61013,51554,48125,63631
17085,IL,7644,15136,7047,9589,6110,4046,6905,15136,7527.040817,6586,9589,50528,5365,-4094,-8051,7983,56477,55893,46434,42477,58511
17087,IL,7644,15136,7047,9589,6110,4046,6905,15136,6365.14861,6586,9589,49366,5365,-4094,-8051,7983,56477,54731,45272,41315,57349
17089,IL,11748,15136,7047,9589,6110,4046,7583,15341,6541.958294,6586,10245,54508,6421,-3038,-6467,9039,61259,60929,51470,48041,63547
17091,IL,9096,15136,7047,9589,6110,4046,7145,14135,6769.28503,6586,9451,50083,5365,-4094,-8051,7983,58169,55448,45989,42032,58066
17093,IL,11988,15136,7047,9589,6110,4046,7623,15608,6238.855979,6586,10213,54680,6421,-3038,-6467,9039,61539,61101,51642,48213,63719
17095,IL,7644,15136,7047,9589,6110,4046,6905,15845,6390.407136,6586,8668,49180,5101,-4357,-8446,7720,56477,54281,44823,40734,56900
17097,IL,11748,15136,7047,9589,6110,4046,7583,12624,7173.42145,6586,10245,52423,5893,-3566,-7259,8511,61259,58316,48857,45164,60934
17099,IL,9204,15136,7047,9589,6110,4046,7163,17410,6289.373032,6586,9417,52953,5893,-3566,-7259,8511,58295,58846,49387,45694,61464
17101,IL,7644,15136,7047,9589,6110,4046,6905,15136,6794.543556,6586,9589,49796,5365,-4094,-8051,7983,56477,55161,45702,41745,57779
17103,IL,7680,15136,7047,9589,6110,4046,6911,14242,6011.529243,6586,9287,47853,4837,-4622,-8843,7455,56519,52690,43231,39010,55308
17105,IL,8160,15136,7047,9589,6110,4046,6991,13921,5935.753664,6586,9209,47857,4837,-4622,-8843,7455,57079,52694,43235,39014,55312
17107,IL,7668,15136,7047,9589,6110,4046,6909,13884,5961.012191,6586,8585,46730,4573,-4885,-9238,7192,56505,51303,41845,37492,53922
17109,IL,8496,15136,7047,9589,6110,4046,7046,16610,6213.597453,6586,8297,50250,5365,-4094,-8051,7983,57470,55615,46156,42199,58233
17111,IL,11748,15136,7047,9589,6110,4046,7583,14312,6870.319135,6586,10219,53781,5893,-3566,-7259,8511,61259,59674,50215,46522,62292
17113,IL,10380,15136,7047,9589,6110,4046,7357,14133,6845.060609,6586,10195,52184,5893,-3566,-7259,8511,59665,58077,48618,44925,60695
17115,IL,8208,15136,7047,9589,6110,4046,6999,14019,6289.373032,6586,9088,48237,4837,-4622,-8843,7455,57135,53074,43615,39394,55692
17117,IL,7644,15136,7047,9589,6110,4046,6905,15447,7097.645871,6586,9538,50358,5365,-4094,-8051,7983,56477,55723,46264,42307,58341
17119,IL,9768,15136,7047,9589,6110,4046,7256,14594,6567.21682,6586,9530,51091,5365,-4094,-8051,7983,58952,56456,46997,43040,59074
17121,IL,7644,15136,7047,9589,6110,4046,6905,15214,6744.026504,6586,8954,49188,5101,-4357,-8446,7720,56477,54289,44831,40742,56908
17123,IL,8700,15136,7047,9589,6110,4046,7080,15884,6491.441241,6586,9442,51150,5365,-4094,-8051,7983,57708,56515,47056,43099,59133
17125,IL,7644,15136,7047,9589,6110,4046,6905,15136,6516.699768,6586,9589,49518,5365,-4094,-8051,7983,56477,54883,45424,41467,57501
17127,IL,8052,15136,7047,9589,6110,4046,6973,14968,6289.373032,6586,9027,48968,5101,-4357,-8446,7720,56953,54069,44611,40522,56688
17129,IL,8916,15136,7047,9589,6110,4046,7116,16153,6642.992399,6586,9476,51820,5893,-3566,-7259,8511,57960,57713,48254,44561,60331
17131,IL,8196,15136,7047,9589,6110,4046,6997,14314,6541.958294,6586,9398,49081,5101,-4357,-8446,7720,57121,54182,44724,40635,56801
17133,IL,9768,15136,7047,9589,6110,4046,7256,15955,7375.489659,6586,9536,53266,5893,-3566,-7259,8511,58952,59159,49700,46007,61777
17135,IL,8172,15136,7047,9589,6110,4046,6993,15136,5784.202507,6586,9589,49313,5365,-4094,-8051,7983,57093,54678,45219,41262,57296
17137,IL,7812,15136,7047,9589,6110,4046,6933,14270,5961.012191,6586,9128,47804,4837,-4622,-8843,7455,56673,52641,43182,38961,55259
17139,IL,7644,15136,7047,9589,6110,4046,6905,15136,6339.890084,6586,9589,49341,5365,-4094,-8051,7983,56477,54706,45247,41290,57324
17141,IL,8268,15136,7047,9589,6110,4046,7008,18006,5910.495138,6586,9596,52412,5893,-3566,-7259,8511,57204,58305,48846,45153,60923
17143,IL,8700,15136,7047,9589,6110,4046,7080,15131,6592.475346,6586,9418,50473,5365,-4094,-8051,7983,57708,55838,46379,42422,58456
17145,IL,7644,15136,7047,9589,6110,4046,6905,15136,6744.026504,6586,9589,49745,5365,-4094,-8051,7983,56477,55110,45651,41694,57728
17147,IL,10344,15136,7047,9589,6110,4046,7351,15506,6718.767977,6586,9274,52475,5893,-3566,-7259,8511,59623,58368,48909,45216,60986
17149,IL,7644,15136,7047,9589,6110,4046,6905,15136,6112.563348,6586,9589,49114,5365,-4094,-8051,7983,56477,54479,45020,41063,57097
17151,IL,7644,15136,7047,9589,6110,4046,6905,15136,6238.855979,6586,9589,49240,5365,-4094,-8051,7983,56477,54605,45146,41189,57223
17153,IL,7644,15136,7047,9589,6110,4046,6905,15136,6365.14861,6586,9589,49366,5365,-4094,-8051,7983,56477,54731,45272,41315,57349
17155,IL,7836,15136,7047,9589,6110,4046,6937,15708,6339.890084,6586,9430,49947,5365,-4094,-8051,7983,56701,55312,45853,41896,57930
17157,IL,7824,15136,7047,9589,6110,4046,6935,15136,5683.168402,6586,9589,48864,5365,-4094,-8051,7983,56687,54229,44770,40813,56847
17159,IL,7644,15136,7047,9589,6110,4046,6905,15136,6794.543556,6586,9589,49796,5365,-4094,-8051,7983,56477,55161,45702,41745,57779
17161,IL,8196,15136,7047,9589,6110,4046,6997,14044,6516.699768,6586,9370,48759,5101,-4357,-8446,7720,57121,53860,44402,40313,56479
17163,IL,9768,15136,7047,9589,6110,4046,7256,15171,6592.475346,6586,9528,51691,5893,-3566,-7259,8511,58952,57584,48125,44432,60202
17165,IL,7644,15136,7047,9589,6110,4046,6905,15136,5961.012191,6586,9589,48962,5365,-4094,-8051,7983,56477,54327,44868,40911,56945
17167,IL,8916,15136,7047,9589,6110,4046,7116,14053,6845.060609,6586,9457,49903,5365,-4094,-8051,7983,57960,55268,45809,41852,57886
17169,IL,7644,15136,7047,9589,6110,4046,6905,15136,6188.338927,6586,9589,49189,5365,-4094,-8051,7983,56477,54554,45095,41138,57172
17171,IL,7644,15136,7047,9589,6110,4046,6905,15341,6112.563348,6586,9177,48907,5101,-4357,-8446,7720,56477,54008,44550,40461,56627
17173,IL,7644,15136,7047,9589,6110,4046,6905,15136,6466.182715,6586,9589,49467,5365,-4094,-8051,7983,56477,54832,45373,41416,57450
17175,IL,8700,15136,7047,9589,6110,4046,7080,14689,6466.182715,6586,9448,49935,5365,-4094,-8051,7983,57708,55300,45841,41884,57918
17177,IL,7836,15136,7047,9589,6110,4046,6937,16285,6339.890084,6586,9041,50133,5365,-4094,-8051,7983,56701,55498,46039,42082,58116
17179,IL,8700,15136,7047,9589,6110,4046,7080,16187,6592.475346,6586,9428,51539,5365,-4094,-8051,7983,57708,56904,47445,43488,59522
17181,IL,7644,15136,7047,9589,6110,4046,6905,15136,6466.182715,6586,9589,49467,5365,-4094,-8051,7983,56477,54832,45373,41416,57450
17183,IL,8532,15136,7047,9589,6110,4046,7052,17117,5935.753664,6586,9024,51241,5893,-3566,-7259,8511,57512,57134,47675,43982,59752
17185,IL,7824,15136,7047,9589,6110,4046,6935,15136,6845.060609,6586,9589,50026,5365,-4094,-8051,7983,56687,55391,45932,41975,58009
17187,IL,8304,15136,7047,9589,6110,4046,7014,15136,6264.114505,6586,9589,49925,5365,-4094,-8051,7983,57246,55290,45831,41874,57908
17189,IL,7944,15136,7047,9589,6110,4046,6955,15136,6365.14861,6586,9589,49666,5365,-4094,-8051,7983,56827,55031,45572,41615,57649
17191,IL,7644,15136,7047,9589,6110,4046,6905,15136,6516.699768,6586,9589,49518,5365,-4094,-8051,7983,56477,54883,45424,41467,57501
17193,IL,7644,15136,7047,9589,6110,4046,6905,15136,6541.958294,6586,9589,49543,5365,-4094,-8051,7983,56477,54908,45449,41492,57526
17195,IL,8208,15136,7047,9589,6110,4046,6999,14513,6238.855979,6586,9280,48871,5101,-4357,-8446,7720,57135,53972,44514,40425,56591
17197,IL,11748,15136,7047,9589,6110,4046,7583,15864,6794.543556,6586,10231,55269,6421,-3038,-6467,9039,61259,61690,52231,48802,64308
17199,IL,7800,15136,7047,9589,6110,4046,6931,17348,6238.855979,6586,8567,50587,5365,-4094,-8051,7983,56659,55952,46493,42536,58570
17201,IL,9048,15136,7047,9589,6110,4046,7137,15519,6339.890084,6586,9436,50975,5365,-4094,-8051,7983,58113,56340,46881,42924,58958
17203,IL,8700,15136,7047,9589,6110,4046,7080,14786,7198.679976,6586,9441,50758,5365,-4094,-8051,7983,57708,56123,46664,42707,58741
18001,IN,7512,9358,7047,9589,5928,4046,5907,8811,6541.958294,9298,9515,45724,4459,-6055,-10540,6022,49387,50183,39669,35184,51746
18003,IN,7968,9358,7047,9589,5928,4046,5975,10364,6491.441241,9298,9449,47617,4978,-5536,-9757,6541,49911,52595,42081,37860,54158
18005,IN,9924,9358,7047,9589,5928,4046,6267,9132,6365.14861,9298,9654,48419,5238,-5276,-9365,6801,52159,53657,43143,39054,55220
18007,IN,9360,9358,7047,9589,5928,4046,6183,8758,6390.407136,9298,9255,47107,4719,-5795,-10148,6282,51511,51826,41312,36959,53389
18009,IN,7512,9358,7047,9589,5928,4046,5907,9358,6163.0804,9298,9589,45966,4459,-6055,-10540,6022,49387,50425,39911,35426,51988
18011,IN,9324,9358,7047,9589,5928,4046,6178,10799,6466.182715,9298,9575,49507,5497,-5017,-8974,7060,51470,55004,44490,40533,56567
18013,IN,9324,9358,7047,9589,5928,4046,6178,8984,6516.699768,9298,9575,47744,4978,-5536,-9757,6541,51470,52722,42208,37987,54285
18015,IN,7512,9358,7047,9589,5928,4046,5907,9594,6895.577661,9298,9249,46595,4459,-6055,-10540,6022,49387,51054,40540,36055,52617
18017,IN,7512,9358,7047,9589,5928,4046,5907,8122,5708.426928,9298,9203,43890,4200,-6314,-10931,5763,49387,48090,37576,32959,49653
18019,IN,8460,9358,7047,9589,5928,4046,6049,9096,6289.373032,9298,9411,46600,4719,-5795,-10148,6282,50477,51319,40805,36452,52882
18021,IN,8760,9358,7047,9589,5928,4046,6094,9504,5506.358718,9298,9101,46215,4719,-5795,-10148,6282,50822,50934,40420,36067,52497
18023,IN,8016,9358,7047,9589,5928,4046,5983,8989,5582.134297,9298,9648,45579,4719,-5795,-10148,6282,49967,50298,39784,35431,51861
18025,IN,7512,9358,7047,9589,5928,4046,5907,9358,6592.475346,9298,9589,46395,4459,-6055,-10540,6022,49387,50854,40340,35855,52417
18027,IN,7512,9358,7047,9589,5928,4046,5907,8517,6870.319135,9298,9602,45845,4459,-6055,-10540,6022,49387,50304,39790,35305,51867
18029,IN,8820,9358,7047,9589,5928,4046,6103,10884,6011.529243,9298,9610,48670,5238,-5276,-9365,6801,50891,53908,43394,39305,55471
18031,IN,8196,9358,7047,9589,5928,4046,6009,9243,5708.426928,9298,9433,45924,4719,-5795,-10148,6282,50173,50643,40129,35776,52206
18033,IN,7512,9358,7047,9589,5928,4046,5907,9689,6693.509451,9298,9392,46630,4459,-6055,-10540,6022,49387,51089,40575,36090,52652
18035,IN,8016,9358,7047,9589,5928,4046,5983,9047,6213.597453,9298,8506,45126,4200,-6314,-10931,5763,49967,49326,38812,34195,50889
18037,IN,7512,9358,7047,9589,5928,4046,5907,9490,6946.094714,9298,9649,46941,4719,-5795,-10148,6282,49387,51660,41146,36793,53223
18039,IN,8904,9358,7047,9589,5928,4046,6115,9473,6036.787769,9298,9597,47355,4978,-5536,-9757,6541,50987,52333,41819,37598,53896
18041,IN,7728,9358,7047,9589,5928,4046,5940,9437,6390.407136,9298,8439,45338,4200,-6314,-10931,5763,49636,49538,39024,34407,51101
18043,IN,8460,9358,7047,9589,5928,4046,6049,8474,6516.699768,9298,9412,46207,4459,-6055,-10540,6022,50477,50666,40152,35667,52229
18045,IN,7512,9358,7047,9589,5928,4046,5907,9358,6466.182715,9298,9589,46269,4459,-6055,-10540,6022,49387,50728,40214,35729,52291
18047,IN,8820,9358,7047,9589,5928,4046,6103,9358,6870.319135,9298,9589,47981,4978,-5536,-9757,6541,50891,52959,42445,38224,54522
18049,IN,7836,9358,7047,9589,5928,4046,5956,9358,6642.992399,9298,9589,46770,4719,-5795,-10148,6282,49760,51489,40975,36622,53052
18051,IN,7512,9358,7047,9589,5928,4046,5907,9358,6920.836187,9298,9589,46724,4459,-6055,-10540,6022,49387,51183,40669,36184,52746
18053,IN,7512,9358,7047,9589,5928,4046,5907,10306,6062.046295,9298,8471,45695,4459,-6055,-10540,6022,49387,50154,39640,35155,51717
18055,IN,7512,9358,7047,9589,5928,4046,5907,9358,6668.250925,9298,9589,46471,4459,-6055,-10540,6022,49387,50930,40416,35931,52493
18057,IN,9324,9358,7047,9589,5928,4046,6178,9005,7754.367553,9298,9575,49002,4978,-5536,-9757,6541,51470,53980,43466,39245,55543
18059,IN,9324,9358,7047,9589,5928,4046,6178,9451,6314.631558,9298,9575,48009,4978,-5536,-9757,6541,51470,52987,42473,38252,54550
18061,IN,8460,9358,7047,9589,5928,4046,6049,7932,6466.182715,9298,9423,45625,4459,-6055,-10540,6022,50477,50084,39570,35085,51647
18063,IN,9324,9358,7047,9589,5928,4046,6178,8963,6668.250925,9298,9575,47874,4978,-5536,-9757,6541,51470,52852,42338,38117,54415
18065,IN,7512,9358,7047,9589,5928,4046,5907,8263,5834.719559,9298,8902,43855,4200,-6314,-10931,5763,49387,48055,37541,32924,49618
18067,IN,7956,9358,7047,9589,5928,4046,5974,10128,6213.597453,9298,8893,46535,4719,-5795,-10148,6282,49898,51254,40740,36387,52817
18069,IN,7740,9358,7047,9589,5928,4046,5941,9021,5809.461033,9298,9368,45282,4459,-6055,-10540,6022,49649,49741,39227,34742,51304
18071,IN,8184,9358,7047,9589,5928,4046,6008,8590,5683.168402,9298,9346,45147,4459,-6055,-10540,6022,50160,49606,39092,34607,51169
18073,IN,8292,9358,7047,9589,5928,4046,6024,8567,6870.319135,9298,10207,47280,4719,-5795,-10148,6282,50284,51999,41485,37132,53562
18075,IN,7512,9358,7047,9589,5928,4046,5907,9358,6339.890084,9298,9589,46143,4459,-6055,-10540,6022,49387,50602,40088,35603,52165
18077,IN,7512,9358,7047,9589,5928,4046,5907,9214,5809.461033,9298,9031,44910,4459,-6055,-10540,6022,49387,49369,38855,34370,50932
18079,IN,8112,9358,7047,9589,5928,4046,5997,9274,6491.441241,9298,9256,46477,4719,-5795,-10148,6282,50077,51196,40682,36329,52759
18081,IN,9324,9358,7047,9589,5928,4046,6178,9698,6592.475346,9298,9575,48533,4978,-5536,-9757,6541,51470,53511,42997,38776,55074
18083,IN,7512,9358,7047,9589,5928,4046,5907,9791,6870.319135,9298,9060,46578,4459,-6055,-10540,6022,49387,51037,40523,36038,52600
18085,IN,8088,9358,7047,9589,5928,4046,5993,9397,6112.563348,9298,9544,46486,4719,-5795,-10148,6282,50049,51205,40691,36338,52768
18087,IN,7932,9358,7047,9589,5928,4046,5970,9358,6870.319135,9298,9589,47093,4719,-5795,-10148,6282,49870,51812,41298,36945,53375
18089,IN,9636,9358,7047,9589,5928,4046,6224,8524,6289.373032,9298,10239,48032,4978,-5536,-9757,6541,51828,53010,42496,38275,54573
18091,IN,8628,9358,7047,9589,5928,4046,6074,8993,6137.821874,9298,9101,46203,4719,-5795,-10148,6282,50670,50922,40408,36055,52485
18093,IN,7704,9358,7047,9589,5928,4046,5936,8540,5733.685454,9298,9023,44344,4200,-6314,-10931,5763,49608,48544,38030,33413,50107
18095,IN,8124,9358,7047,9589,5928,4046,5999,9056,6339.890084,9298,9573,46437,4719,-5795,-10148,6282,50091,51156,40642,36289,52719
18097,IN,9324,9358,7047,9589,5928,4046,6178,12136,6466.182715,9298,9574,50844,5497,-5017,-8974,7060,51470,56341,45827,41870,57904
18099,IN,8076,9358,7047,9589,5928,4046,5992,8725,5809.461033,9298,9401,45355,4459,-6055,-10540,6022,50036,49814,39300,34815,51377
18101,IN,7512,9358,7047,9589,5928,4046,5907,9358,6365.14861,9298,9589,46168,4459,-6055,-10540,6022,49387,50627,40113,35628,52190
18103,IN,7512,9358,7047,9589,5928,4046,5907,8877,5632.65135,9298,9137,44503,4200,-6314,-10931,5763,49387,48703,38189,33572,50266
18105,IN,9348,9358,7047,9589,5928,4046,6181,9900,7072.387345,9298,8958,48622,4978,-5536,-9757,6541,51497,53600,43086,38865,55163
18107,IN,8316,9358,7047,9589,5928,4046,6027,10076,6693.509451,9298,9327,47756,4978,-5536,-9757,6541,50311,52734,42220,37999,54297
18109,IN,9324,9358,7047,9589,5928,4046,6178,8729,6769.28503,9298,9574,47740,4978,-5536,-9757,6541,51470,52718,42204,37983,54281
18111,IN,9636,9358,7047,9589,5928,4046,6224,8780,6365.14861,9298,10194,48319,5238,-5276,-9365,6801,51828,53557,43043,38954,55120
18113,IN,7644,9358,7047,9589,5928,4046,5927,9098,6567.21682,9298,9433,46086,4459,-6055,-10540,6022,49539,50545,40031,35546,52108
18115,IN,8820,9358,7047,9589,5928,4046,6103,9410,6769.28503,9298,9611,47955,4978,-5536,-9757,6541,50891,52933,42419,38198,54496
18117,IN,7512,9358,7047,9589,5928,4046,5907,9358,6289.373032,9298,9589,46092,4459,-6055,-10540,6022,49387,50551,40037,35552,52114
18119,IN,7512,9358,7047,9589,5928,4046,5907,8827,7148.162923,9298,9002,45833,4200,-6314,-10931,5763,49387,50033,39519,34902,51596
18121,IN,7512,9358,7047,9589,5928,4046,5907,9358,6163.0804,9298,9589,45966,4459,-6055,-10540,6022,49387,50425,39911,35426,51988
18123,IN,7512,9358,7047,9589,5928,4046,5907,9358,6592.475346,9298,9589,46395,4459,-6055,-10540,6022,49387,50854,40340,35855,52417
18125,IN,7512,9358,7047,9589,5928,4046,5907,12135,6693.509451,9298,9648,49333,5238,-5276,-9365,6801,49387,54571,44057,39968,56134
18127,IN,9636,9358,7047,9589,5928,4046,6224,9393,6744.026504,9298,10213,49330,5238,-5276,-9365,6801,51828,54568,44054,39965,56131
18129,IN,8868,9358,7047,9589,5928,4046,6110,8402,7173.42145,9298,9336,47124,4459,-6055,-10540,6022,50946,51583,41069,36584,53146
18131,IN,7512,9358,7047,9589,5928,4046,5907,9358,6011.529243,9298,9589,45815,4459,-6055,-10540,6022,49387,50274,39760,35275,51837
18133,IN,7512,9358,7047,9589,5928,4046,5907,10687,5784.202507,9298,9574,46901,4978,-5536,-9757,6541,49387,51879,41365,37144,53442
18135,IN,7512,9358,7047,9589,5928,4046,5907,9358,5405.324613,9298,9589,45208,4459,-6055,-10540,6022,49387,49667,39153,34668,51230
18137,IN,7560,9358,7047,9589,5928,4046,5915,9358,7097.645871,9298,9589,46949,4459,-6055,-10540,6022,49443,51408,40894,36409,52971
18139,IN,7512,9358,7047,9589,5928,4046,5907,9358,6264.114505,9298,9589,46067,4459,-6055,-10540,6022,49387,50526,40012,35527,52089
18141,IN,8568,9358,7047,9589,5928,4046,6065,10165,6390.407136,9298,9225,47693,4978,-5536,-9757,6541,50601,52671,42157,37936,54234
18143,IN,7752,9358,7047,9589,5928,4046,5943,8631,6718.767977,9298,9413,45859,4459,-6055,-10540,6022,49663,50318,39804,35319,51881
18145,IN,9324,9358,7047,9589,5928,4046,6178,9355,5910.495138,9298,9574,47508,4978,-5536,-9757,6541,51470,52486,41972,37751,54049
18147,IN,7512,9358,7047,9589,5928,4046,5907,9358,6971.35324,9298,9589,46774,4459,-6055,-10540,6022,49387,51233,40719,36234,52796
18149,IN,7644,9358,7047,9589,5928,4046,5927,9358,7097.645871,9298,9589,47033,4459,-6055,-10540,6022,49539,51492,40978,36493,53055
18151,IN,8112,9358,7047,9589,5928,4046,5997,10449,5961.012191,9298,9343,47208,4978,-5536,-9757,6541,50077,52186,41672,37451,53749
18153,IN,7512,9358,7047,9589,5928,4046,5907,9778,6996.611766,9298,9111,46741,4459,-6055,-10540,6022,49387,51200,40686,36201,52763
18155,IN,7512,9358,7047,9589,5928,4046,5907,9358,6466.182715,9298,9589,46269,4459,-6055,-10540,6022,49387,50728,40214,35729,52291
18157,IN,9360,9358,7047,9589,5928,4046,6183,8749,6541.958294,9298,9224,47219,4719,-5795,-10148,6282,51511,51938,41424,37071,53501
18159,IN,7956,9358,7047,9589,5928,4046,5974,9358,6920.836187,9298,9589,47168,4719,-5795,-10148,6282,49898,51887,41373,37020,53450
18161,IN,7512,9358,7047,9589,5928,4046,5907,11028,6693.509451,9298,9611,48189,4978,-5536,-9757,6541,49387,53167,42653,38432,54730
18163,IN,8868,9358,7047,9589,5928,4046,6110,9850,6541.958294,9298,9313,47917,4978,-5536,-9757,6541,50946,52895,42381,38160,54458
18165,IN,8760,9358,7047,9589,5928,4046,6094,10491,6112.563348,9298,9112,47819,4978,-5536,-9757,6541,50822,52797,42283,38062,54360
18167,IN,8760,9358,7047,9589,5928,4046,6094,11077,6289.373032,9298,9061,48531,5238,-5276,-9365,6801,50822,53769,43255,39166,55332
18169,IN,7512,9358,7047,9589,5928,4046,5907,8492,6567.21682,9298,9104,45019,4200,-6314,-10931,5763,49387,49219,38705,34088,50782
18171,IN,7512,9358,7047,9589,5928,4046,5907,9358,6466.182715,9298,9589,46269,4459,-6055,-10540,6022,49387,50728,40214,35729,52291
18173,IN,8868,9358,7047,9589,5928,4046,6110,10600,7249.197028,9298,9336,49397,5238,-5276,-9365,6801,50946,54635,44121,40032,56198
18175,IN,7512,9358,7047,9589,5928,4046,5907,9804,7476.523764,9298,9420,47556,4719,-5795,-10148,6282,49387,52275,41761,37408,53838
18177,IN,7656,9358,7047,9589,5928,4046,5929,8460,6062.046295,9298,8453,43976,3826,-6688,-11323,5389,49553,47802,37288,32653,49365
18179,IN,7968,9358,7047,9589,5928,4046,5975,9055,6466.182715,9298,9450,46284,4459,-6055,-10540,6022,49911,50743,40229,35744,52306
18181,IN,7512,9358,7047,9589,5928,4046,5907,9358,6491.441241,9298,9589,46294,4459,-6055,-10540,6022,49387,50753,40239,35754,52316
18183,IN,7968,9358,7047,9589,5928,4046,5975,8113,5809.461033,9298,9454,44688,4200,-6314,-10931,5763,49911,48888,38374,33757,50451
19001,IA,7428,8693,7047,9589,5669,4046,7568,8693,6845.060609,8926,9589,45527,1528,-5101,-9718,6976,50040,47055,40426,35809,52503
19003,IA,7488,8693,7047,9589,5669,4046,7579,8693,6440.924189,8926,9589,45183,1528,-5101,-9718,6976,50111,46711,40082,35465,52159
19005,IA,6948,8693,7047,9589,5669,4046,7478,8693,6339.890084,8926,9589,44542,1528,-5101,-9718,6976,49470,46070,39441,34824,51518
19007,IA,6948,8693,7047,9589,5669,4046,7478,8693,5834.719559,8926,9589,44037,1528,-5101,-9718,6976,49470,45565,38936,34319,51013
19009,IA,6948,8693,7047,9589,5669,4046,7478,8693,6642.992399,8926,9589,44845,1528,-5101,-9718,6976,49470,46373,39744,35127,51821
19011,IA,6948,8693,7047,9589,5669,4046,7478,9347,6668.250925,8926,9667,45602,1528,-5101,-9718,6976,49470,47130,40501,35884,52578
19013,IA,8640,8693,7047,9589,5669,4046,7795,8820,6491.441241,8926,9401,46324,1822,-4807,-9292,7270,51479,48146,41517,37032,53594
19015,IA,7536,8693,7047,9589,5669,4046,7588,8482,6567.21682,8926,9457,45015,1528,-5101,-9718,6976,50168,46543,39914,35297,51991
19017,IA,7800,8693,7047,9589,5669,4046,7638,11093,6794.543556,8926,9409,48069,2411,-4218,-8439,7859,50482,50480,43851,39630,55928
19019,IA,6948,8693,7047,9589,5669,4046,7478,8693,6794.543556,8926,9589,44997,1528,-5101,-9718,6976,49470,46525,39896,35279,51973
19021,IA,7320,8693,7047,9589,5669,4046,7548,8802,6440.924189,8926,9494,45029,1528,-5101,-9718,6976,49912,46557,39928,35311,52005
19023,IA,6948,8693,7047,9589,5669,4046,7478,8693,6516.699768,8926,9589,44719,1528,-5101,-9718,6976,49470,46247,39618,35001,51695
19025,IA,6948,8693,7047,9589,5669,4046,7478,8693,6339.890084,8926,9589,44542,1528,-5101,-9718,6976,49470,46070,39441,34824,51518
19027,IA,6948,8693,7047,9589,5669,4046,7478,8693,6870.319135,8926,9589,45072,1528,-5101,-9718,6976,49470,46600,39971,35354,52048
19029,IA,6948,8693,7047,9589,5669,4046,7478,8693,6390.407136,8926,9589,44592,1528,-5101,-9718,6976,49470,46120,39491,34874,51568
19031,IA,7620,8693,7047,9589,5669,4046,7604,8693,6693.509451,8926,9589,45568,1528,-5101,-9718,6976,50268,47096,40467,35850,52544
19033,IA,7992,8693,7047,9589,5669,4046,7674,9521,6491.441241,8926,9055,46032,1822,-4807,-9292,7270,50710,47854,41225,36740,53302
19035,IA,6948,8693,7047,9589,5669,4046,7478,8693,6592.475346,8926,9589,44794,1528,-5101,-9718,6976,49470,46322,39693,35076,51770
19037,IA,6948,8693,7047,9589,5669,4046,7478,8693,6567.21682,8926,9589,44769,1528,-5101,-9718,6976,49470,46297,39668,35051,51745
19039,IA,7692,8693,7047,9589,5669,4046,7617,8693,6744.026504,8926,9589,45690,1528,-5101,-9718,6976,50353,47218,40589,35972,52666
19041,IA,6948,8693,7047,9589,5669,4046,7478,8983,6693.509451,8926,9273,44869,1528,-5101,-9718,6976,49470,46397,39768,35151,51845
19043,IA,6948,8693,7047,9589,5669,4046,7478,8693,6516.699768,8926,9589,44719,1528,-5101,-9718,6976,49470,46247,39618,35001,51695
19045,IA,7488,8693,7047,9589,5669,4046,7579,8390,6238.855979,8926,9343,44432,1528,-5101,-9718,6976,50111,45960,39331,34714,51408
19047,IA,6948,8693,7047,9589,5669,4046,7478,8693,6541.958294,8926,9589,44744,1528,-5101,-9718,6976,49470,46272,39643,35026,51720
19049,IA,9396,8693,7047,9589,5669,4046,7936,8065,6996.611766,8926,10160,47590,2117,-4512,-8865,7565,52376,49707,43078,38725,55155
19051,IA,7464,8693,7047,9589,5669,4046,7575,8513,6036.787769,8926,9119,44105,1528,-5101,-9718,6976,50083,45633,39004,34387,51081
19053,IA,6948,8693,7047,9589,5669,4046,7478,8693,6264.114505,8926,9589,44466,1528,-5101,-9718,6976,49470,45994,39365,34748,51442
19055,IA,6948,8693,7047,9589,5669,4046,7478,8693,6592.475346,8926,9589,44794,1528,-5101,-9718,6976,49470,46322,39693,35076,51770
19057,IA,8184,8693,7047,9589,5669,4046,7710,7995,6314.631558,8926,8970,44436,1528,-5101,-9718,6976,50938,45964,39335,34718,51412
19059,IA,7224,8693,7047,9589,5669,4046,7530,9019,6718.767977,8926,9187,45121,1528,-5101,-9718,6976,49798,46649,40020,35403,52097
19061,IA,8700,8693,7047,9589,5669,4046,7806,8236,6794.543556,8926,9545,46249,1822,-4807,-9292,7270,51550,48071,41442,36957,53519
19063,IA,7404,8693,7047,9589,5669,4046,7564,8693,7021.870292,8926,9589,45680,1528,-5101,-9718,6976,50012,47208,40579,35962,52656
19065,IA,6948,8693,7047,9589,5669,4046,7478,8693,6642.992399,8926,9589,44845,1528,-5101,-9718,6976,49470,46373,39744,35127,51821
19067,IA,6948,8693,7047,9589,5669,4046,7478,8693,6541.958294,8926,9589,44744,1528,-5101,-9718,6976,49470,46272,39643,35026,51720
19069,IA,6948,8693,7047,9589,5669,4046,7478,8693,6516.699768,8926,9589,44719,1528,-5101,-9718,6976,49470,46247,39618,35001,51695
19071,IA,6948,8693,7047,9589,5669,4046,7478,8693,6668.250925,8926,9589,44870,1528,-5101,-9718,6976,49470,46398,39769,35152,51846
19073,IA,7080,8693,7047,9589,5669,4046,7503,8693,6718.767977,8926,9589,45053,1528,-5101,-9718,6976,49627,46581,39952,35335,52029
19075,IA,8640,8693,7047,9589,5669,4046,7795,8664,6440.924189,8926,9417,46134,1822,-4807,-9292,7270,51479,47956,41327,36842,53404
19077,IA,9396,8693,7047,9589,5669,4046,7936,8457,6744.026504,8926,10137,47707,2411,-4218,-8439,7859,52376,50118,43489,39268,55566
19079,IA,7824,8693,7047,9589,5669,4046,7642,8693,6541.958294,8926,9589,45620,1822,-4807,-9292,7270,50510,47442,40813,36328,52890
19081,IA,6948,8693,7047,9589,5669,4046,7478,8693,6567.21682,8926,9589,44769,1528,-5101,-9718,6976,49470,46297,39668,35051,51745
19083,IA,6948,8693,7047,9589,5669,4046,7478,8693,6516.699768,8926,9589,44719,1528,-5101,-9718,6976,49470,46247,39618,35001,51695
19085,IA,9480,8693,7047,9589,5669,4046,7952,8623,6794.543556,8926,9809,47678,2117,-4512,-8865,7565,52476,49795,43166,38813,55243
19087,IA,7176,8693,7047,9589,5669,4046,7521,8693,5708.426928,8926,9589,44138,1528,-5101,-9718,6976,49741,45666,39037,34420,51114
19089,IA,6948,8693,7047,9589,5669,4046,7478,8693,6440.924189,8926,9589,44643,1528,-5101,-9718,6976,49470,46171,39542,34925,51619
19091,IA,6948,8693,7047,9589,5669,4046,7478,8693,6339.890084,8926,9589,44542,1528,-5101,-9718,6976,49470,46070,39441,34824,51518
19093,IA,6948,8693,7047,9589,5669,4046,7478,8693,6617.733873,8926,9589,44820,1528,-5101,-9718,6976,49470,46348,39719,35102,51796
19095,IA,6948,8693,7047,9589,5669,4046,7478,8693,6870.319135,8926,9589,45072,1528,-5101,-9718,6976,49470,46600,39971,35354,52048
19097,IA,6948,8693,7047,9589,5669,4046,7478,8693,6617.733873,8926,9589,44820,1528,-5101,-9718,6976,49470,46348,39719,35102,51796
19099,IA,7860,8693,7047,9589,5669,4046,7649,8410,6946.094714,8926,9228,45416,1528,-5101,-9718,6976,50553,46944,40315,35698,52392
19101,IA,7668,8693,7047,9589,5669,4046,7613,9342,6062.046295,8926,9007,45051,1822,-4807,-9292,7270,50325,46873,40244,35759,52321
19103,IA,10212,8693,7047,9589,5669,4046,8089,9703,7097.645871,8926,9602,49587,2706,-3923,-8012,8154,53345,52293,45664,41575,57741
19105,IA,6948,8693,7047,9589,5669,4046,7478,8660,6769.28503,8926,9670,45019,1528,-5101,-9718,6976,49470,46547,39918,35301,51995
19107,IA,6948,8693,7047,9589,5669,4046,7478,8693,6744.026504,8926,9589,44946,1528,-5101,-9718,6976,49470,46474,39845,35228,51922
19109,IA,6948,8693,7047,9589,5669,4046,7478,8693,6920.836187,8926,9589,45123,1528,-5101,-9718,6976,49470,46651,40022,35405,52099
19111,IA,7068,8693,7047,9589,5669,4046,7501,9788,5632.65135,8926,9062,44522,1528,-5101,-9718,6976,49613,46050,39421,34804,51498
19113,IA,7860,8693,7047,9589,5669,4046,7649,7828,6769.28503,8926,9670,45100,1528,-5101,-9718,6976,50553,46628,39999,35382,52076
19115,IA,7416,8693,7047,9589,5669,4046,7566,8693,6693.509451,8926,9589,45364,1528,-5101,-9718,6976,50026,46892,40263,35646,52340
19117,IA,6948,8693,7047,9589,5669,4046,7478,8693,6314.631558,8926,9589,44517,1528,-5101,-9718,6976,49470,46045,39416,34799,51493
19119,IA,6948,8693,7047,9589,5669,4046,7478,8693,6769.28503,8926,9589,44971,1528,-5101,-9718,6976,49470,46499,39870,35253,51947
19121,IA,9396,8693,7047,9589,5669,4046,7936,9001,6744.026504,8926,10144,48258,2411,-4218,-8439,7859,52376,50669,44040,39819,56117
19123,IA,7020,8693,7047,9589,5669,4046,7492,8340,6617.733873,8926,9294,44243,1119,-5510,-10145,6567,49556,45362,38733,34098,50810
19125,IA,8412,8693,7047,9589,5669,4046,7752,8693,6845.060609,8926,9589,46511,1822,-4807,-9292,7270,51208,48333,41704,37219,53781
19127,IA,7500,8693,7047,9589,5669,4046,7581,8690,6112.563348,8926,9549,44824,1528,-5101,-9718,6976,50125,46352,39723,35106,51800
19129,IA,9480,8693,7047,9589,5669,4046,7952,9936,6794.543556,8926,9809,48992,2706,-3923,-8012,8154,52476,51698,45069,40980,57146
19131,IA,6948,8693,7047,9589,5669,4046,7478,8693,6516.699768,8926,9589,44719,1528,-5101,-9718,6976,49470,46247,39618,35001,51695
19133,IA,6948,8693,7047,9589,5669,4046,7478,8693,6617.733873,8926,9589,44820,1528,-5101,-9718,6976,49470,46348,39719,35102,51796
19135,IA,7104,8693,7047,9589,5669,4046,7507,8693,6137.821874,8926,9589,44496,1528,-5101,-9718,6976,49655,46024,39395,34778,51472
19137,IA,6948,8693,7047,9589,5669,4046,7478,8693,6415.665663,8926,9589,44618,1528,-5101,-9718,6976,49470,46146,39517,34900,51594
19139,IA,8556,8693,7047,9589,5669,4046,7779,8531,6112.563348,8926,9618,45789,1822,-4807,-9292,7270,51379,47611,40982,36497,53059
19141,IA,6948,8693,7047,9589,5669,4046,7478,8693,6592.475346,8926,9589,44794,1528,-5101,-9718,6976,49470,46322,39693,35076,51770
19143,IA,7368,8693,7047,9589,5669,4046,7557,8693,6642.992399,8926,9589,45265,1528,-5101,-9718,6976,49969,46793,40164,35547,52241
19145,IA,6948,8693,7047,9589,5669,4046,7478,8693,6668.250925,8926,9589,44870,1528,-5101,-9718,6976,49470,46398,39769,35152,51846
19147,IA,6948,8693,7047,9589,5669,4046,7478,8693,6819.802082,8926,9589,45022,1528,-5101,-9718,6976,49470,46550,39921,35304,51998
19149,IA,7500,8693,7047,9589,5669,4046,7581,8291,6592.475346,8926,9637,44992,1528,-5101,-9718,6976,50125,46520,39891,35274,51968
19151,IA,6948,8693,7047,9589,5669,4046,7478,8693,6390.407136,8926,9589,44592,1528,-5101,-9718,6976,49470,46120,39491,34874,51568
19153,IA,9396,8693,7047,9589,5669,4046,7936,8111,6693.509451,8926,10183,47356,2117,-4512,-8865,7565,52376,49473,42844,38491,54921
19155,IA,9480,8693,7047,9589,5669,4046,7952,8486,6365.14861,8926,9820,47124,2117,-4512,-8865,7565,52476,49241,42612,38259,54689
19157,IA,7740,8693,7047,9589,5669,4046,7626,8693,6365.14861,8926,9589,45359,1822,-4807,-9292,7270,50410,47181,40552,36067,52629
19159,IA,6948,8693,7047,9589,5669,4046,7478,8693,6264.114505,8926,9589,44466,1528,-5101,-9718,6976,49470,45994,39365,34748,51442
19161,IA,6948,8693,7047,9589,5669,4046,7478,8693,6541.958294,8926,9589,44744,1528,-5101,-9718,6976,49470,46272,39643,35026,51720
19163,IA,8196,8693,7047,9589,5669,4046,7712,10031,6744.026504,8926,9369,47312,2117,-4512,-8865,7565,50952,49429,42800,38447,54877
19165,IA,6948,8693,7047,9589,5669,4046,7478,8693,6440.924189,8926,9589,44643,1528,-5101,-9718,6976,49470,46171,39542,34925,51619
19167,IA,6948,8693,7047,9589,5669,4046,7478,8693,6415.665663,8926,9589,44618,1528,-5101,-9718,6976,49470,46146,39517,34900,51594
19169,IA,8604,8693,7047,9589,5669,4046,7788,8099,6819.802082,8926,9488,45983,1822,-4807,-9292,7270,51436,47805,41176,36691,53253
19171,IA,7152,8693,7047,9589,5669,4046,7516,8693,6466.182715,8926,9589,44872,1528,-5101,-9718,6976,49712,46400,39771,35154,51848
19173,IA,6948,8693,7047,9589,5669,4046,7478,8693,6491.441241,8926,9589,44693,1528,-5101,-9718,6976,49470,46221,39592,34975,51669
19175,IA,6948,8693,7047,9589,5669,4046,7478,8693,6390.407136,8926,9589,44592,1528,-5101,-9718,6976,49470,46120,39491,34874,51568
19177,IA,6948,8693,7047,9589,5669,4046,7478,8693,5910.495138,8926,9589,44112,1528,-5101,-9718,6976,49470,45640,39011,34394,51088
19179,IA,7800,8693,7047,9589,5669,4046,7638,8149,5961.012191,8926,9056,43938,1528,-5101,-9718,6976,50482,45466,38837,34220,50914
19181,IA,9396,8693,7047,9589,5669,4046,7936,9842,6895.577661,8926,10147,49252,2706,-3923,-8012,8154,52376,51958,45329,41240,57406
19183,IA,7740,8693,7047,9589,5669,4046,7626,7764,6516.699768,8926,9604,44597,1528,-5101,-9718,6976,50410,46125,39496,34879,51573
19185,IA,6948,8693,7047,9589,5669,4046,7478,8693,5834.719559,8926,9589,44037,1528,-5101,-9718,6976,49470,45565,38936,34319,51013
19187,IA,6948,8693,7047,9589,5669,4046,7478,8904,6112.563348,8926,8879,43816,1119,-5510,-10145,6567,49470,44935,38306,33671,50383
19189,IA,6948,8693,7047,9589,5669,4046,7478,8693,6718.767977,8926,9589,44921,1528,-5101,-9718,6976,49470,46449,39820,35203,51897
19191,IA,6948,8693,7047,9589,5669,4046,7478,8693,6996.611766,8926,9589,45199,1528,-5101,-9718,6976,49470,46727,40098,35481,52175
19193,IA,8352,8693,7047,9589,5669,4046,7741,8449,6693.509451,8926,9649,46116,1822,-4807,-9292,7270,51137,47938,41309,36824,53386
19195,IA,6948,8693,7047,9589,5669,4046,7478,12155,6516.699768,8926,9120,47711,2411,-4218,-8439,7859,49470,50122,43493,39272,55570
19197,IA,6948,8693,7047,9589,5669,4046,7478,8693,6415.665663,8926,9589,44618,1528,-5101,-9718,6976,49470,46146,39517,34900,51594
20001,KS,7464,7364,7047,9589,5789,4046,6506,7364,7173.42145,7150,9589,42786,3122,-7234,-11752,4843,47805,45908,35552,31034,47629
20003,KS,7464,7364,7047,9589,5789,4046,6506,7364,7451.265238,7150,9589,43064,3122,-7234,-11752,4843,47805,46186,35830,31312,47907
20005,KS,7464,7364,7047,9589,5789,4046,6506,6793,7148.162923,7150,9182,41783,2729,-7627,-12088,4450,47805,44512,34156,29695,46233
20007,KS,7464,7364,7047,9589,5789,4046,6506,7364,7451.265238,7150,9589,43064,3122,-7234,-11752,4843,47805,46186,35830,31312,47907
20009,KS,7464,7364,7047,9589,5789,4046,6506,6322,7021.870292,7150,9247,41251,2729,-7627,-12088,4450,47805,43980,33624,29163,45701
20011,KS,7596,7364,7047,9589,5789,4046,6528,7364,6769.28503,7150,9589,42514,3122,-7234,-11752,4843,47959,45636,35280,30762,47357
20013,KS,7464,7364,7047,9589,5789,4046,6506,7364,6592.475346,7150,9589,42205,3122,-7234,-11752,4843,47805,45327,34971,30453,47048
20015,KS,8880,7364,7047,9589,5789,4046,6737,7567,7527.040817,7150,9548,44717,3957,-6399,-11034,5678,49452,48674,38318,33683,50395
20017,KS,7464,7364,7047,9589,5789,4046,6506,7364,6845.060609,7150,9589,42458,3122,-7234,-11752,4843,47805,45580,35224,30706,47301
20019,KS,7464,7364,7047,9589,5789,4046,6506,7364,7072.387345,7150,9589,42685,3122,-7234,-11752,4843,47805,45807,35451,30933,47528
20021,KS,7464,7364,7047,9589,5789,4046,6506,7364,7350.231133,7150,9589,42963,3122,-7234,-11752,4843,47805,46085,35729,31211,47806
20023,KS,7464,7364,7047,9589,5789,4046,6506,7364,7602.816396,7150,9589,43216,3122,-7234,-11752,4843,47805,46338,35982,31464,48059
20025,KS,7464,7364,7047,9589,5789,4046,6506,7364,6895.577661,7150,9589,42509,3122,-7234,-11752,4843,47805,45631,35275,30757,47352
20027,KS,8628,7364,7047,9589,5789,4046,6696,7364,6895.577661,7150,9589,43673,3516,-6840,-11417,5237,49159,47189,36833,32256,48910
20029,KS,7464,7364,7047,9589,5789,4046,6506,7364,7047.128818,7150,9589,42660,3122,-7234,-11752,4843,47805,45782,35426,30908,47503
20031,KS,7464,7364,7047,9589,5789,4046,6506,7364,6592.475346,7150,9589,42205,3122,-7234,-11752,4843,47805,45327,34971,30453,47048
20033,KS,7464,7364,7047,9589,5789,4046,6506,7364,7400.748186,7150,9589,43014,3122,-7234,-11752,4843,47805,46136,35780,31262,47857
20035,KS,7680,7364,7047,9589,5789,4046,6542,6662,7072.387345,7150,9085,41696,2729,-7627,-12088,4450,48057,44425,34069,29608,46146
20037,KS,8028,7364,7047,9589,5789,4046,6598,6665,6264.114505,7150,8692,40845,2729,-7627,-12088,4450,48461,43574,33218,28757,45295
20039,KS,7464,7364,7047,9589,5789,4046,6506,7364,7324.972607,7150,9589,42938,3122,-7234,-11752,4843,47805,46060,35704,31186,47781
20041,KS,7464,7364,7047,9589,5789,4046,6506,7364,7047.128818,7150,9589,42660,3122,-7234,-11752,4843,47805,45782,35426,30908,47503
20043,KS,8940,7364,7047,9589,5789,4046,6747,6920,6642.992399,7150,9369,43068,3516,-6840,-11417,5237,49522,46584,36228,31651,48305
20045,KS,9348,7364,7047,9589,5789,4046,6814,8867,7779.626079,7150,9504,46695,4339,-6017,-10634,6060,49997,51034,40678,36061,52755
20047,KS,7464,7364,7047,9589,5789,4046,6506,7364,7021.870292,7150,9589,42635,3122,-7234,-11752,4843,47805,45757,35401,30883,47478
20049,KS,7464,7364,7047,9589,5789,4046,6506,7364,7375.489659,7150,9589,42988,3122,-7234,-11752,4843,47805,46110,35754,31236,47831
20051,KS,7536,7364,7047,9589,5789,4046,6518,7521,7350.231133,7150,9372,42975,3122,-7234,-11752,4843,47889,46097,35741,31223,47818
20053,KS,7464,7364,7047,9589,5789,4046,6506,7364,6642.992399,7150,9589,42256,3122,-7234,-11752,4843,47805,45378,35022,30504,47099
20055,KS,7908,7364,7047,9589,5789,4046,6579,7596,6592.475346,7150,10018,43310,3516,-6840,-11417,5237,48322,46826,36470,31893,48547
20057,KS,7860,7364,7047,9589,5789,4046,6571,7352,6996.611766,7150,10162,43566,3516,-6840,-11417,5237,48266,47082,36726,32149,48803
20059,KS,9408,7364,7047,9589,5789,4046,6824,7446,7223.938502,7150,9490,44765,3957,-6399,-11034,5678,50067,48722,38366,33731,50443
20061,KS,9432,7364,7047,9589,5789,4046,6827,8715,6920.836187,7150,9741,46006,4611,-5745,-10230,6332,50094,50617,40261,35776,52338
20063,KS,7464,7364,7047,9589,5789,4046,6506,7364,7451.265238,7150,9589,43064,3122,-7234,-11752,4843,47805,46186,35830,31312,47907
20065,KS,7464,7364,7047,9589,5789,4046,6506,7364,7350.231133,7150,9589,42963,3122,-7234,-11752,4843,47805,46085,35729,31211,47806
20067,KS,7464,7364,7047,9589,5789,4046,6506,7364,6668.250925,7150,9589,42281,3122,-7234,-11752,4843,47805,45403,35047,30529,47124
20069,KS,7464,7364,7047,9589,5789,4046,6506,7364,6718.767977,7150,9589,42332,3122,-7234,-11752,4843,47805,45454,35098,30580,47175
20071,KS,7464,7364,7047,9589,5789,4046,6506,7364,7476.523764,7150,9589,43090,3122,-7234,-11752,4843,47805,46212,35856,31338,47933
20073,KS,7464,7364,7047,9589,5789,4046,6506,7364,6920.836187,7150,9589,42534,3122,-7234,-11752,4843,47805,45656,35300,30782,47377
20075,KS,8148,7364,7047,9589,5789,4046,6618,7364,6744.026504,7150,9589,43041,3516,-6840,-11417,5237,48601,46557,36201,31624,48278
20077,KS,7464,7364,7047,9589,5789,4046,6506,7364,6946.094714,7150,9589,42559,3122,-7234,-11752,4843,47805,45681,35325,30807,47402
20079,KS,8880,7364,7047,9589,5789,4046,6737,6972,7324.972607,7150,9544,43917,3516,-6840,-11417,5237,49452,47433,37077,32500,49154
20081,KS,7836,7364,7047,9589,5789,4046,6567,7364,6693.509451,7150,9589,42679,3516,-6840,-11417,5237,48238,46195,35839,31262,47916
20083,KS,7464,7364,7047,9589,5789,4046,6506,7364,6718.767977,7150,9589,42332,3122,-7234,-11752,4843,47805,45454,35098,30580,47175
20085,KS,8556,7364,7047,9589,5789,4046,6685,7120,6996.611766,7150,9381,43249,3516,-6840,-11417,5237,49076,46765,36409,31832,48486
20087,KS,8556,7364,7047,9589,5789,4046,6685,7478,7249.197028,7150,9383,43863,3516,-6840,-11417,5237,49076,47379,37023,32446,49100
20089,KS,7464,7364,7047,9589,5789,4046,6506,7364,6996.611766,7150,9589,42610,3122,-7234,-11752,4843,47805,45732,35376,30858,47453
20091,KS,10224,7364,7047,9589,5789,4046,6957,9457,7350.231133,7150,9684,47911,4884,-5472,-9825,6605,51016,52795,42439,38086,54516
20093,KS,7464,7364,7047,9589,5789,4046,6506,7173,6541.958294,7150,9966,42341,3122,-7234,-11752,4843,47805,45463,35107,30589,47184
20095,KS,7464,7364,7047,9589,5789,4046,6506,6773,6946.094714,7150,9549,41928,3122,-7234,-11752,4843,47805,45050,34694,30176,46771
20097,KS,7464,7364,7047,9589,5789,4046,6506,7364,7021.870292,7150,9589,42635,3122,-7234,-11752,4843,47805,45757,35401,30883,47478
20099,KS,7464,7364,7047,9589,5789,4046,6506,6271,7375.489659,7150,9036,41343,2729,-7627,-12088,4450,47805,44072,33716,29255,45793
20101,KS,8052,7364,7047,9589,5789,4046,6602,7364,6592.475346,7150,9589,42793,3516,-6840,-11417,5237,48489,46309,35953,31376,48030
20103,KS,10224,7364,7047,9589,5789,4046,6957,8302,6870.319135,7150,9687,46280,4611,-5745,-10230,6332,51016,50891,40535,36050,52612
20105,KS,7464,7364,7047,9589,5789,4046,6506,7364,6491.441241,7150,9589,42104,3122,-7234,-11752,4843,47805,45226,34870,30352,46947
20107,KS,10224,7364,7047,9589,5789,4046,6957,7178,7072.387345,7150,9678,45348,4339,-6017,-10634,6060,51016,49687,39331,34714,51408
20109,KS,7464,7364,7047,9589,5789,4046,6506,7364,7299.714081,7150,9589,42913,3122,-7234,-11752,4843,47805,46035,35679,31161,47756
20111,KS,7596,7364,7047,9589,5789,4046,6528,7090,6264.114505,7150,8892,41038,2729,-7627,-12088,4450,47959,43767,33411,28950,45488
20113,KS,7896,7364,7047,9589,5789,4046,6577,7027,7426.006712,7150,9590,43135,3122,-7234,-11752,4843,48308,46257,35901,31383,47978
20115,KS,7464,7364,7047,9589,5789,4046,6506,7364,6920.836187,7150,9589,42534,3122,-7234,-11752,4843,47805,45656,35300,30782,47377
20117,KS,7464,7364,7047,9589,5789,4046,6506,7364,7223.938502,7150,9589,42837,3122,-7234,-11752,4843,47805,45959,35603,31085,47680
20119,KS,7464,7364,7047,9589,5789,4046,6506,7364,6769.28503,7150,9589,42382,3122,-7234,-11752,4843,47805,45504,35148,30630,47225
20121,KS,10224,7364,7047,9589,5789,4046,6957,8197,7830.143132,7150,9682,47128,4611,-5745,-10230,6332,51016,51739,41383,36898,53460
20123,KS,7464,7364,7047,9589,5789,4046,6506,7364,6971.35324,7150,9589,42584,3122,-7234,-11752,4843,47805,45706,35350,30832,47427
20125,KS,7464,7364,7047,9589,5789,4046,6506,6445,7375.489659,7150,8672,41153,2335,-8021,-12423,4056,47805,43488,33132,28730,45209
20127,KS,7464,7364,7047,9589,5789,4046,6506,7364,6946.094714,7150,9589,42559,3122,-7234,-11752,4843,47805,45681,35325,30807,47402
20129,KS,7464,7364,7047,9589,5789,4046,6506,7364,6996.611766,7150,9589,42610,3122,-7234,-11752,4843,47805,45732,35376,30858,47453
20131,KS,7464,7364,7047,9589,5789,4046,6506,7364,6617.733873,7150,9589,42231,3122,-7234,-11752,4843,47805,45353,34997,30479,47074
20133,KS,7464,7364,7047,9589,5789,4046,6506,7364,6870.319135,7150,9589,42483,3122,-7234,-11752,4843,47805,45605,35249,30731,47326
20135,KS,7464,7364,7047,9589,5789,4046,6506,7364,6845.060609,7150,9589,42458,3122,-7234,-11752,4843,47805,45580,35224,30706,47301
20137,KS,7464,7364,7047,9589,5789,4046,6506,7364,7299.714081,7150,9589,42913,3122,-7234,-11752,4843,47805,46035,35679,31161,47756
20139,KS,8556,7364,7047,9589,5789,4046,6685,7082,6971.35324,7150,9376,43181,3516,-6840,-11417,5237,49076,46697,36341,31764,48418
20141,KS,7464,7364,7047,9589,5789,4046,6506,7364,7350.231133,7150,9589,42963,3122,-7234,-11752,4843,47805,46085,35729,31211,47806
20143,KS,7464,7364,7047,9589,5789,4046,6506,6790,6541.958294,7150,9472,41465,2729,-7627,-12088,4450,47805,44194,33838,29377,45915
20145,KS,7740,7364,7047,9589,5789,4046,6551,7364,7173.42145,7150,9589,43062,3122,-7234,-11752,4843,48126,46184,35828,31310,47905
20147,KS,7464,7364,7047,9589,5789,4046,6506,7364,7451.265238,7150,9589,43064,3122,-7234,-11752,4843,47805,46186,35830,31312,47907
20149,KS,9432,7364,7047,9589,5789,4046,6827,7361,6238.855979,7150,9489,43717,3957,-6399,-11034,5678,50094,47674,37318,32683,49395
20151,KS,7752,7364,7047,9589,5789,4046,6553,7364,6718.767977,7150,9589,42620,3122,-7234,-11752,4843,48140,45742,35386,30868,47463
20153,KS,7464,7364,7047,9589,5789,4046,6506,7364,7324.972607,7150,9589,42938,3122,-7234,-11752,4843,47805,46060,35704,31186,47781
20155,KS,8016,7364,7047,9589,5789,4046,6596,6803,6567.21682,7150,9072,41655,3122,-7234,-11752,4843,48447,44777,34421,29903,46498
20157,KS,7464,7364,7047,9589,5789,4046,6506,7364,7122.904397,7150,9589,42736,3122,-7234,-11752,4843,47805,45858,35502,30984,47579
20159,KS,7464,7364,7047,9589,5789,4046,6506,7364,6744.026504,7150,9589,42357,3122,-7234,-11752,4843,47805,45479,35123,30605,47200
20161,KS,9432,7364,7047,9589,5789,4046,6827,8804,8057.469868,7150,9469,46958,4339,-6017,-10634,6060,50094,51297,40941,36324,53018
20163,KS,7464,7364,7047,9589,5789,4046,6506,7364,7249.197028,7150,9589,42862,3122,-7234,-11752,4843,47805,45984,35628,31110,47705
20165,KS,7464,7364,7047,9589,5789,4046,6506,7364,7122.904397,7150,9589,42736,3122,-7234,-11752,4843,47805,45858,35502,30984,47579
20167,KS,8244,7364,7047,9589,5789,4046,6634,7364,7249.197028,7150,9589,43642,3516,-6840,-11417,5237,48713,47158,36802,32225,48879
20169,KS,8100,7364,7047,9589,5789,4046,6610,7288,6491.441241,7150,9466,42541,3516,-6840,-11417,5237,48545,46057,35701,31124,47778
20171,KS,7464,7364,7047,9589,5789,4046,6506,7364,6668.250925,7150,9589,42281,3122,-7234,-11752,4843,47805,45403,35047,30529,47124
20173,KS,8880,7364,7047,9589,5789,4046,6737,7604,6971.35324,7150,9548,44199,3957,-6399,-11034,5678,49452,48156,37800,33165,49877
20175,KS,8700,7364,7047,9589,5789,4046,6708,7517,7047.128818,7150,10035,44494,3957,-6399,-11034,5678,49243,48451,38095,33460,50172
20177,KS,8556,7364,7047,9589,5789,4046,6685,7542,6769.28503,7150,9335,43398,3516,-6840,-11417,5237,49076,46914,36558,31981,48635
20179,KS,7464,7364,7047,9589,5789,4046,6506,7364,7375.489659,7150,9589,42988,3122,-7234,-11752,4843,47805,46110,35754,31236,47831
20181,KS,7464,7364,7047,9589,5789,4046,6506,7364,7628.074922,7150,9589,43241,3122,-7234,-11752,4843,47805,46363,36007,31489,48084
20183,KS,7464,7364,7047,9589,5789,4046,6506,7364,7173.42145,7150,9589,42786,3122,-7234,-11752,4843,47805,45908,35552,31034,47629
20185,KS,7464,7364,7047,9589,5789,4046,6506,7364,6769.28503,7150,9589,42382,3122,-7234,-11752,4843,47805,45504,35148,30630,47225
20187,KS,7464,7364,7047,9589,5789,4046,6506,7364,6769.28503,7150,9589,42382,3122,-7234,-11752,4843,47805,45504,35148,30630,47225
20189,KS,9552,7364,7047,9589,5789,4046,6847,7364,6996.611766,7150,9589,44698,3957,-6399,-11034,5678,50234,48655,38299,33664,50376
20191,KS,8040,7364,7047,9589,5789,4046,6600,6811,7173.42145,7150,9546,42766,3122,-7234,-11752,4843,48475,45888,35532,31014,47609
20193,KS,7464,7364,7047,9589,5789,4046,6506,7364,7274.455555,7150,9589,42887,3122,-7234,-11752,4843,47805,46009,35653,31135,47730
20195,KS,7848,7364,7047,9589,5789,4046,6569,7364,7375.489659,7150,9589,43372,3516,-6840,-11417,5237,48252,46888,36532,31955,48609
20197,KS,8556,7364,7047,9589,5789,4046,6685,6770,6870.319135,7150,9387,42780,3122,-7234,-11752,4843,49076,45902,35546,31028,47623
20199,KS,7464,7364,7047,9589,5789,4046,6506,7364,7451.265238,7150,9589,43064,3122,-7234,-11752,4843,47805,46186,35830,31312,47907
20201,KS,7464,7364,7047,9589,5789,4046,6506,7364,7653.333448,7150,9589,43266,3122,-7234,-11752,4843,47805,46388,36032,31514,48109
20203,KS,8256,7364,7047,9589,5789,4046,6636,7364,6668.250925,7150,9589,43073,3516,-6840,-11417,5237,48727,46589,36233,31656,48310
20205,KS,7464,7364,7047,9589,5789,4046,6506,7364,7223.938502,7150,9589,42837,3122,-7234,-11752,4843,47805,45959,35603,31085,47680
20207,KS,7464,7364,7047,9589,5789,4046,6506,7364,6516.699768,7150,9589,42130,3122,-7234,-11752,4843,47805,45252,34896,30378,46973
20209,KS,10224,7364,7047,9589,5789,4046,6957,7500,6718.767977,7150,9683,45322,4339,-6017,-10634,6060,51016,49661,39305,34688,51382
21001,KY,6780,16670,6898,9859,5517,4284,5338,16670,6304.738904,7142,9859,51040,8445,-3158,-7115,8919,55346,59485,47882,43925,59959
21003,KY,6780,16670,6898,9859,5517,4284,5338,15856,6823.952696,7142,9435,50321,8445,-3158,-7115,8919,55346,58766,47163,43206,59240
21005,KY,8052,16670,6898,9859,5517,4284,5523,16212,6428.361235,7142,9446,51565,9014,-2589,-6282,9488,56803,60579,48976,45283,61053
21007,KY,6780,16670,6898,9859,5517,4284,5338,15507,6106.943174,7142,9328,49149,8161,-3442,-7531,8635,55346,57310,45707,41618,57784
21009,KY,6780,16670,6898,9859,5517,4284,5338,16018,6502.534634,7142,8891,49617,8445,-3158,-7115,8919,55346,58062,46459,42502,58536
21011,KY,6780,16670,6898,9859,5517,4284,5338,17222,6527.2591,7142,8728,50684,8445,-3158,-7115,8919,55346,59129,47526,43569,59603
21013,KY,6780,16670,6898,9859,5517,4284,5338,16266,6428.361235,7142,8022,48923,8161,-3442,-7531,8635,55346,57084,45481,41392,57558
21015,KY,8820,16670,6898,9859,5517,4284,5635,19189,6675.605898,7142,9879,55989,10152,-1451,-4616,10626,57683,66141,54538,51373,66615
21017,KY,8604,16670,6898,9859,5517,4284,5603,15990,6601.432499,7142,9670,52292,9014,-2589,-6282,9488,57435,61306,49703,46010,61780
21019,KY,7716,16670,6898,9859,5517,4284,5474,15723,6106.943174,7142,9197,50169,8445,-3158,-7115,8919,56418,58614,47011,43054,59088
21021,KY,7680,16670,6898,9859,5517,4284,5469,16012,5884.422977,7142,8670,49673,8445,-3158,-7115,8919,56377,58118,46515,42558,58592
21023,KY,8820,16670,6898,9859,5517,4284,5635,16853,6551.983567,7142,9882,53532,9014,-2589,-6282,9488,57683,62546,50943,47250,63020
21025,KY,6780,16670,6898,9859,5517,4284,5338,16670,6576.708033,7142,9859,51312,8445,-3158,-7115,8919,55346,59757,48154,44197,60231
21027,KY,6780,16670,6898,9859,5517,4284,5338,16670,6749.779297,7142,9859,51485,8445,-3158,-7115,8919,55346,59930,48327,44370,60404
21029,KY,8460,16670,6898,9859,5517,4284,5582,16772,6799.22823,7142,9689,53146,9014,-2589,-6282,9488,57270,62160,50557,46864,62634
21031,KY,6780,16670,6898,9859,5517,4284,5338,16013,6329.46337,7142,9441,49990,8445,-3158,-7115,8919,55346,58435,46832,42875,58909
21033,KY,6780,16670,6898,9859,5517,4284,5338,16670,6403.636769,7142,9859,51139,8445,-3158,-7115,8919,55346,59584,47981,44024,60058
21035,KY,7632,16670,6898,9859,5517,4284,5462,17205,6749.779297,7142,8847,51859,9014,-2589,-6282,9488,56322,60873,49270,45577,61347
21037,KY,8820,16670,6898,9859,5517,4284,5635,18490,7145.370758,7142,9879,55760,9583,-2020,-5449,10057,57683,65343,53740,50311,65817
21039,KY,7284,16670,6898,9859,5517,4284,5411,16670,6181.116572,7142,9859,51420,9014,-2589,-6282,9488,55923,60434,48831,45138,60908
21041,KY,7752,16670,6898,9859,5517,4284,5479,16670,5859.698511,7142,9859,51567,9014,-2589,-6282,9488,56459,60581,48978,45285,61055
21043,KY,6780,16670,6898,9859,5517,4284,5338,16670,7466.788819,7142,9859,52202,8445,-3158,-7115,8919,55346,60647,49044,45087,61121
21045,KY,6780,16670,6898,9859,5517,4284,5338,16670,6057.494241,7142,9859,50792,8445,-3158,-7115,8919,55346,59237,47634,43677,59711
21047,KY,9204,16670,6898,9859,5517,4284,5690,16951,6205.841039,7142,9691,53478,9583,-2020,-5449,10057,58122,63061,51458,48029,63535
21049,KY,8604,16670,6898,9859,5517,4284,5603,17396,6601.432499,7142,9660,53687,9014,-2589,-6282,9488,57435,62701,51098,47405,63175
21051,KY,6780,16670,6898,9859,5517,4284,5338,16670,6576.708033,7142,9859,51312,8445,-3158,-7115,8919,55346,59757,48154,44197,60231
21053,KY,6780,16670,6898,9859,5517,4284,5338,16670,6304.738904,7142,9859,51040,8445,-3158,-7115,8919,55346,59485,47882,43925,59959
21055,KY,6780,16670,6898,9859,5517,4284,5338,16670,6650.881432,7142,9859,51386,8445,-3158,-7115,8919,55346,59831,48228,44271,60305
21057,KY,6780,16670,6898,9859,5517,4284,5338,16670,6428.361235,7142,9859,51163,8445,-3158,-7115,8919,55346,59608,48005,44048,60082
21059,KY,7512,16670,6898,9859,5517,4284,5445,15857,6428.361235,7142,9528,50752,8445,-3158,-7115,8919,56185,59197,47594,43637,59671
21061,KY,7932,16670,6898,9859,5517,4284,5506,16791,6329.46337,7142,9438,51917,9014,-2589,-6282,9488,56666,60931,49328,45635,61405
21063,KY,6780,16670,6898,9859,5517,4284,5338,16670,6502.534634,7142,9859,51238,8445,-3158,-7115,8919,55346,59683,48080,44123,60157
21065,KY,6780,16670,6898,9859,5517,4284,5338,16670,6551.983567,7142,9859,51287,8445,-3158,-7115,8919,55346,59732,48129,44172,60206
21067,KY,8604,16670,6898,9859,5517,4284,5603,18742,6576.708033,7142,9647,54996,9583,-2020,-5449,10057,57435,64579,52976,49547,65053
21069,KY,6780,16670,6898,9859,5517,4284,5338,16670,6428.361235,7142,9859,51163,8445,-3158,-7115,8919,55346,59608,48005,44048,60082
21071,KY,6780,16670,6898,9859,5517,4284,5338,16670,6972.299494,7142,9859,51707,8445,-3158,-7115,8919,55346,60152,48549,44592,60626
21073,KY,7980,16670,6898,9859,5517,4284,5513,17390,6774.503763,7142,9411,52982,9014,-2589,-6282,9488,56721,61996,50393,46700,62470
21075,KY,6780,16670,6898,9859,5517,4284,5338,14889,6230.565505,7142,8766,48092,7876,-3727,-7948,8350,55346,55968,44365,40144,56442
21077,KY,8820,16670,6898,9859,5517,4284,5635,19064,6626.156966,7142,9881,55818,10152,-1451,-4616,10626,57683,65970,54367,51202,66444
21079,KY,6864,16670,6898,9859,5517,4284,5350,16670,6354.187836,7142,9859,51173,8445,-3158,-7115,8919,55442,59618,48015,44058,60092
21081,KY,8232,16670,6898,9859,5517,4284,5549,18380,6378.912303,7142,9881,54298,9583,-2020,-5449,10057,57009,63881,52278,48849,64355
21083,KY,6912,16670,6898,9859,5517,4284,5357,15371,6428.361235,7142,8903,49041,8161,-3442,-7531,8635,55497,57202,45599,41510,57676
21085,KY,6780,16670,6898,9859,5517,4284,5338,16670,6106.943174,7142,9859,50842,8445,-3158,-7115,8919,55346,59287,47684,43727,59761
21087,KY,6780,16670,6898,9859,5517,4284,5338,16670,6280.014438,7142,9859,51015,8445,-3158,-7115,8919,55346,59460,47857,43900,59934
21089,KY,7716,16670,6898,9859,5517,4284,5474,15843,7095.921825,7142,9179,51260,8445,-3158,-7115,8919,56418,59705,48102,44145,60179
21091,KY,7512,16670,6898,9859,5517,4284,5445,16668,6527.2591,7142,9534,51667,9014,-2589,-6282,9488,56185,60681,49078,45385,61155
21093,KY,7020,16670,6898,9859,5517,4284,5373,17421,6156.392106,7142,9694,51717,9014,-2589,-6282,9488,55621,60731,49128,45435,61205
21095,KY,6780,16670,6898,9859,5517,4284,5338,16670,6551.983567,7142,9859,51287,8445,-3158,-7115,8919,55346,59732,48129,44172,60206
21097,KY,7188,16670,6898,9859,5517,4284,5398,16670,6601.432499,7142,9859,51744,9014,-2589,-6282,9488,55814,60758,49155,45462,61232
21099,KY,6780,16670,6898,9859,5517,4284,5338,16670,6181.116572,7142,9859,50916,8445,-3158,-7115,8919,55346,59361,47758,43801,59835
21101,KY,8868,16670,6898,9859,5517,4284,5641,16464,6700.330364,7142,9601,53060,9014,-2589,-6282,9488,57737,62074,50471,46778,62548
21103,KY,8460,16670,6898,9859,5517,4284,5582,16221,6428.361235,7142,9690,52226,9014,-2589,-6282,9488,57270,61240,49637,45944,61714
21105,KY,6780,16670,6898,9859,5517,4284,5338,16670,6576.708033,7142,9859,51312,8445,-3158,-7115,8919,55346,59757,48154,44197,60231
21107,KY,6780,16670,6898,9859,5517,4284,5338,15753,6725.054831,7142,9291,49975,8445,-3158,-7115,8919,55346,58420,46817,42860,58894
21109,KY,7584,16670,6898,9859,5517,4284,5455,16670,6280.014438,7142,9859,51819,9014,-2589,-6282,9488,56267,60833,49230,45537,61307
21111,KY,8460,16670,6898,9859,5517,4284,5582,18181,6650.881432,7142,9659,54377,9583,-2020,-5449,10057,57270,63960,52357,48928,64434
21113,KY,8604,16670,6898,9859,5517,4284,5603,18331,6576.708033,7142,9664,54601,9583,-2020,-5449,10057,57435,64184,52581,49152,64658
21115,KY,6780,16670,6898,9859,5517,4284,5338,16670,6576.708033,7142,9859,51312,8445,-3158,-7115,8919,55346,59757,48154,44197,60231
21117,KY,8820,16670,6898,9859,5517,4284,5635,18147,6576.708033,7142,9880,54850,9583,-2020,-5449,10057,57683,64433,52830,49401,64907
21119,KY,6780,16670,6898,9859,5517,4284,5338,16670,6626.156966,7142,9859,51361,8445,-3158,-7115,8919,55346,59806,48203,44246,60280
21121,KY,6780,16670,6898,9859,5517,4284,5338,17490,6354.187836,7142,8458,50507,8445,-3158,-7115,8919,55346,58952,47349,43392,59426
21123,KY,7020,16670,6898,9859,5517,4284,5373,15754,6205.841039,7142,9707,50113,8445,-3158,-7115,8919,55621,58558,46955,42998,59032
21125,KY,7008,16670,6898,9859,5517,4284,5371,17170,5983.320842,7142,8462,50049,8445,-3158,-7115,8919,55607,58494,46891,42934,58968
21127,KY,6780,16670,6898,9859,5517,4284,5338,16670,6354.187836,7142,9859,51089,8445,-3158,-7115,8919,55346,59534,47931,43974,60008
21129,KY,6780,16670,6898,9859,5517,4284,5338,16670,6205.841039,7142,9859,50941,8445,-3158,-7115,8919,55346,59386,47783,43826,59860
21131,KY,6912,16670,6898,9859,5517,4284,5357,16670,6477.810168,7142,9859,51345,8445,-3158,-7115,8919,55497,59790,48187,44230,60264
21133,KY,6780,16670,6898,9859,5517,4284,5338,16670,6527.2591,7142,9859,51262,8445,-3158,-7115,8919,55346,59707,48104,44147,60181
21135,KY,6780,16670,6898,9859,5517,4284,5338,16670,6255.289971,7142,9859,50990,8445,-3158,-7115,8919,55346,59435,47832,43875,59909
21137,KY,6780,16670,6898,9859,5517,4284,5338,16045,6181.116572,7142,8722,49155,8161,-3442,-7531,8635,55346,57316,45713,41624,57790
21139,KY,6780,16670,6898,9859,5517,4284,5338,15476,6205.841039,7142,9322,49210,8161,-3442,-7531,8635,55346,57371,45768,41679,57845
21141,KY,7332,16670,6898,9859,5517,4284,5418,16670,6230.565505,7142,9859,51518,9014,-2589,-6282,9488,55978,60532,48929,45236,61006
21143,KY,6780,16670,6898,9859,5517,4284,5338,16670,6700.330364,7142,9859,51435,8445,-3158,-7115,8919,55346,59880,48277,44320,60354
21145,KY,7380,16670,6898,9859,5517,4284,5425,16523,6082.218707,7142,9254,50665,8445,-3158,-7115,8919,56033,59110,47507,43550,59584
21147,KY,6780,16670,6898,9859,5517,4284,5338,16670,6156.392106,7142,9859,50891,8445,-3158,-7115,8919,55346,59336,47733,43776,59810
21149,KY,7512,16670,6898,9859,5517,4284,5445,15474,6477.810168,7142,9540,50429,8445,-3158,-7115,8919,56185,58874,47271,43314,59348
21151,KY,7248,16670,6898,9859,5517,4284,5406,17769,6576.708033,7142,9337,52357,9014,-2589,-6282,9488,55882,61371,49768,46075,61845
21153,KY,6780,16670,6898,9859,5517,4284,5338,16670,6601.432499,7142,9859,51336,8445,-3158,-7115,8919,55346,59781,48178,44221,60255
21155,KY,7092,16670,6898,9859,5517,4284,5384,16670,6156.392106,7142,9859,51203,8445,-3158,-7115,8919,55704,59648,48045,44088,60122
21157,KY,7476,16670,6898,9859,5517,4284,5439,16670,6700.330364,7142,9859,52131,9014,-2589,-6282,9488,56143,61145,49542,45849,61619
21159,KY,6780,16670,6898,9859,5517,4284,5338,16670,6551.983567,7142,9859,51287,8445,-3158,-7115,8919,55346,59732,48129,44172,60206
21161,KY,6912,16670,6898,9859,5517,4284,5357,16181,6354.187836,7142,9431,50304,8445,-3158,-7115,8919,55497,58749,47146,43189,59223
21163,KY,7632,16670,6898,9859,5517,4284,5462,17782,6428.361235,7142,9703,52971,9014,-2589,-6282,9488,56322,61985,50382,46689,62459
21165,KY,6780,16670,6898,9859,5517,4284,5338,15537,6477.810168,7142,8751,48972,8161,-3442,-7531,8635,55346,57133,45530,41441,57607
21167,KY,7152,16670,6898,9859,5517,4284,5392,16670,6378.912303,7142,9859,51486,9014,-2589,-6282,9488,55772,60500,48897,45204,60974
21169,KY,7248,16670,6898,9859,5517,4284,5406,15112,6378.912303,7142,8932,49097,8161,-3442,-7531,8635,55882,57258,45655,41566,57732
21171,KY,6780,16670,6898,9859,5517,4284,5338,16670,6527.2591,7142,9859,51262,8445,-3158,-7115,8919,55346,59707,48104,44147,60181
21173,KY,6948,16670,6898,9859,5517,4284,5363,16898,6453.085702,7142,8681,50406,8445,-3158,-7115,8919,55539,58851,47248,43291,59325
21175,KY,6780,16670,6898,9859,5517,4284,5338,16670,6453.085702,7142,9859,51188,8445,-3158,-7115,8919,55346,59633,48030,44073,60107
21177,KY,6780,16670,6898,9859,5517,4284,5338,16670,6403.636769,7142,9859,51139,8445,-3158,-7115,8919,55346,59584,47981,44024,60058
21179,KY,7344,16670,6898,9859,5517,4284,5420,16022,6650.881432,7142,9560,51002,8445,-3158,-7115,8919,55992,59447,47844,43887,59921
21181,KY,6780,16670,6898,9859,5517,4284,5338,16670,6477.810168,7142,9859,51213,8445,-3158,-7115,8919,55346,59658,48055,44098,60132
21183,KY,6780,16670,6898,9859,5517,4284,5338,16670,6255.289971,7142,9859,50990,8445,-3158,-7115,8919,55346,59435,47832,43875,59909
21185,KY,8460,16670,6898,9859,5517,4284,5582,19187,6848.677162,7142,9695,55617,9583,-2020,-5449,10057,57270,65200,53597,50168,65674
21187,KY,7296,16670,6898,9859,5517,4284,5413,16670,6700.330364,7142,9859,51951,9014,-2589,-6282,9488,55937,60965,49362,45669,61439
21189,KY,6780,16670,6898,9859,5517,4284,5338,16670,6551.983567,7142,9859,51287,8445,-3158,-7115,8919,55346,59732,48129,44172,60206
21191,KY,8820,16670,6898,9859,5517,4284,5635,16934,6700.330364,7142,9881,53761,9014,-2589,-6282,9488,57683,62775,51172,47479,63249
21193,KY,6780,16670,6898,9859,5517,4284,5338,16670,6675.605898,7142,9859,51411,8445,-3158,-7115,8919,55346,59856,48253,44296,60330
21195,KY,8520,16670,6898,9859,5517,4284,5591,16670,6601.432499,7142,9859,53076,9014,-2589,-6282,9488,57339,62090,50487,46794,62564
21197,KY,6780,16670,6898,9859,5517,4284,5338,16670,6502.534634,7142,9859,51238,8445,-3158,-7115,8919,55346,59683,48080,44123,60157
21199,KY,6912,16670,6898,9859,5517,4284,5357,16369,5933.871909,7142,8606,49246,8445,-3158,-7115,8919,55497,57691,46088,42131,58165
21201,KY,8940,16670,6898,9859,5517,4284,5652,16670,6354.187836,7142,9859,53249,9014,-2589,-6282,9488,57820,62263,50660,46967,62737
21203,KY,6780,16670,6898,9859,5517,4284,5338,16051,6106.943174,7142,9383,49748,8445,-3158,-7115,8919,55346,58193,46590,42633,58667
21205,KY,6888,16670,6898,9859,5517,4284,5354,16670,6551.983567,7142,9859,51395,8445,-3158,-7115,8919,55470,59840,48237,44280,60314
21207,KY,6780,16670,6898,9859,5517,4284,5338,16670,6082.218707,7142,9859,50817,8445,-3158,-7115,8919,55346,59262,47659,43702,59736
21209,KY,8604,16670,6898,9859,5517,4284,5603,17431,6873.401628,7142,9663,53997,9583,-2020,-5449,10057,57435,63580,51977,48548,64054
21211,KY,8280,16670,6898,9859,5517,4284,5556,17599,6650.881432,7142,9682,53639,9014,-2589,-6282,9488,57064,62653,51050,47357,63127
21213,KY,7500,16670,6898,9859,5517,4284,5443,16670,6527.2591,7142,9859,51982,9014,-2589,-6282,9488,56171,60996,49393,45700,61470
21215,KY,8460,16670,6898,9859,5517,4284,5582,16806,6650.881432,7142,9692,53035,9014,-2589,-6282,9488,57270,62049,50446,46753,62523
21217,KY,7272,16670,6898,9859,5517,4284,5410,15113,6205.841039,7142,8711,48727,8161,-3442,-7531,8635,55910,56888,45285,41196,57362
21219,KY,7008,16670,6898,9859,5517,4284,5371,16670,6354.187836,7142,9859,51317,8445,-3158,-7115,8919,55607,59762,48159,44202,60236
21221,KY,9204,16670,6898,9859,5517,4284,5690,16108,6477.810168,7142,9700,52916,9014,-2589,-6282,9488,58122,61930,50327,46634,62404
21223,KY,8460,16670,6898,9859,5517,4284,5582,16820,6181.116572,7142,9688,52576,9014,-2589,-6282,9488,57270,61590,49987,46294,62064
21225,KY,6780,16670,6898,9859,5517,4284,5338,16670,6378.912303,7142,9859,51114,8445,-3158,-7115,8919,55346,59559,47956,43999,60033
21227,KY,7932,16670,6898,9859,5517,4284,5506,17141,6329.46337,7142,9386,52215,9014,-2589,-6282,9488,56666,61229,49626,45933,61703
21229,KY,6780,16670,6898,9859,5517,4284,5338,16670,6205.841039,7142,9859,50941,8445,-3158,-7115,8919,55346,59386,47783,43826,59860
21231,KY,6780,16670,6898,9859,5517,4284,5338,16670,6230.565505,7142,9859,50966,8445,-3158,-7115,8919,55346,59411,47808,43851,59885
21233,KY,8868,16670,6898,9859,5517,4284,5641,16670,6675.605898,7142,9859,53499,9014,-2589,-6282,9488,57737,62513,50910,47217,62987
21235,KY,7164,16670,6898,9859,5517,4284,5394,16645,6551.983567,7142,8476,50263,8445,-3158,-7115,8919,55786,58708,47105,43148,59182
21237,KY,7596,16670,6898,9859,5517,4284,5457,16670,6255.289971,7142,9859,51806,9014,-2589,-6282,9488,56281,60820,49217,45524,61294
21239,KY,8604,16670,6898,9859,5517,4284,5603,16641,7244.268623,7142,9672,53588,9014,-2589,-6282,9488,57435,62602,50999,47306,63076
22001,LA,7644,9153,6898,9859,6239,4284,6158,8235,6997.02396,9998,9742,46900,4632,-7391,-11876,4686,50235,51532,39509,35024,51586
22003,LA,7644,9153,6898,9859,6239,4284,6158,9153,6626.156966,9998,9859,47564,4899,-7124,-11477,4953,50235,52463,40440,36087,52517
22005,LA,9588,9153,6898,9859,6239,4284,6460,10147,7367.890954,9998,9923,51307,5698,-6325,-10282,5752,52481,57005,44982,41025,57059
22007,LA,7872,9153,6898,9859,6239,4284,6194,9153,7170.095224,9998,9859,48336,5165,-6858,-11079,5219,50499,53501,41478,37257,53555
22009,LA,7980,9153,6898,9859,6239,4284,6211,9153,6551.983567,9998,9859,47826,5165,-6858,-11079,5219,50624,52991,40968,36747,53045
22011,LA,8064,9153,6898,9859,6239,4284,6224,9157,6626.156966,9998,9598,47727,4899,-7124,-11477,4953,50721,52626,40603,36250,52680
22013,LA,7644,9153,6898,9859,6239,4284,6158,9153,6898.126095,9998,9859,47836,4899,-7124,-11477,4953,50235,52735,40712,36359,52789
22015,LA,9084,9153,6898,9859,6239,4284,6382,10166,7046.472893,9998,9532,50110,5432,-6591,-10680,5486,51899,55542,43519,39430,55596
22017,LA,9084,9153,6898,9859,6239,4284,6382,9425,6922.850561,9998,9524,49238,5432,-6591,-10680,5486,51899,54670,42647,38558,54724
22019,LA,8748,9153,6898,9859,6239,4284,6330,9223,6626.156966,9998,9554,48433,5165,-6858,-11079,5219,51511,53598,41575,37354,53652
22021,LA,7644,9153,6898,9859,6239,4284,6158,9153,6601.432499,9998,9859,47539,4899,-7124,-11477,4953,50235,52438,40415,36062,52492
22023,LA,8748,9153,6898,9859,6239,4284,6330,9051,6354.187836,9998,9574,48009,5165,-6858,-11079,5219,51511,53174,41151,36930,53228
22025,LA,7644,9153,6898,9859,6239,4284,6158,9153,6576.708033,9998,9859,47515,4899,-7124,-11477,4953,50235,52414,40391,36038,52468
22027,LA,7644,9153,6898,9859,6239,4284,6158,9153,6848.677162,9998,9859,47787,4899,-7124,-11477,4953,50235,52686,40663,36310,52740
22029,LA,7644,9153,6898,9859,6239,4284,6158,8182,6873.401628,9998,8250,45232,4366,-7657,-12274,4420,50235,49598,37575,32958,49652
22031,LA,9084,9153,6898,9859,6239,4284,6382,9537,6725.054831,9998,9537,49165,5432,-6591,-10680,5486,51899,54597,42574,38485,54651
22033,LA,9588,9153,6898,9859,6239,4284,6460,10247,7194.81969,9998,9931,51243,5698,-6325,-10282,5752,52481,56941,44918,40961,56995
22035,LA,7644,9153,6898,9859,6239,4284,6158,9153,6675.605898,9998,9859,47614,4899,-7124,-11477,4953,50235,52513,40490,36137,52567
22037,LA,9588,9153,6898,9859,6239,4284,6460,9166,7343.166488,9998,9917,50296,5432,-6591,-10680,5486,52481,55728,43705,39616,55782
22039,LA,7644,9153,6898,9859,6239,4284,6158,9153,6650.881432,9998,9859,47589,4899,-7124,-11477,4953,50235,52488,40465,36112,52542
22041,LA,7644,9153,6898,9859,6239,4284,6158,9153,6354.187836,9998,9859,47292,4899,-7124,-11477,4953,50235,52191,40168,35815,52245
22043,LA,7872,9153,6898,9859,6239,4284,6194,9096,7021.748426,9998,9409,47681,4899,-7124,-11477,4953,50499,52580,40557,36204,52634
22045,LA,8484,9153,6898,9859,6239,4284,6289,9173,6675.605898,9998,9735,48349,5165,-6858,-11079,5219,51206,53514,41491,37270,53568
22047,LA,7644,9153,6898,9859,6239,4284,6158,8701,7194.81969,9998,9920,47742,4899,-7124,-11477,4953,50235,52641,40618,36265,52695
22049,LA,7644,9153,6898,9859,6239,4284,6158,9153,6700.330364,9998,9859,47638,4899,-7124,-11477,4953,50235,52537,40514,36161,52591
22051,LA,11376,9153,6898,9859,6239,4284,6738,10729,7268.993089,9998,9644,53299,6231,-5792,-9485,6285,54547,59530,47507,43814,59584
22053,LA,7644,9153,6898,9859,6239,4284,6158,9153,6799.22823,9998,9859,47737,4899,-7124,-11477,4953,50235,52636,40613,36260,52690
22055,LA,9492,9153,6898,9859,6239,4284,6445,10150,7367.890954,9998,9752,51044,5698,-6325,-10282,5752,52370,56742,44719,40762,56796
22057,LA,9276,9153,6898,9859,6239,4284,6412,9367,7170.095224,9998,9922,50017,5432,-6591,-10680,5486,52121,55449,43426,39337,55503
22059,LA,7644,9153,6898,9859,6239,4284,6158,9153,6403.636769,9998,9859,47342,4899,-7124,-11477,4953,50235,52241,40218,35865,52295
22061,LA,9108,9153,6898,9859,6239,4284,6386,9624,6997.02396,9998,8916,48927,5165,-6858,-11079,5219,51927,54092,42069,37848,54146
22063,LA,9588,9153,6898,9859,6239,4284,6460,10112,6749.779297,9998,9922,50653,5698,-6325,-10282,5752,52481,56351,44328,40371,56405
22065,LA,7908,9153,6898,9859,6239,4284,6199,9153,6626.156966,9998,9859,47828,5165,-6858,-11079,5219,50540,52993,40970,36749,53047
22067,LA,8292,9153,6898,9859,6239,4284,6259,8034,6378.912303,9998,8421,45408,4366,-7657,-12274,4420,50984,49774,37751,33134,49828
22069,LA,8724,9153,6898,9859,6239,4284,6326,9442,7021.748426,9998,8781,48251,5165,-6858,-11079,5219,51483,53416,41393,37172,53470
22071,LA,11376,9153,6898,9859,6239,4284,6738,12230,7961.278145,9998,9616,55466,6764,-5259,-8688,6818,54547,62230,50207,46778,62284
22073,LA,8316,9153,6898,9859,6239,4284,6263,9143,6675.605898,9998,8966,47383,4899,-7124,-11477,4953,51012,52282,40259,35906,52336
22075,LA,11376,9153,6898,9859,6239,4284,6738,12277,6354.187836,9998,9661,53950,6764,-5259,-8688,6818,54547,60714,48691,45262,60768
22077,LA,9588,9153,6898,9859,6239,4284,6460,9275,7244.268623,9998,9918,50307,5432,-6591,-10680,5486,52481,55739,43716,39627,55793
22079,LA,7872,9153,6898,9859,6239,4284,6194,9218,6329.46337,9998,9369,47070,4899,-7124,-11477,4953,50499,51969,39946,35593,52023
22081,LA,7644,9153,6898,9859,6239,4284,6158,9153,6922.850561,9998,9859,47861,4899,-7124,-11477,4953,50235,52760,40737,36384,52814
22083,LA,7644,9153,6898,9859,6239,4284,6158,9153,6576.708033,9998,9859,47515,4899,-7124,-11477,4953,50235,52414,40391,36038,52468
22085,LA,7644,9153,6898,9859,6239,4284,6158,9153,6848.677162,9998,9859,47787,4899,-7124,-11477,4953,50235,52686,40663,36310,52740
22087,LA,11376,9153,6898,9859,6239,4284,6738,9133,6972.299494,9998,9662,51425,5698,-6325,-10282,5752,54547,57123,45100,41143,57177
22089,LA,11376,9153,6898,9859,6239,4284,6738,10422,7615.135617,9998,9656,53351,6231,-5792,-9485,6285,54547,59582,47559,43866,59636
22091,LA,9588,9153,6898,9859,6239,4284,6460,9289,7095.921825,9998,9917,50171,5432,-6591,-10680,5486,52481,55603,43580,39491,55657
22093,LA,7644,9153,6898,9859,6239,4284,6158,9215,7590.411151,9998,9657,48388,4899,-7124,-11477,4953,50235,53287,41264,36911,53341
22095,LA,11376,9153,6898,9859,6239,4284,6738,9409,7170.095224,9998,9646,51883,5698,-6325,-10282,5752,54547,57581,45558,41601,57635
22097,LA,7644,9153,6898,9859,6239,4284,6158,8432,6601.432499,9998,8823,45782,4632,-7391,-11876,4686,50235,50414,38391,33906,50468
22099,LA,9492,9153,6898,9859,6239,4284,6445,9009,7145.370758,9998,9748,49676,5432,-6591,-10680,5486,52370,55108,43085,38996,55162
22101,LA,8352,9153,6898,9859,6239,4284,6268,9092,7046.472893,9998,9392,48165,5165,-6858,-11079,5219,51053,53330,41307,37086,53384
22103,LA,11376,9153,6898,9859,6239,4284,6738,10717,7516.237752,9998,9649,53541,6231,-5792,-9485,6285,54547,59772,47749,44056,59826
22105,LA,9864,9153,6898,9859,6239,4284,6503,9974,7194.81969,9998,9506,50820,5698,-6325,-10282,5752,52800,56518,44495,40538,56572
22107,LA,7644,9153,6898,9859,6239,4284,6158,9153,6650.881432,9998,9859,47589,4899,-7124,-11477,4953,50235,52488,40465,36112,52542
22109,LA,9276,9153,6898,9859,6239,4284,6412,9597,6650.881432,9998,9927,49733,5432,-6591,-10680,5486,52121,55165,43142,39053,55219
22111,LA,8316,9153,6898,9859,6239,4284,6263,8995,6749.779297,9998,9040,47382,4899,-7124,-11477,4953,51012,52281,40258,35905,52335
22113,LA,7884,9153,6898,9859,6239,4284,6196,8770,6749.779297,9998,9743,47429,4899,-7124,-11477,4953,50513,52328,40305,35952,52382
22115,LA,10980,9153,6898,9859,6239,4284,6676,10211,6477.810168,9998,9841,51792,6231,-5792,-9485,6285,54089,58023,46000,42307,58077
22117,LA,7884,9153,6898,9859,6239,4284,6196,8493,7071.197359,9998,8449,46179,4632,-7391,-11876,4686,50513,50811,38788,34303,50865
22119,LA,7644,9153,6898,9859,6239,4284,6158,8698,6799.22823,9998,9517,46941,4899,-7124,-11477,4953,50235,51840,39817,35464,51894
22121,LA,9588,9153,6898,9859,6239,4284,6460,9696,7318.442022,9998,9924,50809,5698,-6325,-10282,5752,52481,56507,44484,40527,56561
22123,LA,7644,9153,6898,9859,6239,4284,6158,9153,6502.534634,9998,9859,47441,4899,-7124,-11477,4953,50235,52340,40317,35964,52394
22125,LA,9588,9153,6898,9859,6239,4284,6460,10399,7046.472893,9998,9917,51232,5698,-6325,-10282,5752,52481,56930,44907,40950,56984
22127,LA,7644,9153,6898,9859,6239,4284,6158,9153,6527.2591,9998,9859,47465,4899,-7124,-11477,4953,50235,52364,40341,35988,52418
23001,ME,9024,5881,8011,7901,6405,3987,8173,4995,9016.128969,8735,7543,43300,3817,-8256,-12774,3821,49382,47117,35044,30526,47121
23003,ME,7644,5881,8011,7901,6405,3987,7904,5881,8470.567025,8735,7901,42619,3817,-8256,-12774,3821,47733,46436,34363,29845,46440
23005,ME,11871,5881,8011,7901,6405,3987,8727,7137,9590.404699,8735,7875,49195,5492,-6581,-10934,5496,52783,54687,42614,38261,54691
23007,ME,7956,5881,8011,7901,6405,3987,7965,5881,9159.697901,8735,7901,43620,3817,-8256,-12774,3821,48106,47437,35364,30846,47441
23009,ME,9876,5881,8011,7901,6405,3987,8338,5881,9762.687418,8735,7901,46143,4638,-7435,-12070,4642,50399,50781,38708,34073,50785
23011,ME,9264,5881,8011,7901,6405,3987,8219,7126,8901.273823,8735,7498,45512,4638,-7435,-12070,4642,49668,50150,38077,33442,50154
23013,ME,10608,5881,8011,7901,6405,3987,8481,5881,10250.82179,8735,7901,47363,4999,-7074,-11691,5003,51274,52362,40289,35672,52366
23015,ME,11016,5881,8011,7901,6405,3987,8560,5881,10652.8148,8735,7901,48173,4999,-7074,-11691,5003,51761,53172,41099,36482,53176
23017,ME,8364,5881,8011,7901,6405,3987,8044,5881,8815.132463,8735,7901,43683,3817,-8256,-12774,3821,48593,47500,35427,30909,47504
23019,ME,9486,5881,8011,7901,6405,3987,8263,6280,8757.70489,8735,7512,44757,4638,-7435,-12070,4642,49934,49395,37322,32687,49399
23021,ME,7800,5881,8011,7901,6405,3987,7934,5881,9245.839261,8735,7901,43550,3817,-8256,-12774,3821,47919,47367,35294,30776,47371
23023,ME,10344,5881,8011,7901,6405,3987,8430,6650,10537.95965,8735,7883,48137,4999,-7074,-11691,5003,50959,53136,41063,36446,53140
23025,ME,8472,5881,8011,7901,6405,3987,8065,5881,8384.425665,8735,7901,43360,3817,-8256,-12774,3821,48722,47177,35104,30586,47181
23027,ME,8832,5881,8011,7901,6405,3987,8135,5881,10021.1115,8735,7901,45357,4204,-7869,-12446,4208,49152,49561,37488,32911,49565
23029,ME,7968,5881,8011,7901,6405,3987,7967,5881,8987.415182,8735,7901,43459,3817,-8256,-12774,3821,48120,47276,35203,30685,47280
23031,ME,11168,5881,8011,7901,6405,3987,8590,5453,9561.690913,8735,7882,46787,4999,-7074,-11691,5003,51943,51786,39713,35096,51790
24001,MD,7644,13960,6898,9859,6145,4284,6216,12627,7244.268623,7730,8652,48181,499,-4874,-9227,7203,55006,48680,43307,38954,55384
24003,MD,15024,13960,6898,9859,6145,4284,7287,15571,7343.166488,7730,10642,60594,4060,-1313,-3950,10764,63457,64654,59281,56644,71358
24005,MD,15024,13960,6898,9859,6145,4284,7287,15469,7170.095224,7730,10692,60369,4060,-1313,-3950,10764,63457,64429,59056,56419,71133
24009,MD,17628,13960,6898,9859,6145,4284,7665,17827,8406.318538,7730,11156,67031,5156,-217,-2326,11860,66439,72187,66814,64705,78891
24011,MD,10692,13960,6898,9859,6145,4284,6658,13960,6997.02396,7730,9859,53522,1868,-3505,-7198,8572,58496,55390,50017,46324,62094
24013,MD,15024,13960,6898,9859,6145,4284,7287,17994,7986.002612,7730,10631,63649,4608,-765,-3138,11312,63457,68257,62884,60511,74961
24015,MD,13620,13960,6898,9859,6145,4284,7083,16130,6848.677162,7730,10382,58994,3512,-1861,-4762,10216,61849,62506,57133,54232,69210
24017,MD,17628,13960,6898,9859,6145,4284,7665,14895,7293.717555,7730,11208,63038,4608,-765,-3138,11312,66439,67646,62273,59900,74350
24019,MD,10164,13960,6898,9859,6145,4284,6582,14735,6749.779297,7730,9390,53053,1868,-3505,-7198,8572,57892,54921,49548,45855,61625
24021,MD,17628,13960,6898,9859,6145,4284,7665,12310,7268.993089,7730,11261,60482,4060,-1313,-3950,10764,66439,64542,59169,56532,71246
24023,MD,8292,13960,6898,9859,6145,4284,6310,13960,6774.503763,7730,9859,50900,1320,-4053,-8010,8024,55748,52220,46847,42890,58924
24025,MD,15024,13960,6898,9859,6145,4284,7287,13936,7417.339887,7730,10626,59017,3512,-1861,-4762,10216,63457,62529,57156,54255,69233
24027,MD,15024,13960,6898,9859,6145,4284,7287,13583,8233.247274,7730,10653,59507,3512,-1861,-4762,10216,63457,63019,57646,54745,69723
24028,MD,18672,13960,6898,9859,6145,4284,7817,13960,6898,7730,9859,61403,4060,-1313,-3950,10764,67635,65463,60090,57453,72167
24029,MD,11328,13960,6898,9859,6145,4284,6751,13960,7812.931347,7730,9859,54974,2416,-2957,-6386,9120,59225,57390,52017,48588,64094
24031,MD,17628,13960,6898,9859,6145,4284,7665,12902,8356.869606,7730,11487,62387,4060,-1313,-3950,10764,66439,66447,61074,58437,73151
24033,MD,17628,13960,6898,9859,6145,4284,7665,13913,7071.197359,7730,11452,62078,4060,-1313,-3950,10764,66439,66138,60765,58128,72842
24035,MD,15024,13960,6898,9859,6145,4284,7287,15288,9024.430196,7730,10579,61930,3512,-1861,-4762,10216,63457,65442,60069,57168,72146
24037,MD,14592,13960,6898,9859,6145,4284,7225,14181,7318.442022,7730,11148,59253,3512,-1861,-4762,10216,62963,62765,57392,54491,69469
24039,MD,8352,13960,6898,9859,6145,4284,6319,13101,6650.881432,7730,9697,49815,1320,-4053,-8010,8024,55817,51135,45762,41805,57839
24041,MD,12720,13960,6898,9859,6145,4284,6953,14504,8208.522808,7730,9979,57426,2964,-2409,-5574,9668,60819,60390,55017,51852,67094
24043,MD,11616,13960,6898,9859,6145,4284,6792,15394,6848.677162,7730,9796,55668,2416,-2957,-6386,9120,59554,58084,52711,49282,64788
24045,MD,10500,13960,6898,9859,6145,4284,6630,16034,6823.952696,7730,9686,55058,2416,-2957,-6386,9120,58276,57474,52101,48672,64178
24047,MD,10656,13960,6898,9859,6145,4284,6653,13273,7714.033482,7730,9695,53352,1868,-3505,-7198,8572,58455,55220,49847,46154,61924
24510,MD,15024,13960,6898,9859,6145,4284,7287,13573,7664.58455,7730,10847,59123,3512,-1861,-4762,10216,63457,62635,57262,54361,69339
25001,MA,14112,5932,8011,7901,6204,3987,8417,6266,10279.53558,8555,7852,51051,7133,-3942,-8163,8135,54564,58184,47109,42888,59186
25003,MA,9648,5932,8011,7901,6204,3987,7670,6604,9820.114991,8555,7470,46084,5907,-5168,-9803,6909,49353,51991,40916,36281,52993
25005,MA,11262,5932,8011,7901,6204,3987,7940,5759,8585.422171,8555,7904,46053,6300,-4775,-9392,7302,51237,52353,41278,36661,53355
25007,MA,15648,5932,8011,7901,6204,3987,8674,5864,9274.553047,8555,8552,51881,7689,-3386,-7343,8691,56357,59570,48495,44538,60572
25009,MA,15798,5932,8011,7901,6204,3987,8699,6002,8958.701396,8555,8596,51897,7689,-3386,-7343,8691,56532,59586,48511,44554,60588
25011,MA,11423,5932,8011,7901,6204,3987,7967,6312,9188.411688,8555,7743,47208,6577,-4498,-8983,7579,51425,53785,42710,38225,54787
25013,MA,11412,5932,8011,7901,6204,3987,7965,5328,8212.142946,8555,7714,45209,6300,-4775,-9392,7302,51412,51509,40434,35817,52511
25015,MA,11412,5932,8011,7901,6204,3987,7965,7609,9446.835767,8555,7730,48740,6856,-4219,-8572,7858,51412,55596,44521,40168,56598
25017,MA,16742,5932,8011,7901,6204,3987,8857,7572,9274.553047,8555,8625,54756,8245,-2830,-6523,9247,57634,63001,51926,48233,64003
25019,MA,21588,5932,8011,7901,6204,3987,9667,5932,9130.984115,8555,7901,57094,8801,-2274,-5703,9803,63290,65895,54820,51391,66897
25021,MA,17424,5932,8011,7901,6204,3987,8971,6828,9016.128969,8555,8605,54415,8245,-2830,-6523,9247,58430,62660,51585,47892,63662
25023,MA,15676,5932,8011,7901,6204,3987,8678,6891,9561.690913,8555,8546,53217,7689,-3386,-7343,8691,56389,60906,49831,45874,61908
25025,MA,17448,5932,8011,7901,6204,3987,8975,6526,9820.114991,8555,8824,55160,8245,-2830,-6523,9247,58458,63405,52330,48637,64407
25027,MA,11371,5932,8011,7901,6204,3987,7959,7233,8728.991103,8555,8414,48289,6856,-4219,-8572,7858,51365,55145,44070,39717,56147
26001,MI,7644,10125,7047,9589,5589,4046,6389,10125,6744.026504,7354,9589,45502,6880,-5119,-9736,6958,50429,52382,40383,35766,52460
26003,MI,7644,10125,7047,9589,5589,4046,6389,10125,7122.904397,7354,9589,45881,6880,-5119,-9736,6958,50429,52761,40762,36145,52839
26005,MI,8328,10125,7047,9589,5589,4046,6497,10861,6845.060609,7354,9552,46986,7418,-4581,-8934,7496,51221,54404,42405,38052,54482
26007,MI,7644,10125,7047,9589,5589,4046,6389,9338,6819.802082,7354,8320,43523,6040,-5959,-10536,6118,50429,49563,37564,32987,49641
26009,MI,7776,10125,7047,9589,5589,4046,6409,10125,7653.333448,7354,9589,46543,6880,-5119,-9736,6958,50581,53423,41424,36807,53501
26011,MI,7644,10125,7047,9589,5589,4046,6389,10125,6541.958294,7354,9589,45300,6880,-5119,-9736,6958,50429,52180,40181,35564,52258
26013,MI,7644,10125,7047,9589,5589,4046,6389,10125,7223.938502,7354,9589,45982,6880,-5119,-9736,6958,50429,52862,40863,36246,52940
26015,MI,8160,10125,7047,9589,5589,4046,6470,10246,6617.733873,7354,9623,46046,7148,-4850,-9335,7227,51026,53194,41196,36711,53273
26017,MI,7896,10125,7047,9589,5589,4046,6428,10082,6339.890084,7354,9071,44789,6880,-5119,-9736,6958,50720,51669,39670,35053,51747
26019,MI,8208,10125,7047,9589,5589,4046,6478,9645,7072.387345,7354,9291,45616,6880,-5119,-9736,6958,51082,52496,40497,35880,52574
26021,MI,8328,10125,7047,9589,5589,4046,6497,10110,6440.924189,7354,9117,45395,7148,-4850,-9335,7227,51221,52543,40545,36060,52622
26023,MI,7944,10125,7047,9589,5589,4046,6436,9780,5859.978086,7354,9053,44037,6880,-5119,-9736,6958,50776,50917,38918,34301,50995
26025,MI,8268,10125,7047,9589,5589,4046,6487,10229,6415.665663,7354,9029,45342,6880,-5119,-9736,6958,51151,52222,40223,35606,52300
26027,MI,7644,10125,7047,9589,5589,4046,6389,9693,6996.611766,7354,9254,44988,6880,-5119,-9736,6958,50429,51868,39869,35252,51946
26029,MI,8244,10125,7047,9589,5589,4046,6483,10125,7729.109027,7354,9589,47087,7148,-4850,-9335,7227,51123,54235,42237,37752,54314
26031,MI,7644,10125,7047,9589,5589,4046,6389,10125,6744.026504,7354,9589,45502,6880,-5119,-9736,6958,50429,52382,40383,35766,52460
26033,MI,7728,10125,7047,9589,5589,4046,6402,10087,6920.836187,7354,8738,44874,6496,-5502,-10137,6575,50526,51370,39372,34737,51449
26035,MI,7644,10125,7047,9589,5589,4046,6389,10125,6036.787769,7354,9589,44795,6880,-5119,-9736,6958,50429,51675,39676,35059,51753
26037,MI,9144,10125,7047,9589,5589,4046,6625,11360,7072.387345,7354,9349,48325,7686,-4312,-8533,7765,52165,56011,44013,39792,56090
26039,MI,8256,10125,7047,9589,5589,4046,6485,10125,6819.802082,7354,9589,46190,7148,-4850,-9335,7227,51137,53338,41340,36855,53417
26041,MI,7644,10125,7047,9589,5589,4046,6389,9492,6971.35324,7354,8857,44364,6496,-5502,-10137,6575,50429,50860,38862,34227,50939
26043,MI,7644,10125,7047,9589,5589,4046,6389,9101,7021.870292,7354,8934,44102,6496,-5502,-10137,6575,50429,50598,38600,33965,50677
26045,MI,9144,10125,7047,9589,5589,4046,6625,11548,6592.475346,7354,9336,48021,7686,-4312,-8533,7765,52165,55707,43709,39488,55786
26047,MI,9228,10125,7047,9589,5589,4046,6638,10125,7451.265238,7354,9589,47793,7418,-4581,-8934,7496,52262,55211,43212,38859,55289
26049,MI,8520,10125,7047,9589,5589,4046,6527,10623,6541.958294,7354,8874,45959,7148,-4850,-9335,7227,51443,53107,41109,36624,53186
26051,MI,7644,10125,7047,9589,5589,4046,6389,10125,7223.938502,7354,9589,45982,6880,-5119,-9736,6958,50429,52862,40863,36246,52940
26053,MI,7644,10125,7047,9589,5589,4046,6389,10125,6592.475346,7354,9589,45350,6880,-5119,-9736,6958,50429,52230,40231,35614,52308
26055,MI,9780,10125,7047,9589,5589,4046,6725,11409,7350.231133,7354,9264,49204,7686,-4312,-8533,7765,52901,56890,44892,40671,56969
26057,MI,7644,10125,7047,9589,5589,4046,6389,9776,6415.665663,7354,8769,44004,6496,-5502,-10137,6575,50429,50500,38502,33867,50579
26059,MI,7932,10125,7047,9589,5589,4046,6434,9809,6213.597453,7354,9016,44370,6880,-5119,-9736,6958,50762,51250,39251,34634,51328
26061,MI,7764,10125,7047,9589,5589,4046,6408,9519,7249.197028,7354,8457,44388,6496,-5502,-10137,6575,50568,50884,38886,34251,50963
26063,MI,7644,10125,7047,9589,5589,4046,6389,10125,6541.958294,7354,9589,45300,6880,-5119,-9736,6958,50429,52180,40181,35564,52258
26065,MI,9144,10125,7047,9589,5589,4046,6625,11885,6920.836187,7354,9316,48666,7686,-4312,-8533,7765,52165,56352,44354,40133,56431
26067,MI,8112,10125,7047,9589,5589,4046,6462,10648,6466.182715,7354,9307,45934,7148,-4850,-9335,7227,50970,53082,41084,36599,53161
26069,MI,7644,10125,7047,9589,5589,4046,6389,10125,6971.35324,7354,9589,45729,6880,-5119,-9736,6958,50429,52609,40610,35993,52687
26071,MI,7644,10125,7047,9589,5589,4046,6389,10125,6668.250925,7354,9589,45426,6880,-5119,-9736,6958,50429,52306,40307,35690,52384
26073,MI,8328,10125,7047,9589,5589,4046,6497,11428,6617.733873,7354,8756,46529,7148,-4850,-9335,7227,51221,53677,41679,37194,53756
26075,MI,9264,10125,7047,9589,5589,4046,6644,10491,6289.373032,7354,9137,46582,7418,-4581,-8934,7496,52304,54000,42001,37648,54078
26077,MI,8616,10125,7047,9589,5589,4046,6542,11498,6718.767977,7354,9245,47477,7418,-4581,-8934,7496,51554,54895,42896,38543,54973
26079,MI,8604,10125,7047,9589,5589,4046,6540,9666,7047.128818,7354,9270,45987,6880,-5119,-9736,6958,51540,52867,40868,36251,52945
26081,MI,8880,10125,7047,9589,5589,4046,6584,11767,6617.733873,7354,9630,48296,7686,-4312,-8533,7765,51860,55982,43984,39763,56061
26083,MI,7716,10125,7047,9589,5589,4046,6400,8572,7223.938502,7354,8564,43476,6040,-5959,-10536,6118,50512,49516,37517,32940,49594
26085,MI,7644,10125,7047,9589,5589,4046,6389,10125,6365.14861,7354,9589,45123,6880,-5119,-9736,6958,50429,52003,40004,35387,52081
26087,MI,10116,10125,7047,9589,5589,4046,6778,10729,6819.802082,7354,9403,48468,7686,-4312,-8533,7765,53290,56154,44156,39935,56233
26089,MI,9612,10125,7047,9589,5589,4046,6699,11033,11568.40501,7354,9300,52913,7686,-4312,-8533,7765,52707,60599,48601,44380,60678
26091,MI,8388,10125,7047,9589,5589,4046,6506,10369,6062.046295,7354,9217,45436,7148,-4850,-9335,7227,51290,52584,40586,36101,52663
26093,MI,10656,10125,7047,9589,5589,4046,6864,12300,6819.802082,7354,9394,50570,8224,-3774,-7731,8303,53916,58794,46796,42839,58873
26095,MI,7644,10125,7047,9589,5589,4046,6389,10125,7122.904397,7354,9589,45881,6880,-5119,-9736,6958,50429,52761,40762,36145,52839
26097,MI,7836,10125,7047,9589,5589,4046,6419,10125,7072.387345,7354,9589,46022,6880,-5119,-9736,6958,50651,52902,40903,36286,52980
26099,MI,10116,10125,7047,9589,5589,4046,6778,12037,6845.060609,7354,9373,49770,7956,-4043,-8132,8034,53290,57726,45727,41638,57804
26101,MI,7680,10125,7047,9589,5589,4046,6394,10125,7097.645871,7354,9589,45892,6880,-5119,-9736,6958,50470,52772,40773,36156,52850
26103,MI,8340,10125,7047,9589,5589,4046,6498,10203,7299.714081,7354,9115,46358,7148,-4850,-9335,7227,51234,53506,41508,37023,53585
26105,MI,8040,10125,7047,9589,5589,4046,6451,10296,6466.182715,7354,8764,44966,6880,-5119,-9736,6958,50887,51846,39847,35230,51924
26107,MI,7644,10125,7047,9589,5589,4046,6389,10386,6415.665663,7354,8656,44502,6880,-5119,-9736,6958,50429,51382,39383,34766,51460
26109,MI,7644,10125,7047,9589,5589,4046,6389,9053,8183.762499,7354,8744,45025,6040,-5959,-10536,6118,50429,51065,39066,34489,51143
26111,MI,8928,10125,7047,9589,5589,4046,6591,11000,7097.645871,7354,9346,47772,7418,-4581,-8934,7496,51915,55190,43191,38838,55268
26113,MI,7644,10125,7047,9589,5589,4046,6389,9341,6920.836187,7354,9047,44352,6496,-5502,-10137,6575,50429,50848,38850,34215,50927
26115,MI,10116,10125,7047,9589,5589,4046,6778,11229,6693.509451,7354,9476,48915,7956,-4043,-8132,8034,53290,56871,44872,40783,56949
26117,MI,7812,10125,7047,9589,5589,4046,6415,9790,6365.14861,7354,9623,44990,6880,-5119,-9736,6958,50623,51870,39871,35254,51948
26119,MI,7992,10125,7047,9589,5589,4046,6444,10125,6845.060609,7354,9589,45951,7148,-4850,-9335,7227,50832,53099,41101,36616,53178
26121,MI,7656,10125,7047,9589,5589,4046,6391,9894,6314.631558,7354,8926,44191,6496,-5502,-10137,6575,50443,50687,38689,34054,50766
26123,MI,7644,10125,7047,9589,5589,4046,6389,10125,6213.597453,7354,9589,44972,6880,-5119,-9736,6958,50429,51852,39853,35236,51930
26125,MI,10116,10125,7047,9589,5589,4046,6778,13394,6971.35324,7354,9375,51256,8224,-3774,-7731,8303,53290,59480,47482,43525,59559
26127,MI,7764,10125,7047,9589,5589,4046,6408,10125,6744.026504,7354,9589,45622,6880,-5119,-9736,6958,50568,52502,40503,35886,52580
26129,MI,7656,10125,7047,9589,5589,4046,6391,10125,6541.958294,7354,9589,45312,6880,-5119,-9736,6958,50443,52192,40193,35576,52270
26131,MI,7644,10125,7047,9589,5589,4046,6389,10125,6693.509451,7354,9589,45452,6880,-5119,-9736,6958,50429,52332,40333,35716,52410
26133,MI,7644,10125,7047,9589,5589,4046,6389,10125,5405.324613,7354,9589,44163,6880,-5119,-9736,6958,50429,51043,39044,34427,51121
26135,MI,8220,10125,7047,9589,5589,4046,6479,10125,6819.802082,7354,9589,46154,7148,-4850,-9335,7227,51095,53302,41304,36819,53381
26137,MI,7956,10125,7047,9589,5589,4046,6438,10125,6946.094714,7354,9589,46016,7148,-4850,-9335,7227,50790,53164,41166,36681,53243
26139,MI,9444,10125,7047,9589,5589,4046,6673,11519,6440.924189,7354,9627,48431,7956,-4043,-8132,8034,52513,56387,44388,40299,56465
26141,MI,7644,10125,7047,9589,5589,4046,6389,10125,7021.870292,7354,9589,45780,6880,-5119,-9736,6958,50429,52660,40661,36044,52738
26143,MI,7644,10125,7047,9589,5589,4046,6389,10125,6642.992399,7354,9589,45401,6880,-5119,-9736,6958,50429,52281,40282,35665,52359
26145,MI,8508,10125,7047,9589,5589,4046,6525,10137,6365.14861,7354,8992,45402,7148,-4850,-9335,7227,51429,52550,40552,36067,52629
26147,MI,10116,10125,7047,9589,5589,4046,6778,10803,6541.958294,7354,9392,48253,7686,-4312,-8533,7765,53290,55939,43941,39720,56018
26149,MI,7884,10125,7047,9589,5589,4046,6426,9675,6415.665663,7354,9243,44618,6880,-5119,-9736,6958,50706,51498,39499,34882,51576
26151,MI,7644,10125,7047,9589,5589,4046,6389,10125,6365.14861,7354,9589,45123,6880,-5119,-9736,6958,50429,52003,40004,35387,52081
26153,MI,7644,10125,7047,9589,5589,4046,6389,10125,6946.094714,7354,9589,45704,6880,-5119,-9736,6958,50429,52584,40585,35968,52662
26155,MI,8100,10125,7047,9589,5589,4046,6461,10111,6062.046295,7354,9169,44842,6880,-5119,-9736,6958,50957,51722,39723,35106,51800
26157,MI,7644,10125,7047,9589,5589,4046,6389,10125,6314.631558,7354,9589,45073,6880,-5119,-9736,6958,50429,51953,39954,35337,52031
26159,MI,8616,10125,7047,9589,5589,4046,6542,10452,6718.767977,7354,9251,46437,7148,-4850,-9335,7227,51554,53585,41587,37102,53664
26161,MI,11424,10125,7047,9589,5589,4046,6985,14049,7148.162923,7354,9553,53574,8762,-3236,-6929,8841,54805,62336,50338,46645,62415
26163,MI,10116,10125,7047,9589,5589,4046,6778,11288,6668.250925,7354,9364,48836,7956,-4043,-8132,8034,53290,56792,44793,40704,56870
26165,MI,7788,10125,7047,9589,5589,4046,6411,10150,6440.924189,7354,9014,44793,6880,-5119,-9736,6958,50595,51673,39674,35057,51751
27001,MN,8472,17079,7047,9589,5836,4046,7846,17079,6895.577661,7606,9589,53688,5882,-3811,-7504,8266,59915,59570,49877,46184,61954
27003,MN,11352,17079,7047,9589,5836,4046,8381,19396,6744.026504,7606,10307,59451,7562,-2131,-5032,9946,63330,67013,57320,54419,69397
27005,MN,7644,17079,7047,9589,5836,4046,7692,17079,6920.836187,7606,9589,52885,5882,-3811,-7504,8266,58933,58767,49074,45381,61151
27007,MN,8088,17079,7047,9589,5836,4046,7775,16867,6819.802082,7606,9212,52639,5882,-3811,-7504,8266,59460,58521,48828,45135,60905
27009,MN,9024,17079,7047,9589,5836,4046,7949,17784,7653.333448,7606,9680,55793,6442,-3251,-6680,8826,60570,62235,52542,49113,64619
27011,MN,7644,17079,7047,9589,5836,4046,7692,17079,6895.577661,7606,9589,52860,5882,-3811,-7504,8266,58933,58742,49049,45356,61126
27013,MN,8448,17079,7047,9589,5836,4046,7842,17762,6769.28503,7606,9757,54388,6442,-3251,-6680,8826,59887,60830,51137,47708,63214
27015,MN,7644,17079,7047,9589,5836,4046,7692,14877,7198.679976,7606,9212,50584,5322,-4371,-8328,7706,58933,55906,46213,42256,58290
27017,MN,8304,17079,7047,9589,5836,4046,7815,15709,7223.938502,7606,9117,52006,5322,-4371,-8328,7706,59716,57328,47635,43678,59712
27019,MN,11352,17079,7047,9589,5836,4046,8381,21566,9194.103548,7606,10287,64051,8122,-1571,-4208,10506,63330,72173,62480,59843,74557
27021,MN,8580,17079,7047,9589,5836,4046,7866,15254,6592.475346,7606,8991,51070,5322,-4371,-8328,7706,60043,56392,46699,42742,58776
27023,MN,7752,17079,7047,9589,5836,4046,7712,17079,7072.387345,7606,9589,53144,5882,-3811,-7504,8266,59061,59026,49333,45640,61410
27025,MN,11352,17079,7047,9589,5836,4046,8381,17935,7501.782291,7606,10276,58717,7562,-2131,-5032,9946,63330,66279,56586,53685,68663
27027,MN,8208,17079,7047,9589,5836,4046,7797,17783,7400.748186,7606,9618,54661,6442,-3251,-6680,8826,59602,61103,51410,47981,63487
27029,MN,7644,17079,7047,9589,5836,4046,7692,17079,6920.836187,7606,9589,52885,5882,-3811,-7504,8266,58933,58767,49074,45381,61151
27031,MN,9504,17079,7047,9589,5836,4046,8038,17079,7047.128818,7606,9589,54871,6442,-3251,-6680,8826,61139,61313,51620,48191,63697
27033,MN,7644,17079,7047,9589,5836,4046,7692,17079,6920.836187,7606,9589,52885,5882,-3811,-7504,8266,58933,58767,49074,45381,61151
27035,MN,8652,17079,7047,9589,5836,4046,7880,16028,6668.250925,7606,8941,51941,5882,-3811,-7504,8266,60129,57823,48130,44437,60207
27037,MN,11352,17079,7047,9589,5836,4046,8381,21738,7375.489659,7606,10325,62443,8695,-998,-3371,11079,63330,71138,61445,59072,73522
27039,MN,10356,17079,7047,9589,5836,4046,8196,16716,6946.094714,7606,10195,55865,6442,-3251,-6680,8826,62149,62307,52614,49185,64691
27041,MN,7644,17079,7047,9589,5836,4046,7692,16430,7072.387345,7606,9270,52068,5882,-3811,-7504,8266,58933,57950,48257,44564,60334
27043,MN,7644,17079,7047,9589,5836,4046,7692,17079,6870.319135,7606,9589,52834,5882,-3811,-7504,8266,58933,58716,49023,45330,61100
27045,MN,7644,17079,7047,9589,5836,4046,7692,15007,6845.060609,7606,10182,51330,5322,-4371,-8328,7706,58933,56652,46959,43002,59036
27047,MN,7644,17079,7047,9589,5836,4046,7692,14703,7375.489659,7606,9137,50511,5322,-4371,-8328,7706,58933,55833,46140,42183,58217
27049,MN,8940,17079,7047,9589,5836,4046,7933,18263,7703.8505,7606,9601,56159,6442,-3251,-6680,8826,60470,62601,52908,49479,64985
27051,MN,7644,17079,7047,9589,5836,4046,7692,17079,7072.387345,7606,9589,53036,5882,-3811,-7504,8266,58933,58918,49225,45532,61302
27053,MN,11352,17079,7047,9589,5836,4046,8381,22011,7451.265238,7606,10370,62837,8695,-998,-3371,11079,63330,71532,61839,59466,73916
27055,MN,8388,17079,7047,9589,5836,4046,7831,15248,6794.543556,7606,9556,51638,5322,-4371,-8328,7706,59816,56960,47267,43310,59344
27057,MN,7644,17079,7047,9589,5836,4046,7692,17079,7021.870292,7606,9589,52986,5882,-3811,-7504,8266,58933,58868,49175,45482,61252
27059,MN,11352,17079,7047,9589,5836,4046,8381,17605,7223.938502,7606,10283,58116,7002,-2691,-5856,9386,63330,65118,55425,52260,67502
27061,MN,8964,17079,7047,9589,5836,4046,7937,17079,6946.094714,7606,9589,54230,6442,-3251,-6680,8826,60498,60672,50979,47550,63056
27063,MN,7644,17079,7047,9589,5836,4046,7692,17079,6794.543556,7606,9589,52759,5882,-3811,-7504,8266,58933,58641,48948,45255,61025
27065,MN,9240,17079,7047,9589,5836,4046,7989,17079,6946.094714,7606,9589,54506,6442,-3251,-6680,8826,60826,60948,51255,47826,63332
27067,MN,7848,17079,7047,9589,5836,4046,7730,16615,7047.128818,7606,9468,52630,5882,-3811,-7504,8266,59175,58512,48819,45126,60896
27069,MN,7644,17079,7047,9589,5836,4046,7692,17079,7047.128818,7606,9589,53011,5882,-3811,-7504,8266,58933,58893,49200,45507,61277
27071,MN,7644,17079,7047,9589,5836,4046,7692,17079,6895.577661,7606,9589,52860,5882,-3811,-7504,8266,58933,58742,49049,45356,61126
27073,MN,7644,17079,7047,9589,5836,4046,7692,17079,7047.128818,7606,9589,53011,5882,-3811,-7504,8266,58933,58893,49200,45507,61277
27075,MN,7752,17079,7047,9589,5836,4046,7712,17079,7097.645871,7606,9589,53170,5882,-3811,-7504,8266,59061,59052,49359,45666,61436
27077,MN,7644,17079,7047,9589,5836,4046,7692,17079,6895.577661,7606,9589,52860,5882,-3811,-7504,8266,58933,58742,49049,45356,61126
27079,MN,8544,17079,7047,9589,5836,4046,7860,16542,6870.319135,7606,10276,53884,6442,-3251,-6680,8826,60001,60326,50633,47204,62710
27081,MN,7644,17079,7047,9589,5836,4046,7692,17079,7299.714081,7606,9589,53264,5882,-3811,-7504,8266,58933,59146,49453,45760,61530
27083,MN,7644,17079,7047,9589,5836,4046,7692,15878,7223.938502,7606,9514,51912,5322,-4371,-8328,7706,58933,57234,47541,43584,59618
27085,MN,8052,17079,7047,9589,5836,4046,7768,17279,7299.714081,7606,9607,53889,5882,-3811,-7504,8266,59417,59771,50078,46385,62155
27087,MN,7644,17079,7047,9589,5836,4046,7692,17079,7072.387345,7606,9589,53036,5882,-3811,-7504,8266,58933,58918,49225,45532,61302
27089,MN,7644,17079,7047,9589,5836,4046,7692,17079,6946.094714,7606,9589,52910,5882,-3811,-7504,8266,58933,58792,49099,45406,61176
27091,MN,7980,17079,7047,9589,5836,4046,7755,17079,7122.904397,7606,9589,53423,5882,-3811,-7504,8266,59332,59305,49612,45919,61689
27093,MN,9012,17079,7047,9589,5836,4046,7946,17079,7223.938502,7606,9589,54556,6442,-3251,-6680,8826,60555,60998,51305,47876,63382
27095,MN,8712,17079,7047,9589,5836,4046,7891,16670,6920.836187,7606,10276,54230,6442,-3251,-6680,8826,60200,60672,50979,47550,63056
27097,MN,7656,17079,7047,9589,5836,4046,7695,17079,7072.387345,7606,9589,53048,5882,-3811,-7504,8266,58948,58930,49237,45544,61314
27099,MN,8376,17079,7047,9589,5836,4046,7828,15071,6137.821874,7606,9307,50543,5322,-4371,-8328,7706,59801,55865,46172,42215,58249
27101,MN,7644,17079,7047,9589,5836,4046,7692,17079,6819.802082,7606,9589,52784,5882,-3811,-7504,8266,58933,58666,48973,45280,61050
27103,MN,8448,17079,7047,9589,5836,4046,7842,17832,7880.660184,7606,9755,55567,6442,-3251,-6680,8826,59887,62009,52316,48887,64393
27105,MN,7644,17079,7047,9589,5836,4046,7692,14957,6390.407136,7606,9613,50257,5322,-4371,-8328,7706,58933,55579,45886,41929,57963
27107,MN,7644,17079,7047,9589,5836,4046,7692,17079,7097.645871,7606,9589,53062,5882,-3811,-7504,8266,58933,58944,49251,45558,61328
27109,MN,10356,17079,7047,9589,5836,4046,8196,18710,6946.094714,7606,10217,57881,7002,-2691,-5856,9386,62149,64883,55190,52025,67267
27111,MN,7644,17079,7047,9589,5836,4046,7692,15714,7097.645871,7606,9187,51295,5322,-4371,-8328,7706,58933,56617,46924,42967,59001
27113,MN,7644,17079,7047,9589,5836,4046,7692,17079,6946.094714,7606,9589,52910,5882,-3811,-7504,8266,58933,58792,49099,45406,61176
27115,MN,8664,17079,7047,9589,5836,4046,7882,17079,7148.162923,7606,9589,54132,6442,-3251,-6680,8826,60143,60574,50881,47452,62958
27117,MN,7644,17079,7047,9589,5836,4046,7692,17079,6845.060609,7606,9589,52809,5882,-3811,-7504,8266,58933,58691,48998,45305,61075
27119,MN,8700,17079,7047,9589,5836,4046,7888,15958,7198.679976,7606,9414,52923,5882,-3811,-7504,8266,60185,58805,49112,45419,61189
27121,MN,8376,17079,7047,9589,5836,4046,7828,17079,7047.128818,7606,9589,53743,5882,-3811,-7504,8266,59801,59625,49932,46239,62009
27123,MN,11352,17079,7047,9589,5836,4046,8381,20831,7375.489659,7606,10373,61584,8122,-1571,-4208,10506,63330,69706,60013,57376,72090
27125,MN,7644,17079,7047,9589,5836,4046,7692,17079,7173.42145,7606,9589,53137,5882,-3811,-7504,8266,58933,59019,49326,45633,61403
27127,MN,7644,17079,7047,9589,5836,4046,7692,17079,7122.904397,7606,9589,53087,5882,-3811,-7504,8266,58933,58969,49276,45583,61353
27129,MN,7644,17079,7047,9589,5836,4046,7692,17079,7173.42145,7606,9589,53137,5882,-3811,-7504,8266,58933,59019,49326,45633,61403
27131,MN,10188,17079,7047,9589,5836,4046,8165,18330,6819.802082,7606,9634,56623,7002,-2691,-5856,9386,61950,63625,53932,50767,66009
27133,MN,7644,17079,7047,9589,5836,4046,7692,17079,6794.543556,7606,9589,52759,5882,-3811,-7504,8266,58933,58641,48948,45255,61025
27135,MN,7644,17079,7047,9589,5836,4046,7692,17079,6946.094714,7606,9589,52910,5882,-3811,-7504,8266,58933,58792,49099,45406,61176
27137,MN,8304,17079,7047,9589,5836,4046,7815,16240,7072.387345,7606,9076,52344,5882,-3811,-7504,8266,59716,58226,48533,44840,60610
27139,MN,11352,17079,7047,9589,5836,4046,8381,21399,6920.836187,7606,10288,61611,8122,-1571,-4208,10506,63330,69733,60040,57403,72117
27141,MN,11352,17079,7047,9589,5836,4046,8381,18008,6617.733873,7606,10254,57883,7562,-2131,-5032,9946,63330,65445,55752,52851,67829
27143,MN,7644,17079,7047,9589,5836,4046,7692,15323,7249.197028,7606,10268,52136,5322,-4371,-8328,7706,58933,57458,47765,43808,59842
27145,MN,9024,17079,7047,9589,5836,4046,7949,16984,7072.387345,7606,9679,54411,6442,-3251,-6680,8826,60570,60853,51160,47731,63237
27147,MN,8868,17079,7047,9589,5836,4046,7920,17025,7426.006712,7606,9728,54700,6442,-3251,-6680,8826,60385,61142,51449,48020,63526
27149,MN,7644,17079,7047,9589,5836,4046,7692,17079,7021.870292,7606,9589,52986,5882,-3811,-7504,8266,58933,58868,49175,45482,61252
27151,MN,7644,17079,7047,9589,5836,4046,7692,17079,7021.870292,7606,9589,52986,5882,-3811,-7504,8266,58933,58868,49175,45482,61252
27153,MN,8580,17079,7047,9589,5836,4046,7866,17079,7047.128818,7606,9589,53947,5882,-3811,-7504,8266,60043,59829,50136,46443,62213
27155,MN,7644,17079,7047,9589,5836,4046,7692,17079,7072.387345,7606,9589,53036,5882,-3811,-7504,8266,58933,58918,49225,45532,61302
27157,MN,7644,17079,7047,9589,5836,4046,7692,16665,7426.006712,7606,10198,53585,5882,-3811,-7504,8266,58933,59467,49774,46081,61851
27159,MN,7644,17079,7047,9589,5836,4046,7692,17079,6819.802082,7606,9589,52784,5882,-3811,-7504,8266,58933,58666,48973,45280,61050
27161,MN,7740,17079,7047,9589,5836,4046,7710,17079,6946.094714,7606,9589,53006,5882,-3811,-7504,8266,59047,58888,49195,45502,61272
27163,MN,11352,17079,7047,9589,5836,4046,8381,21029,7350.231133,7606,10291,61674,8122,-1571,-4208,10506,63330,69796,60103,57466,72180
27165,MN,7644,17079,7047,9589,5836,4046,7692,17079,6895.577661,7606,9589,52860,5882,-3811,-7504,8266,58933,58742,49049,45356,61126
27167,MN,7644,17079,7047,9589,5836,4046,7692,14148,7122.904397,7606,9408,49975,5043,-4650,-8739,7427,58933,55018,45325,41236,57402
27169,MN,7692,17079,7047,9589,5836,4046,7701,16794,7779.626079,7606,9574,53492,5882,-3811,-7504,8266,58990,59374,49681,45988,61758
27171,MN,11352,17079,7047,9589,5836,4046,8381,18836,7830.143132,7606,10282,59952,7562,-2131,-5032,9946,63330,67514,57821,54920,69898
27173,MN,7644,17079,7047,9589,5836,4046,7692,17079,7122.904397,7606,9589,53087,5882,-3811,-7504,8266,58933,58969,49276,45583,61353
28001,MS,7368,6648,6898,9859,6006,4284,6024,6405,7071.197359,8498,9859,43485,5347,-6717,-11294,5360,47087,48832,36768,32191,48845
28003,MS,7368,6648,6898,9859,6006,4284,6024,6449,7145.370758,8498,9859,43603,5347,-6717,-11294,5360,47087,48950,36886,32309,48963
28005,MS,7368,6648,6898,9859,6006,4284,6024,6644,7318.442022,8498,9859,43971,5347,-6717,-11294,5360,47087,49318,37254,32677,49331
28007,MS,7368,6648,6898,9859,6006,4284,6024,6648,7639.860083,8498,9859,44297,5347,-6717,-11294,5360,47087,49644,37580,33003,49657
28009,MS,7368,6648,6898,9859,6006,4284,6024,6273,7145.370758,8498,9859,43428,5347,-6717,-11294,5360,47087,48775,36711,32134,48788
28011,MS,7464,6648,6898,9859,6006,4284,6039,6461,7293.717555,8498,9859,43859,5347,-6717,-11294,5360,47198,49206,37142,32565,49219
28013,MS,7368,6648,6898,9859,6006,4284,6024,6648,7318.442022,8498,9859,43975,5347,-6717,-11294,5360,47087,49322,37258,32681,49335
28015,MS,10656,6648,6898,9859,6006,4284,6534,6703,7268.993089,8498,9859,47269,6478,-5586,-10071,6491,50885,53747,41683,37198,53760
28017,MS,7368,6648,6898,9859,6006,4284,6024,6648,7095.921825,8498,9859,43753,5347,-6717,-11294,5360,47087,49100,37036,32459,49113
28019,MS,7368,6648,6898,9859,6006,4284,6024,6648,7392.615421,8498,9859,44050,5347,-6717,-11294,5360,47087,49397,37333,32756,49410
28021,MS,7368,6648,6898,9859,6006,4284,6024,6599,7071.197359,8498,9859,43679,5347,-6717,-11294,5360,47087,49026,36962,32385,49039
28023,MS,7368,6648,6898,9859,6006,4284,6024,6631,6997.02396,8498,9859,43637,5347,-6717,-11294,5360,47087,48984,36920,32343,48997
28025,MS,7896,6648,6898,9859,6006,4284,6106,6648,7021.748426,8498,9859,44207,5811,-6253,-10888,5824,47697,50018,37954,33319,50031
28027,MS,7680,6648,6898,9859,6006,4284,6072,6393,7095.921825,8498,9859,43809,5347,-6717,-11294,5360,47447,49156,37092,32515,49169
28029,MS,9252,6648,6898,9859,6006,4284,6316,6711,6898.126095,8498,9859,45502,6202,-5862,-10479,6215,49263,51704,39640,35023,51717
28031,MS,7368,6648,6898,9859,6006,4284,6024,6648,6997.02396,8498,9859,43654,5347,-6717,-11294,5360,47087,49001,36937,32360,49014
28033,MS,9360,6648,6898,9859,6006,4284,6333,7256,6848.677162,8498,9859,46105,6478,-5586,-10071,6491,49388,52583,40519,36034,52596
28035,MS,8616,6648,6898,9859,6006,4284,6218,7223,7293.717555,8498,9859,45773,6202,-5862,-10479,6215,48529,51975,39911,35294,51988
28037,MS,7368,6648,6898,9859,6006,4284,6024,6648,6947.575027,8498,9859,43605,5347,-6717,-11294,5360,47087,48952,36888,32311,48965
28039,MS,9816,6648,6898,9859,6006,4284,6404,6648,7021.748426,8498,9859,46127,6478,-5586,-10071,6491,49915,52605,40541,36056,52618
28041,MS,7368,6648,6898,9859,6006,4284,6024,6648,7367.890954,8498,9859,44025,5347,-6717,-11294,5360,47087,49372,37308,32731,49385
28043,MS,7368,6648,6898,9859,6006,4284,6024,6326,7367.890954,8498,9859,43702,5347,-6717,-11294,5360,47087,49049,36985,32408,49062
28045,MS,9936,6648,6898,9859,6006,4284,6422,7401,7442.064353,8498,9859,47420,6478,-5586,-10071,6491,50053,53898,41834,37349,53911
28047,MS,9936,6648,6898,9859,6006,4284,6422,7859,7170.095224,8498,9859,47606,6755,-5309,-9662,6768,50053,54361,42297,37944,54374
28049,MS,9252,6648,6898,9859,6006,4284,6316,7022,7120.646291,8498,9859,46036,6202,-5862,-10479,6215,49263,52238,40174,35557,52251
28051,MS,7368,6648,6898,9859,6006,4284,6024,6648,7837.655814,8498,9859,44495,5347,-6717,-11294,5360,47087,49842,37778,33201,49855
28053,MS,7368,6648,6898,9859,6006,4284,6024,6648,7170.095224,8498,9859,43827,5347,-6717,-11294,5360,47087,49174,37110,32533,49187
28055,MS,11640,6648,6898,9859,6006,4284,6687,6648,7120.646291,8498,9859,48050,6755,-5309,-9662,6768,52022,54805,42741,38388,54818
28057,MS,7368,6648,6898,9859,6006,4284,6024,6421,6947.575027,8498,9859,43378,5347,-6717,-11294,5360,47087,48725,36661,32084,48738
28059,MS,9816,6648,6898,9859,6006,4284,6404,7417,7590.411151,8498,9859,47464,6478,-5586,-10071,6491,49915,53942,41878,37393,53955
28061,MS,7368,6648,6898,9859,6006,4284,6024,6514,6972.299494,8498,9859,43495,5347,-6717,-11294,5360,47087,48842,36778,32201,48855
28063,MS,7368,6648,6898,9859,6006,4284,6024,6648,7095.921825,8498,9859,43753,5347,-6717,-11294,5360,47087,49100,37036,32459,49113
28065,MS,7368,6648,6898,9859,6006,4284,6024,6648,6922.850561,8498,9859,43580,5347,-6717,-11294,5360,47087,48927,36863,32286,48940
28067,MS,9852,6648,6898,9859,6006,4284,6409,6807,6947.575027,8498,9859,46247,6478,-5586,-10071,6491,49956,52725,40661,36176,52738
28069,MS,7716,6648,6898,9859,6006,4284,6078,5872,7145.370758,8498,9859,43375,5347,-6717,-11294,5360,47489,48722,36658,32081,48735
28071,MS,9792,6648,6898,9859,6006,4284,6400,7867,8307.420673,8498,9859,48608,6755,-5309,-9662,6768,49887,55363,43299,38946,55376
28073,MS,8616,6648,6898,9859,6006,4284,6218,7804,6947.575027,8498,9859,46009,6202,-5862,-10479,6215,48529,52211,40147,35530,52224
28075,MS,7368,6648,6898,9859,6006,4284,6024,7231,6997.02396,8498,9859,44237,5811,-6253,-10888,5824,47087,50048,37984,33349,50061
28077,MS,8052,6648,6898,9859,6006,4284,6130,6648,7046.472893,8498,9859,44387,5811,-6253,-10888,5824,47877,50198,38134,33499,50211
28079,MS,7440,6648,6898,9859,6006,4284,6035,6648,6774.503763,8498,9859,43504,5347,-6717,-11294,5360,47170,48851,36787,32210,48864
28081,MS,7368,6648,6898,9859,6006,4284,6024,6925,6873.401628,8498,9859,43807,5347,-6717,-11294,5360,47087,49154,37090,32513,49167
28083,MS,7368,6648,6898,9859,6006,4284,6024,6189,7417.339887,8498,9859,43615,5347,-6717,-11294,5360,47087,48962,36898,32321,48975
28085,MS,7368,6648,6898,9859,6006,4284,6024,7249,7194.81969,8498,9859,44452,5811,-6253,-10888,5824,47087,50263,38199,33564,50276
28087,MS,7944,6648,6898,9859,6006,4284,6113,6928,7343.166488,8498,9859,44856,5811,-6253,-10888,5824,47752,50667,38603,33968,50680
28089,MS,9252,6648,6898,9859,6006,4284,6316,8081,8183.798342,8498,9859,48158,6478,-5586,-10071,6491,49263,54636,42572,38087,54649
28091,MS,7368,6648,6898,9859,6006,4284,6024,6648,6997.02396,8498,9859,43654,5347,-6717,-11294,5360,47087,49001,36937,32360,49014
28093,MS,7368,6648,6898,9859,6006,4284,6024,7347,7046.472893,8498,9859,44403,5811,-6253,-10888,5824,47087,50214,38150,33515,50227
28095,MS,7512,6648,6898,9859,6006,4284,6046,6648,6848.677162,8498,9859,43650,5347,-6717,-11294,5360,47253,48997,36933,32356,49010
28097,MS,7368,6648,6898,9859,6006,4284,6024,6648,7244.268623,8498,9859,43901,5347,-6717,-11294,5360,47087,49248,37184,32607,49261
28099,MS,7368,6648,6898,9859,6006,4284,6024,6648,6997.02396,8498,9859,43654,5347,-6717,-11294,5360,47087,49001,36937,32360,49014
28101,MS,7872,6648,6898,9859,6006,4284,6102,6648,7021.748426,8498,9859,44183,5811,-6253,-10888,5824,47669,49994,37930,33295,50007
28103,MS,7368,6648,6898,9859,6006,4284,6024,6648,7293.717555,8498,9859,43951,5347,-6717,-11294,5360,47087,49298,37234,32657,49311
28105,MS,8592,6648,6898,9859,6006,4284,6214,7888,7565.686685,8498,9859,46686,6478,-5586,-10071,6491,48501,53164,41100,36615,53177
28107,MS,7536,6648,6898,9859,6006,4284,6050,6648,7194.81969,8498,9859,44020,5347,-6717,-11294,5360,47281,49367,37303,32726,49380
28109,MS,8124,6648,6898,9859,6006,4284,6141,7099,7194.81969,8498,9859,45058,5811,-6253,-10888,5824,47960,50869,38805,34170,50882
28111,MS,8616,6648,6898,9859,6006,4284,6218,7081,6997.02396,8498,9859,45336,6202,-5862,-10479,6215,48529,51538,39474,34857,51551
28113,MS,7836,6648,6898,9859,6006,4284,6097,7037,6774.503763,8498,9859,44289,5811,-6253,-10888,5824,47628,50100,38036,33401,50113
28115,MS,7368,6648,6898,9859,6006,4284,6024,6735,7293.717555,8498,9859,44038,5347,-6717,-11294,5360,47087,49385,37321,32744,49398
28117,MS,7368,6648,6898,9859,6006,4284,6024,6648,6873.401628,8498,9859,43530,5347,-6717,-11294,5360,47087,48877,36813,32236,48890
28119,MS,7368,6648,6898,9859,6006,4284,6024,6648,7021.748426,8498,9859,43679,5347,-6717,-11294,5360,47087,49026,36962,32385,49039
28121,MS,9252,6648,6898,9859,6006,4284,6316,7604,7170.095224,8498,9859,46667,6478,-5586,-10071,6491,49263,53145,41081,36596,53158
28123,MS,7944,6648,6898,9859,6006,4284,6113,6648,6922.850561,8498,9859,44156,5811,-6253,-10888,5824,47752,49967,37903,33268,49980
28125,MS,7368,6648,6898,9859,6006,4284,6024,6648,7120.646291,8498,9859,43778,5347,-6717,-11294,5360,47087,49125,37061,32484,49138
28127,MS,7368,6648,6898,9859,6006,4284,6024,6964,7071.197359,8498,9859,44044,5347,-6717,-11294,5360,47087,49391,37327,32750,49404
28129,MS,8412,6648,6898,9859,6006,4284,6186,6648,7095.921825,8498,9859,44797,5811,-6253,-10888,5824,48293,50608,38544,33909,50621
28131,MS,9936,6648,6898,9859,6006,4284,6422,6648,7442.064353,8498,9859,46667,6478,-5586,-10071,6491,50053,53145,41081,36596,53158
28133,MS,7368,6648,6898,9859,6006,4284,6024,5775,7392.615421,8498,9859,43176,4930,-7134,-11652,4943,47087,48106,36042,31524,48119
28135,MS,7368,6648,6898,9859,6006,4284,6024,6648,7268.993089,8498,9859,43926,5347,-6717,-11294,5360,47087,49273,37209,32632,49286
28137,MS,8520,6648,6898,9859,6006,4284,6203,7421,6774.503763,8498,9859,45356,6202,-5862,-10479,6215,48418,51558,39494,34877,51571
28139,MS,7368,6648,6898,9859,6006,4284,6024,6648,7343.166488,8498,9859,44000,5347,-6717,-11294,5360,47087,49347,37283,32706,49360
28141,MS,7368,6648,6898,9859,6006,4284,6024,6648,6823.952696,8498,9859,43481,5347,-6717,-11294,5360,47087,48828,36764,32187,48841
28143,MS,8328,6648,6898,9859,6006,4284,6173,7370,6898.126095,8498,9859,45237,6202,-5862,-10479,6215,48196,51439,39375,34758,51452
28145,MS,7368,6648,6898,9859,6006,4284,6024,6648,6972.299494,8498,9859,43629,5347,-6717,-11294,5360,47087,48976,36912,32335,48989
28147,MS,9192,6648,6898,9859,6006,4284,6307,6648,7071.197359,8498,9859,45552,6202,-5862,-10479,6215,49194,51754,39690,35073,51767
28149,MS,8196,6648,6898,9859,6006,4284,6152,7159,7194.81969,8498,9859,45191,5811,-6253,-10888,5824,48043,51002,38938,34303,51015
28151,MS,7392,6648,6898,9859,6006,4284,6028,6451,7021.748426,8498,9859,43505,5347,-6717,-11294,5360,47115,48852,36788,32211,48865
28153,MS,7368,6648,6898,9859,6006,4284,6024,6648,7343.166488,8498,9859,44000,5347,-6717,-11294,5360,47087,49347,37283,32706,49360
28155,MS,7368,6648,6898,9859,6006,4284,6024,6648,7392.615421,8498,9859,44050,5347,-6717,-11294,5360,47087,49397,37333,32756,49410
28157,MS,7440,6648,6898,9859,6006,4284,6035,6648,7293.717555,8498,9859,44023,5347,-6717,-11294,5360,47170,49370,37306,32729,49383
28159,MS,7368,6648,6898,9859,6006,4284,6024,6648,7244.268623,8498,9859,43901,5347,-6717,-11294,5360,47087,49248,37184,32607,49261
28161,MS,7368,6648,6898,9859,6006,4284,6024,6648,7615.135617,8498,9859,44272,5347,-6717,-11294,5360,47087,49619,37555,32978,49632
28163,MS,8028,6648,6898,9859,6006,4284,6126,7049,7664.58455,8498,9859,45383,5811,-6253,-10888,5824,47849,51194,39130,34495,51207
29001,MO,7152,11710,7047,9589,6087,4046,5264,11228,6137.821874,9022,8369,45955,3766,-7107,-11592,4970,50895,49721,38848,34363,50925
29003,MO,8940,11710,7047,9589,6087,4046,5505,11795,6415.665663,9022,9358,49577,4672,-6201,-10158,5876,52924,54249,43376,39419,55453
29005,MO,7152,11710,7047,9589,6087,4046,5264,11710,6895.577661,9022,9589,48415,4219,-6654,-10875,5423,50895,52634,41761,37540,53838
29007,MO,7884,11710,7047,9589,6087,4046,5363,10557,5935.753664,9022,9137,46582,3993,-6880,-11233,5197,51726,50575,39702,35349,51779
29009,MO,7152,11710,7047,9589,6087,4046,5264,11710,6845.060609,9022,9589,48364,4219,-6654,-10875,5423,50895,52583,41710,37489,53787
29011,MO,7152,11710,7047,9589,6087,4046,5264,11710,6339.890084,9022,9589,47859,4219,-6654,-10875,5423,50895,52078,41205,36984,53282
29013,MO,7752,11710,7047,9589,6087,4046,5345,11247,6693.509451,9022,9681,48442,4219,-6654,-10875,5423,51576,52661,41788,37567,53865
29015,MO,7260,11710,7047,9589,6087,4046,5278,11710,6466.182715,9022,9589,48093,4219,-6654,-10875,5423,51017,52312,41439,37218,53516
29017,MO,8148,11710,7047,9589,6087,4046,5398,10688,6744.026504,9022,9263,47912,4219,-6654,-10875,5423,52025,52131,41258,37037,53335
29019,MO,8292,11710,7047,9589,6087,4046,5418,13283,7299.714081,9022,9453,51396,4672,-6201,-10158,5876,52189,56068,45195,41238,57272
29021,MO,8940,11710,7047,9589,6087,4046,5505,11698,6238.855979,9022,9338,49283,4672,-6201,-10158,5876,52924,53955,43082,39125,55159
29023,MO,7260,11710,7047,9589,6087,4046,5278,10816,6112.563348,9022,8477,45733,3766,-7107,-11592,4970,51017,49499,38626,34141,50703
29025,MO,10224,11710,7047,9589,6087,4046,5679,11179,6996.611766,9022,9679,51147,4672,-6201,-10158,5876,54382,55819,44946,40989,57023
29027,MO,7416,11710,7047,9589,6087,4046,5299,11613,7122.904397,9022,9453,48673,4219,-6654,-10875,5423,51194,52892,42019,37798,54096
29029,MO,7500,11710,7047,9589,6087,4046,5311,11710,7451.265238,9022,9589,49318,4219,-6654,-10875,5423,51290,53537,42664,38443,54741
29031,MO,8148,11710,7047,9589,6087,4046,5398,11808,6567.21682,9022,9218,48809,4446,-6427,-10516,5650,52025,53255,42382,38293,54459
29033,MO,7152,11710,7047,9589,6087,4046,5264,11710,6339.890084,9022,9589,47859,4219,-6654,-10875,5423,50895,52078,41205,36984,53282
29035,MO,7152,11710,7047,9589,6087,4046,5264,11710,6137.821874,9022,9589,47657,4219,-6654,-10875,5423,50895,51876,41003,36782,53080
29037,MO,10224,11710,7047,9589,6087,4046,5679,13130,6794.543556,9022,9685,52902,5125,-5748,-9441,6329,54382,58027,47154,43461,59231
29039,MO,7152,11710,7047,9589,6087,4046,5264,11710,6365.14861,9022,9589,47884,4219,-6654,-10875,5423,50895,52103,41230,37009,53307
29041,MO,7152,11710,7047,9589,6087,4046,5264,11710,6213.597453,9022,9589,47733,4219,-6654,-10875,5423,50895,51952,41079,36858,53156
29043,MO,7800,11710,7047,9589,6087,4046,5351,11953,7274.455555,9022,9126,49222,4219,-6654,-10875,5423,51630,53441,42568,38347,54645
29045,MO,7152,11710,7047,9589,6087,4046,5264,10372,5935.753664,9022,9099,45627,3766,-7107,-11592,4970,50895,49393,38520,34035,50597
29047,MO,10224,11710,7047,9589,6087,4046,5679,13357,6895.577661,9022,9683,53227,5125,-5748,-9441,6329,54382,58352,47479,43786,59556
29049,MO,10224,11710,7047,9589,6087,4046,5679,12086,7400.748186,9022,9682,52461,5125,-5748,-9441,6329,54382,57586,46713,43020,58790
29051,MO,7668,11710,7047,9589,6087,4046,5333,12039,6769.28503,9022,9444,48988,4446,-6427,-10516,5650,51480,53434,42561,38472,54638
29053,MO,7152,11710,7047,9589,6087,4046,5264,11710,6744.026504,9022,9589,48263,4219,-6654,-10875,5423,50895,52482,41609,37388,53686
29055,MO,7152,11710,7047,9589,6087,4046,5264,11710,7375.489659,9022,9589,48894,4219,-6654,-10875,5423,50895,53113,42240,38019,54317
29056,MO,9768,11710,7047,9589,6087,4046,5617,11710,7047,9022,9589,51182,4672,-6201,-10158,5876,53864,55854,44981,41024,57058
29057,MO,7152,11710,7047,9589,6087,4046,5264,11710,6642.992399,9022,9589,48162,4219,-6654,-10875,5423,50895,52381,41508,37287,53585
29059,MO,7152,11710,7047,9589,6087,4046,5264,10646,6718.767977,9022,9144,46729,3993,-6880,-11233,5197,50895,50722,39849,35496,51926
29061,MO,7152,11710,7047,9589,6087,4046,5264,11710,6870.319135,9022,9589,48389,4219,-6654,-10875,5423,50895,52608,41735,37514,53812
29063,MO,8940,11710,7047,9589,6087,4046,5505,11742,6339.890084,9022,9339,49429,4672,-6201,-10158,5876,52924,54101,43228,39271,55305
29065,MO,7152,11710,7047,9589,6087,4046,5264,11710,6592.475346,9022,9589,48111,4219,-6654,-10875,5423,50895,52330,41457,37236,53534
29067,MO,7152,11710,7047,9589,6087,4046,5264,11710,6794.543556,9022,9589,48314,4219,-6654,-10875,5423,50895,52533,41660,37439,53737
29069,MO,7152,11710,7047,9589,6087,4046,5264,9931,5834.719559,9022,8169,44155,3540,-7333,-11950,4744,50895,47695,36822,32205,48899
29071,MO,9768,11710,7047,9589,6087,4046,5617,12261,6264.114505,9022,9537,50898,4672,-6201,-10158,5876,53864,55570,44697,40740,56774
29073,MO,7152,11710,7047,9589,6087,4046,5264,11710,6390.407136,9022,9589,47909,4219,-6654,-10875,5423,50895,52128,41255,37034,53332
29075,MO,7152,11710,7047,9589,6087,4046,5264,11710,6390.407136,9022,9589,47909,4219,-6654,-10875,5423,50895,52128,41255,37034,53332
29077,MO,7800,11710,7047,9589,6087,4046,5351,11578,6794.543556,9022,9102,48343,4219,-6654,-10875,5423,51630,52562,41689,37468,53766
29079,MO,7152,11710,7047,9589,6087,4046,5264,11710,6819.802082,9022,9589,48339,4219,-6654,-10875,5423,50895,52558,41685,37464,53762
29081,MO,7200,11710,7047,9589,6087,4046,5270,11710,6870.319135,9022,9589,48437,4219,-6654,-10875,5423,50949,52656,41783,37562,53860
29083,MO,7596,11710,7047,9589,6087,4046,5324,11710,5809.461033,9022,9589,47772,4446,-6427,-10516,5650,51399,52218,41345,37256,53422
29085,MO,7152,11710,7047,9589,6087,4046,5264,11710,6289.373032,9022,9589,47808,4219,-6654,-10875,5423,50895,52027,41154,36933,53231
29087,MO,7152,11710,7047,9589,6087,4046,5264,11710,6516.699768,9022,9589,48036,4219,-6654,-10875,5423,50895,52255,41382,37161,53459
29089,MO,8292,11710,7047,9589,6087,4046,5418,11710,6971.35324,9022,9589,49630,4446,-6427,-10516,5650,52189,54076,43203,39114,55280
29091,MO,7152,11710,7047,9589,6087,4046,5264,10920,6036.787769,9022,8408,45585,3766,-7107,-11592,4970,50895,49351,38478,33993,50555
29093,MO,7152,11710,7047,9589,6087,4046,5264,11710,6592.475346,9022,9589,48111,4219,-6654,-10875,5423,50895,52330,41457,37236,53534
29095,MO,10224,11710,7047,9589,6087,4046,5679,12919,6642.992399,9022,9687,52541,5125,-5748,-9441,6329,54382,57666,46793,43100,58870
29097,MO,7404,11710,7047,9589,6087,4046,5298,10947,6289.373032,9022,9185,46893,3993,-6880,-11233,5197,51181,50886,40013,35660,52090
29099,MO,9768,11710,7047,9589,6087,4046,5617,12670,6996.611766,9022,9535,52037,5125,-5748,-9441,6329,53864,57162,46289,42596,58366
29101,MO,8088,11710,7047,9589,6087,4046,5390,12624,6365.14861,9022,9375,49520,4672,-6201,-10158,5876,51957,54192,43319,39362,55396
29103,MO,7152,11710,7047,9589,6087,4046,5264,11710,6213.597453,9022,9589,47733,4219,-6654,-10875,5423,50895,51952,41079,36858,53156
29105,MO,7152,11710,7047,9589,6087,4046,5264,11555,5885.236612,9022,8722,46383,3993,-6880,-11233,5197,50895,50376,39503,35150,51580
29107,MO,10224,11710,7047,9589,6087,4046,5679,11510,7628.074922,9022,9683,52113,4672,-6201,-10158,5876,54382,56785,45912,41955,57989
29109,MO,7152,11710,7047,9589,6087,4046,5264,11710,6895.577661,9022,9589,48415,4219,-6654,-10875,5423,50895,52634,41761,37540,53838
29111,MO,7152,11710,7047,9589,6087,4046,5264,10821,6213.597453,9022,9266,46521,3993,-6880,-11233,5197,50895,50514,39641,35288,51718
29113,MO,9768,11710,7047,9589,6087,4046,5617,12499,6289.373032,9022,9538,51163,4672,-6201,-10158,5876,53864,55835,44962,41005,57039
29115,MO,7152,11710,7047,9589,6087,4046,5264,11710,6289.373032,9022,9589,47808,4219,-6654,-10875,5423,50895,52027,41154,36933,53231
29117,MO,7704,11710,7047,9589,6087,4046,5338,11710,6845.060609,9022,9589,48916,4446,-6427,-10516,5650,51521,53362,42489,38400,54566
29119,MO,7152,11710,7047,9589,6087,4046,5264,11322,7299.714081,9022,9489,48330,4219,-6654,-10875,5423,50895,52549,41676,37455,53753
29121,MO,7152,11710,7047,9589,6087,4046,5264,11710,6163.0804,9022,9589,47682,4219,-6654,-10875,5423,50895,51901,41028,36807,53105
29123,MO,7500,11710,7047,9589,6087,4046,5311,11710,6668.250925,9022,9589,48535,4219,-6654,-10875,5423,51290,52754,41881,37660,53958
29125,MO,7152,11710,7047,9589,6087,4046,5264,11710,6718.767977,9022,9589,48238,4219,-6654,-10875,5423,50895,52457,41584,37363,53661
29127,MO,7440,11710,7047,9589,6087,4046,5303,10861,6011.529243,9022,9141,46522,3993,-6880,-11233,5197,51222,50515,39642,35289,51719
29129,MO,7152,11710,7047,9589,6087,4046,5264,11710,6213.597453,9022,9589,47733,4219,-6654,-10875,5423,50895,51952,41079,36858,53156
29131,MO,7320,11710,7047,9589,6087,4046,5286,11710,7527.040817,9022,9589,49214,4219,-6654,-10875,5423,51085,53433,42560,38339,54637
29133,MO,7152,11710,7047,9589,6087,4046,5264,11710,6289.373032,9022,9589,47808,4219,-6654,-10875,5423,50895,52027,41154,36933,53231
29135,MO,7848,11710,7047,9589,6087,4046,5358,10994,7072.387345,9022,9458,48441,4219,-6654,-10875,5423,51685,52660,41787,37566,53864
29137,MO,7152,11710,7047,9589,6087,4046,5264,11710,5961.012191,9022,9589,47480,4219,-6654,-10875,5423,50895,51699,40826,36605,52903
29139,MO,7524,11710,7047,9589,6087,4046,5314,11710,6238.855979,9022,9589,48130,4219,-6654,-10875,5423,51317,52349,41476,37255,53553
29141,MO,7416,11710,7047,9589,6087,4046,5299,11710,7021.870292,9022,9589,48805,4219,-6654,-10875,5423,51194,53024,42151,37930,54228
29143,MO,7152,11710,7047,9589,6087,4046,5264,11710,6390.407136,9022,9589,47909,4219,-6654,-10875,5423,50895,52128,41255,37034,53332
29145,MO,7404,11710,7047,9589,6087,4046,5298,11171,6188.338927,9022,9208,47040,3993,-6880,-11233,5197,51181,51033,40160,35807,52237
29147,MO,7152,11710,7047,9589,6087,4046,5264,11413,7072.387345,9022,8700,47405,3993,-6880,-11233,5197,50895,51398,40525,36172,52602
29149,MO,7152,11710,7047,9589,6087,4046,5264,11710,6289.373032,9022,9589,47808,4219,-6654,-10875,5423,50895,52027,41154,36933,53231
29151,MO,7668,11710,7047,9589,6087,4046,5333,10612,7021.870292,9022,9463,47833,3993,-6880,-11233,5197,51480,51826,40953,36600,53030
29153,MO,7152,11710,7047,9589,6087,4046,5264,11710,6845.060609,9022,9589,48364,4219,-6654,-10875,5423,50895,52583,41710,37489,53787
29155,MO,7152,11710,7047,9589,6087,4046,5264,11710,6314.631558,9022,9589,47834,4219,-6654,-10875,5423,50895,52053,41180,36959,53257
29157,MO,7284,11710,7047,9589,6087,4046,5281,11710,6617.733873,9022,9589,48269,4219,-6654,-10875,5423,51044,52488,41615,37394,53692
29159,MO,7944,11710,7047,9589,6087,4046,5371,10918,6087.304822,9022,8795,46813,3993,-6880,-11233,5197,51794,50806,39933,35580,52010
29161,MO,7608,11710,7047,9589,6087,4046,5325,11915,6264.114505,9022,9030,47885,4219,-6654,-10875,5423,51412,52104,41231,37010,53308
29163,MO,7152,11710,7047,9589,6087,4046,5264,11710,6238.855979,9022,9589,47758,4219,-6654,-10875,5423,50895,51977,41104,36883,53181
29165,MO,10224,11710,7047,9589,6087,4046,5679,14642,8360.572183,9022,9681,55976,5578,-5295,-8724,6782,54382,61554,50681,47252,62758
29167,MO,7152,11710,7047,9589,6087,4046,5264,10665,5961.012191,9022,9134,45980,3993,-6880,-11233,5197,50895,49973,39100,34747,51177
29169,MO,8880,11710,7047,9589,6087,4046,5497,13037,6895.577661,9022,9342,51222,4672,-6201,-10158,5876,52856,55894,45021,41064,57098
29171,MO,7656,11710,7047,9589,6087,4046,5332,11710,5986.270717,9022,9589,48009,4446,-6427,-10516,5650,51467,52455,41582,37493,53659
29173,MO,7152,11710,7047,9589,6087,4046,5264,10856,6264.114505,9022,9182,46522,3993,-6880,-11233,5197,50895,50515,39642,35289,51719
29175,MO,7536,11710,7047,9589,6087,4046,5316,10920,5910.495138,9022,8590,46025,3993,-6880,-11233,5197,51331,50018,39145,34792,51222
29177,MO,10224,11710,7047,9589,6087,4046,5679,11550,6971.35324,9022,9680,51493,4672,-6201,-10158,5876,54382,56165,45292,41335,57369
29179,MO,7152,11710,7047,9589,6087,4046,5264,11710,6794.543556,9022,9589,48314,4219,-6654,-10875,5423,50895,52533,41660,37439,53737
29181,MO,7152,11710,7047,9589,6087,4046,5264,11710,6289.373032,9022,9589,47808,4219,-6654,-10875,5423,50895,52027,41154,36933,53231
29183,MO,9768,11710,7047,9589,6087,4046,5617,14163,7097.645871,9022,9530,53627,5125,-5748,-9441,6329,53864,58752,47879,44186,59956
29185,MO,7152,11710,7047,9589,6087,4046,5264,11710,6137.821874,9022,9589,47657,4219,-6654,-10875,5423,50895,51876,41003,36782,53080
29186,MO,7236,11710,7047,9589,6087,4046,5275,11710,6870.319135,9022,9589,48473,4219,-6654,-10875,5423,50990,52692,41819,37598,53896
29187,MO,7896,11710,7047,9589,6087,4046,5364,11386,6491.441241,9022,8287,47129,3993,-6880,-11233,5197,51739,51122,40249,35896,52326
29189,MO,9768,11710,7047,9589,6087,4046,5617,14195,7223.938502,9022,9524,53780,5125,-5748,-9441,6329,53864,58905,48032,44339,60109
29195,MO,7152,11710,7047,9589,6087,4046,5264,10431,5784.202507,9022,8758,45194,3766,-7107,-11592,4970,50895,48960,38087,33602,50164
29197,MO,7152,11710,7047,9589,6087,4046,5264,9948,6087.304822,9022,8480,44736,3540,-7333,-11950,4744,50895,48276,37403,32786,49480
29199,MO,7152,11710,7047,9589,6087,4046,5264,11710,6516.699768,9022,9589,48036,4219,-6654,-10875,5423,50895,52255,41382,37161,53459
29201,MO,7392,11710,7047,9589,6087,4046,5296,10717,7451.265238,9022,9177,47805,3993,-6880,-11233,5197,51167,51798,40925,36572,53002
29203,MO,7152,11710,7047,9589,6087,4046,5264,11710,6238.855979,9022,9589,47758,4219,-6654,-10875,5423,50895,51977,41104,36883,53181
29205,MO,7152,11710,7047,9589,6087,4046,5264,11710,6011.529243,9022,9589,47531,4219,-6654,-10875,5423,50895,51750,40877,36656,52954
29207,MO,7152,11710,7047,9589,6087,4046,5264,11710,7173.42145,9022,9589,48692,4219,-6654,-10875,5423,50895,52911,42038,37817,54115
29209,MO,7980,11710,7047,9589,6087,4046,5376,11923,7148.162923,9022,8577,48696,4219,-6654,-10875,5423,51835,52915,42042,37821,54119
29211,MO,7536,11710,7047,9589,6087,4046,5316,11710,6491.441241,9022,9589,48394,4219,-6654,-10875,5423,51331,52613,41740,37519,53817
29213,MO,7920,11710,7047,9589,6087,4046,5367,12830,7426.006712,9022,8540,49784,4446,-6427,-10516,5650,51766,54230,43357,39268,55434
29215,MO,7152,11710,7047,9589,6087,4046,5264,11710,6971.35324,9022,9589,48490,4219,-6654,-10875,5423,50895,52709,41836,37615,53913
29217,MO,7500,11710,7047,9589,6087,4046,5311,11710,6971.35324,9022,9589,48838,4219,-6654,-10875,5423,51290,53057,42184,37963,54261
29219,MO,9768,11710,7047,9589,6087,4046,5617,12550,6036.787769,9022,9539,50962,4672,-6201,-10158,5876,53864,55634,44761,40804,56838
29221,MO,7152,11710,7047,9589,6087,4046,5264,11710,7122.904397,9022,9589,48642,4219,-6654,-10875,5423,50895,52861,41988,37767,54065
29223,MO,7152,11710,7047,9589,6087,4046,5264,11710,6415.665663,9022,9589,47935,4219,-6654,-10875,5423,50895,52154,41281,37060,53358
29225,MO,7800,11710,7047,9589,6087,4046,5351,10835,6895.577661,9022,9126,47725,3993,-6880,-11233,5197,51630,51718,40845,36492,52922
29227,MO,7152,11710,7047,9589,6087,4046,5264,11710,6920.836187,9022,9589,48440,4219,-6654,-10875,5423,50895,52659,41786,37565,53863
29229,MO,7152,11710,7047,9589,6087,4046,5264,11710,6339.890084,9022,9589,47859,4219,-6654,-10875,5423,50895,52078,41205,36984,53282
29510,MO,9768,11710,7047,9589,6087,4046,5617,13836,6920.836187,9022,9512,53104,5125,-5748,-9441,6329,53864,58229,47356,43663,59433
30001,MT,7644,14881,8234,8509,5105,4344,5508,14881,8499.768275,9718,8509,53596,4883,-4797,-8490,7280,54225,58479,48799,45106,60876
30003,MT,7644,14881,8234,8509,5105,4344,5508,14881,8263.663601,9718,8509,53360,4883,-4797,-8490,7280,54225,58243,48563,44870,60640
30005,MT,7644,14881,8234,8509,5105,4344,5508,14881,8588.307528,9718,8509,53684,4883,-4797,-8490,7280,54225,58567,48887,45194,60964
30007,MT,7872,14881,8234,8509,5105,4344,5539,14881,8440.742107,9718,8509,53765,4883,-4797,-8490,7280,54484,58648,48968,45275,61045
30009,MT,8388,14881,8234,8509,5105,4344,5608,15564,8234.150517,9718,8422,54670,5474,-4206,-7635,7871,55069,60144,50464,47035,62541
30011,MT,7644,14881,8234,8509,5105,4344,5508,14881,8588.307528,9718,8509,53684,4883,-4797,-8490,7280,54225,58567,48887,45194,60964
30013,MT,7644,14881,8234,8509,5105,4344,5508,16741,7968.532758,9718,8153,54569,5474,-4206,-7635,7871,54225,60043,50363,46934,62440
30015,MT,7644,14881,8234,8509,5105,4344,5508,14881,8086.585095,9718,8509,53183,4883,-4797,-8490,7280,54225,58066,48386,44693,60463
30017,MT,7644,14881,8234,8509,5105,4344,5508,14881,8322.68977,9718,8509,53419,4883,-4797,-8490,7280,54225,58302,48622,44929,60699
30019,MT,7644,14881,8234,8509,5105,4344,5508,14881,9355.64772,9718,8509,54452,4883,-4797,-8490,7280,54225,59335,49655,45962,61732
30021,MT,7644,14881,8234,8509,5105,4344,5508,14881,9031.003793,9718,8509,54127,4883,-4797,-8490,7280,54225,59010,49330,45637,61407
30023,MT,7644,14881,8234,8509,5105,4344,5508,14881,8588.307528,9718,8509,53684,4883,-4797,-8490,7280,54225,58567,48887,45194,60964
30025,MT,7644,14881,8234,8509,5105,4344,5508,14881,8824.412203,9718,8509,53920,4883,-4797,-8490,7280,54225,58803,49123,45430,61200
30027,MT,7644,14881,8234,8509,5105,4344,5508,14881,8322.68977,9718,8509,53419,4883,-4797,-8490,7280,54225,58302,48622,44929,60699
30029,MT,8832,14881,8234,8509,5105,4344,5668,17927,8116.09818,9718,8166,57103,6065,-3615,-6780,8462,55573,63168,53488,50323,65565
30031,MT,8964,14881,8234,8509,5105,4344,5686,21092,8411.229022,9718,8433,60962,8666,-1014,-3651,11063,55723,69628,59948,57311,72025
30033,MT,7644,14881,8234,8509,5105,4344,5508,14881,8234.150517,9718,8509,53330,4883,-4797,-8490,7280,54225,58213,48533,44840,60610
30035,MT,7644,14881,8234,8509,5105,4344,5508,14881,8263.663601,9718,8509,53360,4883,-4797,-8490,7280,54225,58243,48563,44870,60640
30037,MT,7704,14881,8234,8509,5105,4344,5516,14104,8204.637432,9718,8430,52504,4883,-4797,-8490,7280,54293,57387,47707,44014,59784
30039,MT,7680,14881,8234,8509,5105,4344,5513,14881,8588.307528,9718,8509,53720,4883,-4797,-8490,7280,54266,58603,48923,45230,61000
30041,MT,7644,14881,8234,8509,5105,4344,5508,14881,8470.255191,9718,8509,53566,4883,-4797,-8490,7280,54225,58449,48769,45076,60846
30043,MT,8844,14881,8234,8509,5105,4344,5670,16492,8440.742107,9718,8469,56308,6065,-3615,-6780,8462,55587,62373,52693,49528,64770
30045,MT,7644,14881,8234,8509,5105,4344,5508,14881,8204.637432,9718,8509,53301,4883,-4797,-8490,7280,54225,58184,48504,44811,60581
30047,MT,7644,14881,8234,8509,5105,4344,5508,14881,9562.23931,9718,8509,54658,4883,-4797,-8490,7280,54225,59541,49861,46168,61938
30049,MT,8388,14881,8234,8509,5105,4344,5608,18350,8352.202854,9718,8460,57612,6065,-3615,-6780,8462,55069,63677,53997,50832,66074
30051,MT,7644,14881,8234,8509,5105,4344,5508,14881,8057.072011,9718,8509,53153,4883,-4797,-8490,7280,54225,58036,48356,44663,60433
30053,MT,7644,14881,8234,8509,5105,4344,5508,14881,8234.150517,9718,8509,53330,4883,-4797,-8490,7280,54225,58213,48533,44840,60610
30055,MT,7644,14881,8234,8509,5105,4344,5508,14881,9001.490708,9718,8509,54097,4883,-4797,-8490,7280,54225,58980,49300,45607,61377
30057,MT,8364,14881,8234,8509,5105,4344,5605,14881,8529.28136,9718,8509,54345,5474,-4206,-7635,7871,55042,59819,50139,46710,62216
30059,MT,7644,14881,8234,8509,5105,4344,5508,14881,8381.715938,9718,8509,53478,4883,-4797,-8490,7280,54225,58361,48681,44988,60758
30061,MT,7644,14881,8234,8509,5105,4344,5508,14881,8293.176685,9718,8509,53389,4883,-4797,-8490,7280,54225,58272,48592,44899,60669
30063,MT,10140,14881,8234,8509,5105,4344,5845,19229,8529.28136,9718,8253,60213,6656,-3024,-5925,9053,57058,66869,57189,54288,69266
30065,MT,7644,14881,8234,8509,5105,4344,5508,14881,8145.611264,9718,8509,53242,4883,-4797,-8490,7280,54225,58125,48445,44752,60522
30067,MT,8988,14881,8234,8509,5105,4344,5690,14881,8293.176685,9718,8509,54733,5474,-4206,-7635,7871,55751,60207,50527,47098,62604
30069,MT,7644,14881,8234,8509,5105,4344,5508,14881,8145.611264,9718,8509,53242,4883,-4797,-8490,7280,54225,58125,48445,44752,60522
30071,MT,7644,14881,8234,8509,5105,4344,5508,14881,8647.333697,9718,8509,53743,4883,-4797,-8490,7280,54225,58626,48946,45253,61023
30073,MT,7644,14881,8234,8509,5105,4344,5508,14881,8057.072011,9718,8509,53153,4883,-4797,-8490,7280,54225,58036,48356,44663,60433
30075,MT,7644,14881,8234,8509,5105,4344,5508,14881,8676.846781,9718,8509,53773,4883,-4797,-8490,7280,54225,58656,48976,45283,61053
30077,MT,7644,14881,8234,8509,5105,4344,5508,14881,8411.229022,9718,8509,53507,4883,-4797,-8490,7280,54225,58390,48710,45017,60787
30079,MT,7644,14881,8234,8509,5105,4344,5508,14881,9001.490708,9718,8509,54097,4883,-4797,-8490,7280,54225,58980,49300,45607,61377
30081,MT,8244,14881,8234,8509,5105,4344,5589,14881,10034.44866,9718,8509,55730,4883,-4797,-8490,7280,54906,60613,50933,47240,63010
30083,MT,7644,14881,8234,8509,5105,4344,5508,14881,9414.673888,9718,8509,54511,4883,-4797,-8490,7280,54225,59394,49714,46021,61791
30085,MT,7644,14881,8234,8509,5105,4344,5508,14881,9680.291647,9718,8509,54776,4883,-4797,-8490,7280,54225,59659,49979,46286,62056
30087,MT,7644,14881,8234,8509,5105,4344,5508,14881,8263.663601,9718,8509,53360,4883,-4797,-8490,7280,54225,58243,48563,44870,60640
30089,MT,7644,14881,8234,8509,5105,4344,5508,14881,8293.176685,9718,8509,53389,4883,-4797,-8490,7280,54225,58272,48592,44899,60669
30091,MT,7644,14881,8234,8509,5105,4344,5508,14881,9709.804731,9718,8509,54806,4883,-4797,-8490,7280,54225,59689,50009,46316,62086
30093,MT,7644,14881,8234,8509,5105,4344,5508,13773,8942.46454,9718,7550,51972,4292,-5388,-9345,6689,54225,56264,46584,42627,58661
30095,MT,7644,14881,8234,8509,5105,4344,5508,14881,8234.150517,9718,8509,53330,4883,-4797,-8490,7280,54225,58213,48533,44840,60610
30097,MT,7704,14881,8234,8509,5105,4344,5516,14881,8263.663601,9718,8509,53420,4883,-4797,-8490,7280,54293,58303,48623,44930,60700
30099,MT,7644,14881,8234,8509,5105,4344,5508,14881,8322.68977,9718,8509,53419,4883,-4797,-8490,7280,54225,58302,48622,44929,60699
30101,MT,7644,14881,8234,8509,5105,4344,5508,14881,8057.072011,9718,8509,53153,4883,-4797,-8490,7280,54225,58036,48356,44663,60433
30103,MT,7644,14881,8234,8509,5105,4344,5508,14881,8145.611264,9718,8509,53242,4883,-4797,-8490,7280,54225,58125,48445,44752,60522
30105,MT,7644,14881,8234,8509,5105,4344,5508,14881,9355.64772,9718,8509,54452,4883,-4797,-8490,7280,54225,59335,49655,45962,61732
30107,MT,7644,14881,8234,8509,5105,4344,5508,14881,8263.663601,9718,8509,53360,4883,-4797,-8490,7280,54225,58243,48563,44870,60640
30109,MT,7644,14881,8234,8509,5105,4344,5508,14881,9444.186973,9718,8509,54540,4883,-4797,-8490,7280,54225,59423,49743,46050,61820
30111,MT,8388,14881,8234,8509,5105,4344,5608,17862,8116.09818,9718,8410,56837,6065,-3615,-6780,8462,55069,62902,53222,50057,65299
31001,NE,7044,11250,7047,9589,6108,4046,6084,9811,6693.509451,9730,9366,46691,3644,-8352,-12705,3725,51168,50335,38339,33986,50416
31003,NE,7044,11250,7047,9589,6108,4046,6084,11250,6794.543556,9730,9589,48454,3928,-8068,-12289,4009,51168,52382,40386,36165,52463
31005,NE,7080,11250,7047,9589,6108,4046,6090,11250,7148.162923,9730,9589,48843,3928,-8068,-12289,4009,51210,52771,40775,36554,52852
31007,NE,7044,11250,7047,9589,6108,4046,6084,10639,7148.162923,9730,9329,47937,3644,-8352,-12705,3725,51168,51581,39585,35232,51662
31009,NE,7080,11250,7047,9589,6108,4046,6090,11250,6744.026504,9730,9589,48439,3928,-8068,-12289,4009,51210,52367,40371,36150,52448
31011,NE,7044,11250,7047,9589,6108,4046,6084,11250,6642.992399,9730,9589,48302,3928,-8068,-12289,4009,51168,52230,40234,36013,52311
31013,NE,7044,11250,7047,9589,6108,4046,6084,11250,7148.162923,9730,9589,48807,3928,-8068,-12289,4009,51168,52735,40739,36518,52816
31015,NE,7044,11250,7047,9589,6108,4046,6084,11250,6769.28503,9730,9589,48428,3928,-8068,-12289,4009,51168,52356,40360,36139,52437
31017,NE,7044,11250,7047,9589,6108,4046,6084,11250,6567.21682,9730,9589,48226,3928,-8068,-12289,4009,51168,52154,40158,35937,52235
31019,NE,7764,11250,7047,9589,6108,4046,6193,9789,7122.904397,9730,9767,48218,3928,-8068,-12289,4009,51997,52146,40150,35929,52227
31021,NE,7044,11250,7047,9589,6108,4046,6084,11250,6794.543556,9730,9589,48454,3928,-8068,-12289,4009,51168,52382,40386,36165,52463
31023,NE,7044,11250,7047,9589,6108,4046,6084,11250,7047.128818,9730,9589,48706,3928,-8068,-12289,4009,51168,52634,40638,36417,52715
31025,NE,9480,11250,7047,9589,6108,4046,6451,9789,7249.197028,9730,9813,50107,4212,-7784,-11873,4293,53971,54319,42323,38234,54400
31027,NE,7044,11250,7047,9589,6108,4046,6084,11250,6744.026504,9730,9589,48403,3928,-8068,-12289,4009,51168,52331,40335,36114,52412
31029,NE,7044,11250,7047,9589,6108,4046,6084,11250,7047.128818,9730,9589,48706,3928,-8068,-12289,4009,51168,52634,40638,36417,52715
31031,NE,7548,11250,7047,9589,6108,4046,6160,11250,6920.836187,9730,9589,49084,4212,-7784,-11873,4293,51748,53296,41300,37211,53377
31033,NE,7044,11250,7047,9589,6108,4046,6084,11250,7249.197028,9730,9589,48908,3928,-8068,-12289,4009,51168,52836,40840,36619,52917
31035,NE,7044,11250,7047,9589,6108,4046,6084,11250,6567.21682,9730,9589,48226,3928,-8068,-12289,4009,51168,52154,40158,35937,52235
31037,NE,7044,11250,7047,9589,6108,4046,6084,11250,6769.28503,9730,9589,48428,3928,-8068,-12289,4009,51168,52356,40360,36139,52437
31039,NE,7164,11250,7047,9589,6108,4046,6102,11250,6769.28503,9730,9589,48548,3928,-8068,-12289,4009,51306,52476,40480,36259,52557
31041,NE,7044,11250,7047,9589,6108,4046,6084,11250,6744.026504,9730,9589,48403,3928,-8068,-12289,4009,51168,52331,40335,36114,52412
31043,NE,8352,11250,7047,9589,6108,4046,6281,9891,6415.665663,9730,9647,48081,3928,-8068,-12289,4009,52673,52009,40013,35792,52090
31045,NE,7044,11250,7047,9589,6108,4046,6084,11250,7122.904397,9730,9589,48782,3928,-8068,-12289,4009,51168,52710,40714,36493,52791
31047,NE,7212,11250,7047,9589,6108,4046,6110,10904,6491.441241,9730,9647,48030,3928,-8068,-12289,4009,51362,51958,39962,35741,52039
31049,NE,7044,11250,7047,9589,6108,4046,6084,11250,7274.455555,9730,9589,48933,3928,-8068,-12289,4009,51168,52861,40865,36644,52942
31051,NE,8352,11250,7047,9589,6108,4046,6281,12419,6693.509451,9730,9634,50875,4496,-7500,-11457,4577,52673,55371,43375,39418,55452
31053,NE,7848,11250,7047,9589,6108,4046,6205,9812,6693.509451,9730,9323,47453,3644,-8352,-12705,3725,52093,51097,39101,34748,51178
31055,NE,9480,11250,7047,9589,6108,4046,6451,9374,6845.060609,9730,9837,49312,4212,-7784,-11873,4293,53971,53524,41528,37439,53605
31057,NE,7044,11250,7047,9589,6108,4046,6084,11250,6819.802082,9730,9589,48479,3928,-8068,-12289,4009,51168,52407,40411,36190,52488
31059,NE,7044,11250,7047,9589,6108,4046,6084,11250,6769.28503,9730,9589,48428,3928,-8068,-12289,4009,51168,52356,40360,36139,52437
31061,NE,7044,11250,7047,9589,6108,4046,6084,11250,6971.35324,9730,9589,48630,3928,-8068,-12289,4009,51168,52558,40562,36341,52639
31063,NE,7872,11250,7047,9589,6108,4046,6209,11250,6794.543556,9730,9589,49282,4212,-7784,-11873,4293,52121,53494,41498,37409,53575
31065,NE,7044,11250,7047,9589,6108,4046,6084,11250,6920.836187,9730,9589,48580,3928,-8068,-12289,4009,51168,52508,40512,36291,52589
31067,NE,7320,11250,7047,9589,6108,4046,6126,9685,6744.026504,9730,9301,46826,3644,-8352,-12705,3725,51486,50470,38474,34121,50551
31069,NE,7044,11250,7047,9589,6108,4046,6084,11250,7148.162923,9730,9589,48807,3928,-8068,-12289,4009,51168,52735,40739,36518,52816
31071,NE,7044,11250,7047,9589,6108,4046,6084,11250,6592.475346,9730,9589,48251,3928,-8068,-12289,4009,51168,52179,40183,35962,52260
31073,NE,7272,11250,7047,9589,6108,4046,6119,9349,6946.094714,9730,9640,46983,3644,-8352,-12705,3725,51431,50627,38631,34278,50708
31075,NE,7044,11250,7047,9589,6108,4046,6084,11250,7122.904397,9730,9589,48782,3928,-8068,-12289,4009,51168,52710,40714,36493,52791
31077,NE,7044,11250,7047,9589,6108,4046,6084,11250,6971.35324,9730,9589,48630,3928,-8068,-12289,4009,51168,52558,40562,36341,52639
31079,NE,7644,11250,7047,9589,6108,4046,6175,9530,6491.441241,9730,9670,47111,3644,-8352,-12705,3725,51859,50755,38759,34406,50836
31081,NE,7044,11250,7047,9589,6108,4046,6084,10238,6567.21682,9730,9658,47283,3644,-8352,-12705,3725,51168,50927,38931,34578,51008
31083,NE,7044,11250,7047,9589,6108,4046,6084,11250,6996.611766,9730,9589,48656,3928,-8068,-12289,4009,51168,52584,40588,36367,52665
31085,NE,7080,11250,7047,9589,6108,4046,6090,11250,7021.870292,9730,9589,48717,3928,-8068,-12289,4009,51210,52645,40649,36428,52726
31087,NE,7044,11250,7047,9589,6108,4046,6084,11250,6819.802082,9730,9589,48479,3928,-8068,-12289,4009,51168,52407,40411,36190,52488
31089,NE,7044,11250,7047,9589,6108,4046,6084,11250,6895.577661,9730,9589,48555,3928,-8068,-12289,4009,51168,52483,40487,36266,52564
31091,NE,7080,11250,7047,9589,6108,4046,6090,11250,7097.645871,9730,9589,48793,3928,-8068,-12289,4009,51210,52721,40725,36504,52802
31093,NE,7044,11250,7047,9589,6108,4046,6084,10370,6693.509451,9730,9656,47539,3644,-8352,-12705,3725,51168,51183,39187,34834,51264
31095,NE,7044,11250,7047,9589,6108,4046,6084,11250,6668.250925,9730,9589,48327,3928,-8068,-12289,4009,51168,52255,40259,36038,52336
31097,NE,7044,11250,7047,9589,6108,4046,6084,11250,7072.387345,9730,9589,48731,3928,-8068,-12289,4009,51168,52659,40663,36442,52740
31099,NE,7044,11250,7047,9589,6108,4046,6084,9917,6996.611766,9730,9744,47477,3644,-8352,-12705,3725,51168,51121,39125,34772,51202
31101,NE,7044,11250,7047,9589,6108,4046,6084,11250,7097.645871,9730,9589,48757,3928,-8068,-12289,4009,51168,52685,40689,36468,52766
31103,NE,7044,11250,7047,9589,6108,4046,6084,11250,6567.21682,9730,9589,48226,3928,-8068,-12289,4009,51168,52154,40158,35937,52235
31105,NE,7308,11250,7047,9589,6108,4046,6124,11250,7274.455555,9730,9589,49197,3928,-8068,-12289,4009,51472,53125,41129,36908,53206
31107,NE,7044,11250,7047,9589,6108,4046,6084,11250,6946.094714,9730,9589,48605,3928,-8068,-12289,4009,51168,52533,40537,36316,52614
31109,NE,8400,11250,7047,9589,6108,4046,6288,11624,7198.679976,9730,9601,50600,4496,-7500,-11457,4577,52728,55096,43100,39143,55177
31111,NE,7536,11250,7047,9589,6108,4046,6158,10138,6946.094714,9730,9227,47623,3644,-8352,-12705,3725,51734,51267,39271,34918,51348
31113,NE,8544,11250,7047,9589,6108,4046,6310,9454,6769.28503,9730,9303,47846,3928,-8068,-12289,4009,52894,51774,39778,35557,51855
31115,NE,7044,11250,7047,9589,6108,4046,6084,11250,6693.509451,9730,9589,48353,3928,-8068,-12289,4009,51168,52281,40285,36064,52362
31117,NE,7080,11250,7047,9589,6108,4046,6090,9853,7097.645871,9730,9308,47115,3644,-8352,-12705,3725,51210,50759,38763,34410,50840
31119,NE,7164,11250,7047,9589,6108,4046,6102,9618,6794.543556,9730,9497,46849,3644,-8352,-12705,3725,51306,50493,38497,34144,50574
31121,NE,7044,11250,7047,9589,6108,4046,6084,9592,6617.733873,9730,9658,46687,3644,-8352,-12705,3725,51168,50331,38335,33982,50412
31123,NE,7044,11250,7047,9589,6108,4046,6084,11250,7198.679976,9730,9589,48858,3928,-8068,-12289,4009,51168,52786,40790,36569,52867
31125,NE,7044,11250,7047,9589,6108,4046,6084,11250,6870.319135,9730,9589,48529,3928,-8068,-12289,4009,51168,52457,40461,36240,52538
31127,NE,7044,11250,7047,9589,6108,4046,6084,11250,6516.699768,9730,9589,48176,3928,-8068,-12289,4009,51168,52104,40108,35887,52185
31129,NE,7044,11250,7047,9589,6108,4046,6084,11250,6642.992399,9730,9589,48302,3928,-8068,-12289,4009,51168,52230,40234,36013,52311
31131,NE,7164,11250,7047,9589,6108,4046,6102,11250,6845.060609,9730,9589,48624,3928,-8068,-12289,4009,51306,52552,40556,36335,52633
31133,NE,7044,11250,7047,9589,6108,4046,6084,11250,6718.767977,9730,9589,48378,3928,-8068,-12289,4009,51168,52306,40310,36089,52387
31135,NE,7044,11250,7047,9589,6108,4046,6084,11250,7097.645871,9730,9589,48757,3928,-8068,-12289,4009,51168,52685,40689,36468,52766
31137,NE,7044,11250,7047,9589,6108,4046,6084,11250,6946.094714,9730,9589,48605,3928,-8068,-12289,4009,51168,52533,40537,36316,52614
31139,NE,7044,11250,7047,9589,6108,4046,6084,10349,6769.28503,9730,9511,47449,3644,-8352,-12705,3725,51168,51093,39097,34744,51174
31141,NE,7044,11250,7047,9589,6108,4046,6084,13132,6895.577661,9730,9730,50578,4496,-7500,-11457,4577,51168,55074,43078,39121,55155
31143,NE,7044,11250,7047,9589,6108,4046,6084,11250,6895.577661,9730,9589,48555,3928,-8068,-12289,4009,51168,52483,40487,36266,52564
31145,NE,7044,11250,7047,9589,6108,4046,6084,11250,6617.733873,9730,9589,48277,3928,-8068,-12289,4009,51168,52205,40209,35988,52286
31147,NE,7044,11250,7047,9589,6108,4046,6084,11250,6769.28503,9730,9589,48428,3928,-8068,-12289,4009,51168,52356,40360,36139,52437
31149,NE,7092,11250,7047,9589,6108,4046,6092,11250,6516.699768,9730,9589,48224,3928,-8068,-12289,4009,51224,52152,40156,35935,52233
31151,NE,8292,11250,7047,9589,6108,4046,6272,11250,7072.387345,9730,9589,49979,4212,-7784,-11873,4293,52604,54191,42195,38106,54272
31153,NE,9480,11250,7047,9589,6108,4046,6451,9733,6920.836187,9730,9825,49734,4212,-7784,-11873,4293,53971,53946,41950,37861,54027
31155,NE,8796,11250,7047,9589,6108,4046,6348,9706,7223.938502,9730,9808,49310,4212,-7784,-11873,4293,53184,53522,41526,37437,53603
31157,NE,7560,11250,7047,9589,6108,4046,6162,10164,6971.35324,9730,9259,47730,3644,-8352,-12705,3725,51762,51374,39378,35025,51455
31159,NE,7044,11250,7047,9589,6108,4046,6084,10067,7122.904397,9730,9599,47609,3644,-8352,-12705,3725,51168,51253,39257,34904,51334
31161,NE,7044,11250,7047,9589,6108,4046,6084,11250,7350.231133,9730,9589,49009,3928,-8068,-12289,4009,51168,52937,40941,36720,53018
31163,NE,7044,11250,7047,9589,6108,4046,6084,11250,6718.767977,9730,9589,48378,3928,-8068,-12289,4009,51168,52306,40310,36089,52387
31165,NE,7044,11250,7047,9589,6108,4046,6084,12949,7148.162923,9730,9331,50248,4496,-7500,-11457,4577,51168,54744,42748,38791,54825
31167,NE,7044,11250,7047,9589,6108,4046,6084,13739,6819.802082,9730,9508,50887,4496,-7500,-11457,4577,51168,55383,43387,39430,55464
31169,NE,7044,11250,7047,9589,6108,4046,6084,11250,6567.21682,9730,9589,48226,3928,-8068,-12289,4009,51168,52154,40158,35937,52235
31171,NE,7188,11250,7047,9589,6108,4046,6106,11250,6870.319135,9730,9589,48673,3928,-8068,-12289,4009,51334,52601,40605,36384,52682
31173,NE,7044,11250,7047,9589,6108,4046,6084,11250,6642.992399,9730,9589,48302,3928,-8068,-12289,4009,51168,52230,40234,36013,52311
31175,NE,7044,11250,7047,9589,6108,4046,6084,11250,6693.509451,9730,9589,48353,3928,-8068,-12289,4009,51168,52281,40285,36064,52362
31177,NE,9480,11250,7047,9589,6108,4046,6451,9666,6946.094714,9730,9814,49681,4212,-7784,-11873,4293,53971,53893,41897,37808,53974
31179,NE,7044,11250,7047,9589,6108,4046,6084,11250,6718.767977,9730,9589,48378,3928,-8068,-12289,4009,51168,52306,40310,36089,52387
31181,NE,7044,11250,7047,9589,6108,4046,6084,11250,6693.509451,9730,9589,48353,3928,-8068,-12289,4009,51168,52281,40285,36064,52362
31183,NE,7044,11250,7047,9589,6108,4046,6084,11250,6794.543556,9730,9589,48454,3928,-8068,-12289,4009,51168,52382,40386,36165,52463
31185,NE,7200,11250,7047,9589,6108,4046,6108,11250,6567.21682,9730,9589,48382,3928,-8068,-12289,4009,51348,52310,40314,36093,52391
32001,NV,9780,10841,8234,8509,6190,4344,5194,12538,9060.516877,8050,8346,52119,-2761,-6347,-10304,5730,53092,49358,45772,41815,57849
32003,NV,12456,10841,8234,8509,6190,4344,5502,12752,8411.229022,8050,8676,54689,-1806,-5392,-8821,6685,56076,52883,49297,45868,61374
32005,NV,11688,10841,8234,8509,6190,4344,5414,14309,8322.68977,8050,8582,55296,-1806,-5392,-8821,6685,55220,53490,49904,46475,61981
32007,NV,10560,10841,8234,8509,6190,4344,5284,9985,9060.516877,8050,9382,51381,-2761,-6347,-10304,5730,53962,48620,45034,41077,57111
32009,NV,7644,10841,8234,8509,6190,4344,4948,10841,10182.01408,8050,8509,49570,-3477,-7063,-11416,5014,50710,46093,42507,38154,54584
32011,NV,9936,10841,8234,8509,6190,4344,5212,12313,8765.386034,8050,9290,52698,-2284,-5870,-9563,6207,53266,50414,46828,43135,58905
32013,NV,8328,10841,8234,8509,6190,4344,5026,11006,8175.124348,8050,8637,48539,-3239,-6824,-11045,5253,51472,45300,41715,37494,53792
32015,NV,9036,10841,8234,8509,6190,4344,5108,10841,8824.412203,8050,8509,49604,-2999,-6585,-10674,5492,52262,46605,43019,38930,55096
32017,NV,9384,10841,8234,8509,6190,4344,5148,10841,8352.202854,8050,8509,49480,-2999,-6585,-10674,5492,52650,46481,42895,38806,54972
32019,NV,9420,10841,8234,8509,6190,4344,5152,12467,8263.663601,8050,8130,50674,-2761,-6347,-10304,5730,52690,47913,44327,40370,56404
32021,NV,10668,10841,8234,8509,6190,4344,5296,10841,8647.333697,8050,8509,51059,-2761,-6347,-10304,5730,54082,48298,44712,40755,56789
32023,NV,9816,10841,8234,8509,6190,4344,5198,10506,8175.124348,8050,7379,48271,-3239,-6824,-11045,5253,53132,45032,41447,37226,53524
32027,NV,7644,10841,8234,8509,6190,4344,4948,10841,8529.28136,8050,8509,47917,-3477,-7063,-11416,5014,50710,44440,40854,36501,52931
32029,NV,11052,10841,8234,8509,6190,4344,5340,12478,8558.794444,8050,8502,52985,-2284,-5870,-9563,6207,54510,50701,47115,43422,59192
32031,NV,11052,10841,8234,8509,6190,4344,5340,12598,8529.28136,8050,8501,53074,-2284,-5870,-9563,6207,54510,50790,47204,43511,59281
32033,NV,9120,10841,8234,8509,6190,4344,5118,10841,8027.558927,8050,8509,48892,-2999,-6585,-10674,5492,52356,45893,42307,38218,54384
32510,NV,10428,10841,8234,8509,6190,4344,5268,11362,9503.213141,8050,8215,51902,-2761,-6347,-10304,5730,53814,49141,45555,41598,57632
33001,NH,11352,7670,8011,7901,6227,3987,7594,6735,9102.270328,8075,7886,47137,-2356,-6685,-11170,5392,52742,44781,40452,35967,52529
33003,NH,12156,7670,8011,7901,6227,3987,7726,7670,10308.24936,8075,7901,50097,-2094,-6423,-10776,5654,53678,48003,43674,39321,55751
33005,NH,11664,7670,8011,7901,6227,3987,7645,6904,8757.70489,8075,7798,47186,-2356,-6685,-11170,5392,53105,44830,40501,36016,52578
33007,NH,7884,7670,8011,7901,6227,3987,7021,6900,8929.987609,8075,7193,42969,-3844,-8174,-12692,3903,48701,39125,34795,30277,46872
33009,NH,12192,7670,8011,7901,6227,3987,7732,8313,9303.266834,8075,7739,49609,-1833,-6162,-10383,5915,53720,47776,43447,39226,55524
33011,NH,13414,7670,8011,7901,6227,3987,7934,6507,8614.135957,8075,8548,49145,-1833,-6162,-10383,5915,55144,47312,42983,38762,55060
33013,NH,12024,7670,8011,7901,6227,3987,7705,6634,8815.132463,8075,8353,47888,-2094,-6423,-10776,5654,53525,45794,41465,37112,53542
33015,NH,13506,7670,8011,7901,6227,3987,7949,6751,8872.560036,8075,8549,49741,-1833,-6162,-10383,5915,55251,47908,43579,39358,55656
33017,NH,12780,7670,8011,7901,6227,3987,7830,8828,8700.277317,8075,8570,50941,-1288,-5617,-9574,6460,54406,49653,45324,41367,57401
33019,NH,11004,7670,8011,7901,6227,3987,7536,9483,8183.429159,8075,7739,48471,-1833,-6162,-10383,5915,52336,46638,42309,38088,54386
34001,NJ,13668,6903,8011,7901,6118,3987,6325,7075,8499.280811,9959,7976,51165,5742,-5730,-9687,6347,52913,56907,45435,41478,57512
34003,NJ,16824,6903,8011,7901,6118,3987,6744,9040,9504.26334,9959,8623,57938,7101,-4371,-7536,7706,56488,65039,53567,50402,65644
34005,NJ,13620,6903,8011,7901,6118,3987,6318,8626,8097.2878,9959,8337,52627,6195,-5277,-8970,6800,52858,58822,47350,43657,59427
34007,NJ,13620,6903,8011,7901,6118,3987,6318,6144,8642.849744,9959,8358,50711,5742,-5730,-9687,6347,52858,56453,44981,41024,57058
34009,NJ,12300,6903,8011,7901,6118,3987,6143,7113,9733.973632,9959,7526,50619,5289,-6183,-10404,5894,51363,55908,44436,40215,56513
34011,NJ,12852,6903,8011,7901,6118,3987,6217,6892,7724.008575,9959,7883,49297,5516,-5956,-10045,6121,51989,54813,43341,39252,55418
34013,NJ,15180,6903,8011,7901,6118,3987,6525,6353,9992.39771,9959,8677,54149,6195,-5277,-8970,6800,54625,60344,48872,45179,60949
34015,NJ,13620,6903,8011,7901,6118,3987,6318,6178,7982.432654,9959,8334,50060,5742,-5730,-9687,6347,52858,55802,44330,40373,56407
34017,NJ,15492,6903,8011,7901,6118,3987,6567,6156,8527.994598,9959,8874,52995,6195,-5277,-8970,6800,54979,59190,47718,44025,59795
34019,NJ,17496,6903,8011,7901,6118,3987,6833,7945,10164.68043,9959,8497,58049,6648,-4824,-8253,7253,57249,64697,53225,49796,65302
34021,NJ,14700,6903,8011,7901,6118,3987,6462,6226,8700.277317,9959,8631,52203,5742,-5730,-9687,6347,54082,57945,46473,42516,58550
34023,NJ,17496,6903,8011,7901,6118,3987,6833,7233,8298.284306,9959,8566,55540,6648,-4824,-8253,7253,57249,62188,50716,47287,62793
34025,NJ,16140,6903,8011,7901,6118,3987,6653,7112,8757.70489,9959,8533,54489,6195,-5277,-8970,6800,55713,60684,49212,45519,61289
34027,NJ,15180,6903,8011,7901,6118,3987,6525,6572,9217.125474,9959,8529,53444,6195,-5277,-8970,6800,54625,59639,48167,44474,60244
34029,NJ,16140,6903,8011,7901,6118,3987,6653,6181,8441.853238,9959,8512,53221,6195,-5277,-8970,6800,55713,59416,47944,44251,60021
34031,NJ,16824,6903,8011,7901,6118,3987,6744,6151,8326.998092,9959,8615,53863,6195,-5277,-8970,6800,56488,60058,48586,44893,60663
34033,NJ,13620,6903,8011,7901,6118,3987,6318,9098,9331.98062,9959,8318,54314,6195,-5277,-8970,6800,52858,60509,49037,45344,61114
34035,NJ,17496,6903,8011,7901,6118,3987,6833,5979,9102.270328,9959,8532,55055,6195,-5277,-8970,6800,57249,61250,49778,46085,61855
34037,NJ,15180,6903,8011,7901,6118,3987,6525,6328,9619.118486,9959,8496,53569,5742,-5730,-9687,6347,54625,59311,47839,43882,59916
34039,NJ,15180,6903,8011,7901,6118,3987,6525,6088,8183.429159,9959,8609,52007,5742,-5730,-9687,6347,54625,57749,46277,42320,58354
34041,NJ,14052,6903,8011,7901,6118,3987,6376,6415,9389.408193,9959,7955,51757,5742,-5730,-9687,6347,53348,57499,46027,42070,58104
35001,NM,9624,13449,8234,8509,5630,4344,6223,16597,7968.532758,5914,8343,52791,8428,-2916,-6609,9161,56013,61219,49875,46182,61952
35003,NM,7644,13449,8234,8509,5630,4344,5931,13449,8204.637432,5914,8509,48065,7322,-4022,-8243,8055,53741,55387,44043,39822,56120
35005,NM,7740,13449,8234,8509,5630,4344,5945,15792,7791.454252,5914,7817,49398,7599,-3745,-7834,8332,53851,56997,45653,41564,57730
35006,NM,7644,13449,8234,8509,5630,4344,5931,13679,7732.428084,5914,7902,47215,7046,-4298,-8651,7779,53741,54261,42917,38564,54994
35007,NM,8136,13449,8234,8509,5630,4344,6003,13449,9296.621551,5914,8509,49649,7322,-4022,-8243,8055,54305,56971,45627,41406,57704
35009,NM,8028,13449,8234,8509,5630,4344,5988,14522,8499.768275,5914,8016,49324,7599,-3745,-7834,8332,54182,56923,45579,41490,57656
35011,NM,7644,13449,8234,8509,5630,4344,5931,13449,8175.124348,5914,8509,48035,7322,-4022,-8243,8055,53741,55357,44013,39792,56090
35013,NM,8832,13449,8234,8509,5630,4344,6106,13097,8086.585095,5914,7960,48234,7322,-4022,-8243,8055,55104,55556,44212,39991,56289
35015,NM,8844,13449,8234,8509,5630,4344,6108,15480,8676.846781,5914,8483,51742,7875,-3469,-7426,8608,55118,59617,48273,44316,60350
35017,NM,7644,13449,8234,8509,5630,4344,5931,16215,8470.255191,5914,7337,49924,7599,-3745,-7834,8332,53741,57523,46179,42090,58256
35019,NM,7644,13449,8234,8509,5630,4344,5931,13449,8086.585095,5914,8509,47947,7322,-4022,-8243,8055,53741,55269,43925,39704,56002
35021,NM,7644,13449,8234,8509,5630,4344,5931,13449,9031.003793,5914,8509,48891,7322,-4022,-8243,8055,53741,56213,44869,40648,56946
35023,NM,7644,13449,8234,8509,5630,4344,5931,13449,8234.150517,5914,8509,48094,7322,-4022,-8243,8055,53741,55416,44072,39851,56149
35025,NM,9492,13449,8234,8509,5630,4344,6203,14134,8676.846781,5914,8713,51273,7875,-3469,-7426,8608,55861,59148,47804,43847,59881
35027,NM,10668,13449,8234,8509,5630,4344,6376,13449,8381.715938,5914,8509,51266,7875,-3469,-7426,8608,57210,59141,47797,43840,59874
35028,NM,13104,13449,8234,8509,5630,4344,6735,15598,8588.307528,5914,10340,57888,9534,-1810,-4975,10267,60005,67422,56078,52913,68155
35029,NM,7644,13449,8234,8509,5630,4344,5931,13202,8057.072011,5914,7366,46527,6769,-4575,-9060,7502,53741,53296,41952,37467,54029
35031,NM,7644,13449,8234,8509,5630,4344,5931,15122,7761.941168,5914,8236,49022,7599,-3745,-7834,8332,53741,56621,45277,41188,57354
35033,NM,8028,13449,8234,8509,5630,4344,5988,13449,8706.359865,5914,8509,48950,7322,-4022,-8243,8055,54182,56272,44928,40707,57005
35035,NM,7644,13449,8234,8509,5630,4344,5931,15008,8440.742107,5914,7674,49025,7322,-4022,-8243,8055,53741,56347,45003,40782,57080
35037,NM,8112,13449,8234,8509,5630,4344,6000,13449,8116.09818,5914,8509,48444,7322,-4022,-8243,8055,54278,55766,44422,40201,56499
35039,NM,8880,13449,8234,8509,5630,4344,6113,15495,8204.637432,5914,8141,50979,7875,-3469,-7426,8608,55159,58854,47510,43553,59587
35041,NM,8532,13449,8234,8509,5630,4344,6062,15990,7939.019674,5914,7911,50630,7875,-3469,-7426,8608,54760,58505,47161,43204,59238
35043,NM,9624,13449,8234,8509,5630,4344,6223,13514,8647.333697,5914,8367,50410,7599,-3745,-7834,8332,56013,58009,46665,42576,58742
35045,NM,8820,13449,8234,8509,5630,4344,6104,14127,7939.019674,5914,8684,49829,7875,-3469,-7426,8608,55090,57704,46360,42403,58437
35047,NM,7908,13449,8234,8509,5630,4344,5970,16581,8529.28136,5914,7029,50305,7875,-3469,-7426,8608,54044,58180,46836,42879,58913
35049,NM,11484,13449,8234,8509,5630,4344,6496,13745,8499.768275,5914,8186,52173,7875,-3469,-7426,8608,58146,60048,48704,44747,60781
35051,NM,8004,13449,8234,8509,5630,4344,5984,13449,7702.915,5914,8509,47923,7322,-4022,-8243,8055,54154,55245,43901,39680,55978
35053,NM,7644,13449,8234,8509,5630,4344,5931,13449,8027.558927,5914,8509,47888,7322,-4022,-8243,8055,53741,55210,43866,39645,55943
35055,NM,10824,13449,8234,8509,5630,4344,6399,14516,10063.96174,5914,7345,53007,7875,-3469,-7426,8608,57389,60882,49538,45581,61615
35057,NM,9624,13449,8234,8509,5630,4344,6223,14470,8086.585095,5914,8368,50807,7875,-3469,-7426,8608,56013,58682,47338,43381,59415
35059,NM,8004,13449,8234,8509,5630,4344,5984,13449,8322.68977,5914,8509,48543,7322,-4022,-8243,8055,54154,55865,44521,40300,56598
35061,NM,9624,13449,8234,8509,5630,4344,6223,13511,7909.50659,5914,8368,49671,7599,-3745,-7834,8332,56013,57270,45926,41837,58003
36001,NY,11148,6648,8011,7901,5859,3987,7542,7072,9245.839261,11039,8201,50693,5438,-6639,-10728,5438,51096,56131,44054,39965,56131
36003,NY,7644,6648,8011,7901,5859,3987,6981,6648,8901.273823,11039,7901,46120,4392,-7685,-12302,4392,47031,50512,38435,33818,50512
36005,NY,17280,6648,8011,7901,5859,3987,8525,7166,8987.415182,11039,9007,57466,7268,-4809,-7974,7268,58211,64734,52657,49492,64734
36007,NY,8304,6648,8011,7901,5859,3987,7087,7148,7781.436148,11039,7551,45811,4653,-7424,-11909,4653,47797,50464,38387,33902,50464
36009,NY,7944,6648,8011,7901,5859,3987,7029,7372,7350.72935,11039,7413,45106,4392,-7685,-12302,4392,47379,49498,37421,32804,49498
36011,NY,8952,6648,8011,7901,5859,3987,7191,6943,7580.439642,11039,7690,46192,4653,-7424,-11909,4653,48549,50845,38768,34283,50845
36013,NY,7644,6648,8011,7901,5859,3987,6981,7250,7408.156923,11039,7317,44645,4392,-7685,-12302,4392,47031,49037,36960,32343,49037
36015,NY,9444,6648,8011,7901,5859,3987,7269,8328,7121.019058,11039,7486,47405,5176,-6901,-11122,5176,49119,52581,40504,36283,52581
36017,NY,7644,6648,8011,7901,5859,3987,6981,6648,8585.422171,11039,7901,45804,4392,-7685,-12302,4392,47031,50196,38119,33502,50196
36019,NY,9768,6648,8011,7901,5859,3987,7321,7450,7838.863721,11039,7501,47585,4915,-7162,-11515,4915,49495,52500,40423,36070,52500
36021,NY,10752,6648,8011,7901,5859,3987,7479,7419,8011.14644,11039,7748,48956,5176,-6901,-11122,5176,50637,54132,42055,37834,54132
36023,NY,8988,6648,8011,7901,5859,3987,7196,8349,7609.153429,11039,7699,47672,5176,-6901,-11122,5176,48590,52848,40771,36550,52848
36025,NY,8004,6648,8011,7901,5859,3987,7039,6648,9820.114991,11039,7901,47399,4392,-7685,-12302,4392,47449,51791,39714,35097,51791
36027,NY,15096,6648,8011,7901,5859,3987,8175,6773,8901.273823,11039,8497,54293,6222,-5855,-9548,6222,55677,60515,48438,44745,60515
36029,NY,8520,6648,8011,7901,5859,3987,7121,7822,7925.005081,11039,7602,46895,4653,-7424,-11909,4653,48047,51548,39471,34986,51548
36031,NY,9804,6648,8011,7901,5859,3987,7327,6648,7695.294789,11039,7901,47074,4915,-7162,-11515,4915,49537,51989,39912,35559,51989
36033,NY,8592,6648,8011,7901,5859,3987,7133,8833,6891.308766,11039,7285,46627,4915,-7162,-11515,4915,48131,51542,39465,35112,51542
36035,NY,8496,6648,8011,7901,5859,3987,7118,7790,7609.153429,11039,7394,46315,4653,-7424,-11909,4653,48020,50968,38891,34406,50968
36037,NY,9180,6648,8011,7901,5859,3987,7227,7859,7494.298283,11039,7801,47360,4915,-7162,-11515,4915,48813,52275,40198,35845,52275
36039,NY,9372,6648,8011,7901,5859,3987,7258,6648,9102.270328,11039,7901,48049,4653,-7424,-11909,4653,49036,52702,40625,36140,52702
36041,NY,7800,6648,8011,7901,5859,3987,7006,6648,8355.711879,11039,7901,45731,4392,-7685,-12302,4392,47212,50123,38046,33429,50123
36043,NY,9348,6648,8011,7901,5859,3987,7254,7842,7322.015564,11039,7545,47083,4915,-7162,-11515,4915,49008,51998,39921,35568,51998
36045,NY,12144,6648,8011,7901,5859,3987,7702,7776,7494.298283,11039,7639,50079,5699,-6378,-10335,5699,52252,55778,43701,39744,55778
36047,NY,17280,6648,8011,7901,5859,3987,8525,7079,8987.415182,11039,9091,57464,7268,-4809,-7974,7268,58211,64732,52655,49490,64732
36049,NY,7980,6648,8011,7901,5859,3987,7035,6648,8097.2878,11039,7901,45652,4392,-7685,-12302,4392,47421,50044,37967,33350,50044
36051,NY,10008,6648,8011,7901,5859,3987,7360,8012,7695.294789,11039,7766,48508,5176,-6901,-11122,5176,49774,53684,41607,37386,53684
36053,NY,9612,6648,8011,7901,5859,3987,7296,7026,7896.291294,11039,7778,47338,4915,-7162,-11515,4915,49314,52253,40176,35823,52253
36055,NY,10008,6648,8011,7901,5859,3987,7360,6652,7925.005081,11039,7739,47350,4915,-7162,-11515,4915,49774,52265,40188,35835,52265
36057,NY,8880,6648,8011,7901,5859,3987,7179,7453,7724.008575,11039,7492,46576,4653,-7424,-11909,4653,48465,51229,39152,34667,51229
36059,NY,19356,6648,8011,7901,5859,3987,8857,6748,9532.977126,11039,8574,59237,7268,-4809,-7974,7268,60619,66505,54428,51263,66505
36061,NY,17280,6648,8011,7901,5859,3987,8525,6987,12547.92471,11039,9675,61515,7268,-4809,-7974,7268,58211,68783,56706,53541,68783
36063,NY,8520,6648,8011,7901,5859,3987,7121,6762,7465.584496,11039,7630,45403,4392,-7685,-12302,4392,48047,49795,37718,33101,49795
36065,NY,9348,6648,8011,7901,5859,3987,7254,7129,7838.863721,11039,7521,46863,4915,-7162,-11515,4915,49008,51778,39701,35348,51778
36067,NY,9612,6648,8011,7901,5859,3987,7296,6815,7838.863721,11039,7755,47047,4915,-7162,-11515,4915,49314,51962,39885,35532,51962
36069,NY,10008,6648,8011,7901,5859,3987,7360,6997,7666.581002,11039,7758,47456,4915,-7162,-11515,4915,49774,52371,40294,35941,52371
36071,NY,15096,6648,8011,7901,5859,3987,8175,7017,8470.567025,11039,8501,54110,6222,-5855,-9548,6222,55677,60332,48255,44562,60332
36073,NY,10008,6648,8011,7901,5859,3987,7360,6842,6833.881193,11039,7763,46473,4915,-7162,-11515,4915,49774,51388,39311,34958,51388
36075,NY,9612,6648,8011,7901,5859,3987,7296,7156,7207.160418,11039,7771,46771,4915,-7162,-11515,4915,49314,51686,39609,35256,51686
36077,NY,10128,6648,8011,7901,5859,3987,7379,7557,8068.574013,11039,7530,48309,5176,-6901,-11122,5176,49913,53485,41408,37187,53485
36079,NY,17280,6648,8011,7901,5859,3987,8525,7241,10365.67694,11039,8480,58392,7268,-4809,-7974,7268,58211,65660,53583,50418,65660
36081,NY,17280,6648,8011,7901,5859,3987,8525,8516,8786.418676,11039,8888,58496,7268,-4809,-7974,7268,58211,65764,53687,50522,65764
36083,NY,11148,6648,8011,7901,5859,3987,7542,7658,8987.415182,11039,8195,51015,5699,-6378,-10335,5699,51096,56714,44637,40680,56714
36085,NY,17280,6648,8011,7901,5859,3987,8525,7448,9159.697901,11039,8668,57581,7268,-4809,-7974,7268,58211,64849,52772,49607,64849
36087,NY,17280,6648,8011,7901,5859,3987,8525,7029,8441.853238,11039,8530,56307,6745,-5332,-8761,6745,58211,63052,50975,47546,63052
36089,NY,8688,6648,8011,7901,5859,3987,7148,7427,7408.156923,11039,7325,45875,4653,-7424,-11909,4653,48242,50528,38451,33966,50528
36091,NY,11148,6648,8011,7901,5859,3987,7542,7024,9217.125474,11039,8191,50605,5438,-6639,-10728,5438,51096,56043,43966,39877,56043
36093,NY,11148,6648,8011,7901,5859,3987,7542,8056,8556.708384,11039,8201,50988,5699,-6378,-10335,5699,51096,56687,44610,40653,56687
36095,NY,11148,6648,8011,7901,5859,3987,7542,8314,8527.994598,11039,8201,51217,5699,-6378,-10335,5699,51096,56916,44839,40882,56916
36097,NY,7716,6648,8011,7901,5859,3987,6993,6648,7523.012069,11039,7901,44814,4392,-7685,-12302,4392,47115,49206,37129,32512,49206
36099,NY,8520,6648,8011,7901,5859,3987,7121,8121,6747.739833,11039,7526,45940,4915,-7162,-11515,4915,48047,50855,38778,34425,50855
36101,NY,8124,6648,8011,7901,5859,3987,7058,6256,7293.301777,11039,7469,44168,4016,-8061,-12696,4016,47588,48184,36107,31472,48184
36103,NY,19356,6648,8011,7901,5859,3987,8857,7559,9217.125474,11039,8515,59673,7791,-4286,-7187,7791,60619,67464,55387,52486,67464
36105,NY,10884,6648,8011,7901,5859,3987,7500,6648,7207.160418,11039,7901,47666,5176,-6901,-11122,5176,50790,52842,40765,36544,52842
36107,NY,8304,6648,8011,7901,5859,3987,7087,6571,8929.987609,11039,7580,46411,4392,-7685,-12302,4392,47797,50803,38726,34109,50803
36109,NY,13560,6648,8011,7901,5859,3987,7929,6358,8757.70489,11039,7580,51281,5699,-6378,-10335,5699,53895,56980,44903,40946,56980
36111,NY,12744,6648,8011,7901,5859,3987,7798,6893,8614.135957,11039,7812,51090,5699,-6378,-10335,5699,52948,56789,44712,40755,56789
36113,NY,12180,6648,8011,7901,5859,3987,7708,5800,8470.567025,11039,7681,49157,5176,-6901,-11122,5176,52294,54333,42256,38035,54333
36115,NY,12180,6648,8011,7901,5859,3987,7708,7363,9820.114991,11039,7691,52080,5699,-6378,-10335,5699,52294,57779,45702,41745,57779
36117,NY,10008,6648,8011,7901,5859,3987,7360,6977,7350.72935,11039,7764,47125,4915,-7162,-11515,4915,49774,52040,39963,35610,52040
36119,NY,17388,6648,8011,7901,5859,3987,8542,7919,9217.125474,11039,8588,58138,7268,-4809,-7974,7268,58336,65406,53329,50164,65406
36121,NY,8124,6648,8011,7901,5859,3987,7058,6648,8929.987609,11039,7901,46629,4392,-7685,-12302,4392,47588,51021,38944,34327,51021
36123,NY,7908,6648,8011,7901,5859,3987,7023,7327,6460.601968,11039,7763,44485,4653,-7424,-11909,4653,47337,49138,37061,32576,49138
37001,NC,8208,12324,6898,9859,6322,4284,7197,10983,6898.126095,12086,9378,51837,6020,-5978,-9935,6099,55092,57857,45859,41902,57936
37003,NC,7644,12324,6898,9859,6322,4284,7100,10936,6898.126095,12086,9357,51205,6020,-5978,-9935,6099,54431,57225,45227,41270,57304
37005,NC,7644,12324,6898,9859,6322,4284,7100,12324,6823.952696,12086,9859,53021,6375,-5623,-9316,6454,54431,59396,47398,43705,59475
37007,NC,7644,12324,6898,9859,6322,4284,7100,12324,6700.330364,12086,9859,52897,6375,-5623,-9316,6454,54431,59272,47274,43581,59351
37009,NC,7644,12324,6898,9859,6322,4284,7100,12324,6873.401628,12086,9859,53070,6375,-5623,-9316,6454,54431,59445,47447,43754,59524
37011,NC,8436,12324,6898,9859,6322,4284,7237,12324,6873.401628,12086,9859,53862,6375,-5623,-9316,6454,55360,60237,48239,44546,60316
37013,NC,7644,12324,6898,9859,6322,4284,7100,11647,6997.02396,12086,9135,51792,6020,-5978,-9935,6099,54431,57812,45814,41857,57891
37015,NC,7644,12324,6898,9859,6322,4284,7100,12324,6428.361235,12086,9859,52625,6375,-5623,-9316,6454,54431,59000,47002,43309,59079
37017,NC,7644,12324,6898,9859,6322,4284,7100,12324,6873.401628,12086,9859,53070,6375,-5623,-9316,6454,54431,59445,47447,43754,59524
37019,NC,9816,12324,6898,9859,6322,4284,7476,11494,7664.58455,12086,9246,54590,6375,-5623,-9316,6454,56979,60965,48967,45274,61044
37021,NC,8628,12324,6898,9859,6322,4284,7270,11252,6725.054831,12086,9195,52169,6375,-5623,-9316,6454,55585,58544,46546,42853,58623
37023,NC,7644,12324,6898,9859,6322,4284,7100,10922,6032.769775,12086,9353,50322,6020,-5978,-9935,6099,54431,56342,44344,40387,56421
37025,NC,9756,12324,6898,9859,6322,4284,7465,10522,6725.054831,12086,9842,53216,6375,-5623,-9316,6454,56908,59591,47593,43900,59670
37027,NC,7644,12324,6898,9859,6322,4284,7100,11113,6255.289971,12086,9349,50731,6020,-5978,-9935,6099,54431,56751,44753,40796,56830
37029,NC,9684,12324,6898,9859,6322,4284,7453,12011,7268.993089,12086,9666,55000,6730,-5268,-8697,6809,56824,61730,49732,46303,61809
37031,NC,8292,12324,6898,9859,6322,4284,7212,10968,7961.278145,12086,9243,52834,6020,-5978,-9935,6099,55191,58854,46856,42899,58933
37033,NC,7644,12324,6898,9859,6322,4284,7100,12324,6082.218707,12086,9859,52279,6375,-5623,-9316,6454,54431,58654,46656,42963,58733
37035,NC,7644,12324,6898,9859,6322,4284,7100,10530,6626.156966,12086,9382,50553,6020,-5978,-9935,6099,54431,56573,44575,40618,56652
37037,NC,10116,12324,6898,9859,6322,4284,7528,11332,7664.58455,12086,9667,55149,6730,-5268,-8697,6809,57331,61879,49881,46452,61958
37039,NC,7644,12324,6898,9859,6322,4284,7100,12324,7170.095224,12086,9859,53367,6375,-5623,-9316,6454,54431,59742,47744,44051,59821
37041,NC,7644,12324,6898,9859,6322,4284,7100,12324,6799.22823,12086,9859,52996,6375,-5623,-9316,6454,54431,59371,47373,43680,59450
37043,NC,7644,12324,6898,9859,6322,4284,7100,12324,7268.993089,12086,9859,53466,6375,-5623,-9316,6454,54431,59841,47843,44150,59920
37045,NC,7728,12324,6898,9859,6322,4284,7114,10949,6131.66764,12086,8941,50119,6020,-5978,-9935,6099,54529,56139,44141,40184,56218
37047,NC,7644,12324,6898,9859,6322,4284,7100,12324,6675.605898,12086,9859,52873,6375,-5623,-9316,6454,54431,59248,47250,43557,59327
37049,NC,9480,12324,6898,9859,6322,4284,7418,10909,7318.442022,12086,9404,53481,6375,-5623,-9316,6454,56585,59856,47858,44165,59935
37051,NC,9792,12324,6898,9859,6322,4284,7472,10801,6749.779297,12086,9612,53325,6375,-5623,-9316,6454,56951,59700,47702,44009,59779
37053,NC,13560,12324,6898,9859,6322,4284,8124,12023,7936.553679,12086,10102,59991,7440,-4558,-7459,7519,61371,67431,55433,52532,67510
37055,NC,11208,12324,6898,9859,6322,4284,7717,11390,8604.114269,12086,9705,57277,6730,-5268,-8697,6809,58612,64007,52009,48580,64086
37057,NC,7644,12324,6898,9859,6322,4284,7100,10542,6205.841039,12086,9439,50200,6020,-5978,-9935,6099,54431,56220,44222,40265,56299
37059,NC,8316,12324,6898,9859,6322,4284,7216,10670,6947.575027,12086,9444,51748,6020,-5978,-9935,6099,55219,57768,45770,41813,57847
37061,NC,7644,12324,6898,9859,6322,4284,7100,12324,6799.22823,12086,9859,52996,6375,-5623,-9316,6454,54431,59371,47373,43680,59450
37063,NC,10116,12324,6898,9859,6322,4284,7528,11106,7021.748426,12086,9630,54244,6730,-5268,-8697,6809,57331,60974,48976,45547,61053
37065,NC,8076,12324,6898,9859,6322,4284,7174,10576,6601.432499,12086,8910,50534,6020,-5978,-9935,6099,54937,56554,44556,40599,56633
37067,NC,8316,12324,6898,9859,6322,4284,7216,10540,6799.22823,12086,9422,51447,6020,-5978,-9935,6099,55219,57467,45469,41512,57546
37069,NC,10272,12324,6898,9859,6322,4284,7555,11113,6527.2591,12086,10445,54728,6730,-5268,-8697,6809,57514,61458,49460,46031,61537
37071,NC,9756,12324,6898,9859,6322,4284,7465,12076,6428.361235,12086,9842,54473,6730,-5268,-8697,6809,56908,61203,49205,45776,61282
37073,NC,7644,12324,6898,9859,6322,4284,7100,11438,7046.472893,12086,10099,52598,6375,-5623,-9316,6454,54431,58973,46975,43282,59052
37075,NC,7644,12324,6898,9859,6322,4284,7100,12324,7219.544157,12086,9859,53417,6375,-5623,-9316,6454,54431,59792,47794,44101,59871
37077,NC,8784,12324,6898,9859,6322,4284,7297,11232,6576.708033,12086,9719,52681,6375,-5623,-9316,6454,55768,59056,47058,43365,59135
37079,NC,7644,12324,6898,9859,6322,4284,7100,12324,6329.46337,12086,9859,52526,6375,-5623,-9316,6454,54431,58901,46903,43210,58980
37081,NC,8508,12324,6898,9859,6322,4284,7249,11289,6922.850561,12086,9418,52508,6375,-5623,-9316,6454,55444,58883,46885,43192,58962
37083,NC,7644,12324,6898,9859,6322,4284,7100,10498,6502.534634,12086,8362,49377,5843,-6155,-10244,5922,54431,55220,43222,39133,55299
37085,NC,8508,12324,6898,9859,6322,4284,7249,10640,6972.299494,12086,9725,52215,6375,-5623,-9316,6454,55444,58590,46592,42899,58669
37087,NC,8028,12324,6898,9859,6322,4284,7166,11645,7244.268623,12086,9195,52482,6375,-5623,-9316,6454,54881,58857,46859,43166,58936
37089,NC,8628,12324,6898,9859,6322,4284,7270,11816,6799.22823,12086,9194,52807,6375,-5623,-9316,6454,55585,59182,47184,43491,59261
37091,NC,7644,12324,6898,9859,6322,4284,7100,12324,6428.361235,12086,9859,52625,6375,-5623,-9316,6454,54431,59000,47002,43309,59079
37093,NC,7956,12324,6898,9859,6322,4284,7154,12671,6997.02396,12086,9625,53618,6375,-5623,-9316,6454,54797,59993,47995,44302,60072
37095,NC,9588,12324,6898,9859,6322,4284,7436,12324,7466.788819,12086,9859,55608,6730,-5268,-8697,6809,56711,62338,50340,46911,62417
37097,NC,9288,12324,6898,9859,6322,4284,7384,12609,6922.850561,12086,9840,55030,6730,-5268,-8697,6809,56359,61760,49762,46333,61839
37099,NC,8112,12324,6898,9859,6322,4284,7181,12219,7120.646291,12086,8742,52563,6375,-5623,-9316,6454,54980,58938,46940,43247,59017
37101,NC,10272,12324,6898,9859,6322,4284,7555,11752,7145.370758,12086,10458,55998,6730,-5268,-8697,6809,57514,62728,50730,47301,62807
37103,NC,8208,12324,6898,9859,6322,4284,7197,12007,7046.472893,12086,9446,53078,6375,-5623,-9316,6454,55092,59453,47455,43762,59532
37105,NC,8772,12324,6898,9859,6322,4284,7295,11991,7095.921825,12086,9691,53921,6375,-5623,-9316,6454,55754,60296,48298,44605,60375
37107,NC,7800,12324,6898,9859,6322,4284,7127,12301,5983.320842,12086,8699,51153,6375,-5623,-9316,6454,54614,57528,45530,41837,57607
37109,NC,7644,12324,6898,9859,6322,4284,7100,12377,6403.636769,12086,9840,52635,6375,-5623,-9316,6454,54431,59010,47012,43319,59089
37111,NC,7644,12324,6898,9859,6322,4284,7100,12762,7046.472893,12086,8712,52534,6375,-5623,-9316,6454,54431,58909,46911,43218,58988
37113,NC,8556,12324,6898,9859,6322,4284,7258,12324,7417.339887,12086,9859,54526,6730,-5268,-8697,6809,55501,61256,49258,45829,61335
37115,NC,8628,12324,6898,9859,6322,4284,7270,12572,7244.268623,12086,9236,54050,6375,-5623,-9316,6454,55585,60425,48427,44734,60504
37117,NC,7644,12324,6898,9859,6322,4284,7100,12324,6725.054831,12086,9859,52922,6375,-5623,-9316,6454,54431,59297,47299,43606,59376
37119,NC,9756,12324,6898,9859,6322,4284,7465,12544,7268.993089,12086,9840,55778,6730,-5268,-8697,6809,56908,62508,50510,47081,62587
37121,NC,7644,12324,6898,9859,6322,4284,7100,12324,7194.81969,12086,9859,53392,6375,-5623,-9316,6454,54431,59767,47769,44076,59846
37123,NC,7644,12324,6898,9859,6322,4284,7100,12324,6601.432499,12086,9859,52798,6375,-5623,-9316,6454,54431,59173,47175,43482,59252
37125,NC,7680,12324,6898,9859,6322,4284,7106,12612,8134.349409,12086,9272,54068,6375,-5623,-9316,6454,54473,60443,48445,44752,60522
37127,NC,8076,12324,6898,9859,6322,4284,7174,11705,6280.014438,12086,8908,51339,6020,-5978,-9935,6099,54937,57359,45361,41404,57438
37129,NC,9816,12324,6898,9859,6322,4284,7476,12572,7392.615421,12086,9493,55643,6730,-5268,-8697,6809,56979,62373,50375,46946,62452
37131,NC,7644,12324,6898,9859,6322,4284,7100,13612,7244.268623,12086,8445,53315,6375,-5623,-9316,6454,54431,59690,47692,43999,59769
37133,NC,9084,12324,6898,9859,6322,4284,7349,13090,6898.126095,12086,9900,55342,6730,-5268,-8697,6809,56120,62072,50074,46645,62151
37135,NC,10116,12324,6898,9859,6322,4284,7528,13747,8529.94087,12086,9640,58403,7085,-4913,-8078,7164,57331,65488,53490,50325,65567
37137,NC,7644,12324,6898,9859,6322,4284,7100,13282,7466.788819,12086,9437,54200,6375,-5623,-9316,6454,54431,60575,48577,44884,60654
37139,NC,8892,12324,6898,9859,6322,4284,7316,12297,6922.850561,12086,9641,54123,6730,-5268,-8697,6809,55895,60853,48855,45426,60932
37141,NC,7908,12324,6898,9859,6322,4284,7145,13378,7862.38028,12086,9532,55051,6730,-5268,-8697,6809,54740,61781,49783,46354,61860
37143,NC,8916,12324,6898,9859,6322,4284,7320,15375,6848.677162,12086,9658,57168,7085,-4913,-8078,7164,55923,64253,52255,49090,64332
37145,NC,8100,12324,6898,9859,6322,4284,7179,13801,6576.708033,12086,9661,54509,6730,-5268,-8697,6809,54966,61239,49241,45812,61318
37147,NC,8232,12324,6898,9859,6322,4284,7201,13500,6922.850561,12086,9461,54486,6730,-5268,-8697,6809,55120,61216,49218,45789,61295
37149,NC,7704,12324,6898,9859,6322,4284,7110,12324,7293.717555,12086,9859,53551,6375,-5623,-9316,6454,54501,59926,47928,44235,60005
37151,NC,8508,12324,6898,9859,6322,4284,7249,13456,6428.361235,12086,9432,54194,6730,-5268,-8697,6809,55444,60924,48926,45497,61003
37153,NC,7644,12324,6898,9859,6322,4284,7100,12520,5909.147443,12086,8457,50900,6020,-5978,-9935,6099,54431,56920,44922,40965,56999
37155,NC,7644,12324,6898,9859,6322,4284,7100,14787,5958.596376,12086,8784,53543,6730,-5268,-8697,6809,54431,60273,48275,44846,60352
37157,NC,7644,12324,6898,9859,6322,4284,7100,13323,6799.22823,12086,9428,53564,6375,-5623,-9316,6454,54431,59939,47941,44248,60018
37159,NC,7980,12324,6898,9859,6322,4284,7158,15333,6230.565505,12086,9843,55756,7085,-4913,-8078,7164,54825,62841,50843,47678,62920
37161,NC,7644,12324,6898,9859,6322,4284,7100,14928,6008.045308,12086,8563,53513,6730,-5268,-8697,6809,54431,60243,48245,44816,60322
37163,NC,7644,12324,6898,9859,6322,4284,7100,12324,6428.361235,12086,9859,52625,6375,-5623,-9316,6454,54431,59000,47002,43309,59079
37165,NC,7704,12324,6898,9859,6322,4284,7110,14449,6898.126095,12086,8254,53675,6375,-5623,-9316,6454,54501,60050,48052,44359,60129
37167,NC,7644,12324,6898,9859,6322,4284,7100,14500,6354.187836,12086,9345,54213,6730,-5268,-8697,6809,54431,60943,48945,45516,61022
37169,NC,8316,12324,6898,9859,6322,4284,7216,14646,7268.993089,12086,9440,56041,6730,-5268,-8697,6809,55219,62771,50773,47344,62850
37171,NC,7644,12324,6898,9859,6322,4284,7100,15124,6774.503763,12086,8746,54659,6730,-5268,-8697,6809,54431,61389,49391,45962,61468
37173,NC,8736,12324,6898,9859,6322,4284,7289,12324,6997.02396,12086,9859,54286,6730,-5268,-8697,6809,55712,61016,49018,45589,61095
37175,NC,7764,12324,6898,9859,6322,4284,7120,13240,7466.788819,12086,8953,53794,6375,-5623,-9316,6454,54571,60169,48171,44478,60248
37177,NC,7644,12324,6898,9859,6322,4284,7100,14784,7590.411151,12086,9716,56104,6730,-5268,-8697,6809,54431,62834,50836,47407,62913
37179,NC,9756,12324,6898,9859,6322,4284,7465,12565,7046.472893,12086,9842,55580,6730,-5268,-8697,6809,56908,62310,50312,46883,62389
37181,NC,7944,12324,6898,9859,6322,4284,7152,15348,6428.361235,12086,8849,54939,6730,-5268,-8697,6809,54783,61669,49671,46242,61748
37183,NC,10272,12324,6898,9859,6322,4284,7555,13818,7343.166488,12086,10482,58285,7085,-4913,-8078,7164,57514,65370,53372,50207,65449
37185,NC,7644,12324,6898,9859,6322,4284,7100,12324,6527.2591,12086,9859,52724,6375,-5623,-9316,6454,54431,59099,47101,43408,59178
37187,NC,7644,12324,6898,9859,6322,4284,7100,12324,6848.677162,12086,9859,53046,6375,-5623,-9316,6454,54431,59421,47423,43730,59500
37189,NC,9684,12324,6898,9859,6322,4284,7453,14735,8356.869606,12086,8527,57673,7085,-4913,-8078,7164,56824,64758,52760,49595,64837
37191,NC,8292,12324,6898,9859,6322,4284,7212,13616,6502.534634,12086,9442,54223,6730,-5268,-8697,6809,55191,60953,48955,45526,61032
37193,NC,7644,12324,6898,9859,6322,4284,7100,12064,6972.299494,12086,8587,51637,6020,-5978,-9935,6099,54431,57657,45659,41702,57736
37195,NC,9636,12324,6898,9859,6322,4284,7445,10914,6428.361235,12086,8935,52283,6375,-5623,-9316,6454,56768,58658,46660,42967,58737
37197,NC,8316,12324,6898,9859,6322,4284,7216,11064,6873.401628,12086,9442,52065,6375,-5623,-9316,6454,55219,58440,46442,42749,58519
37199,NC,7644,12324,6898,9859,6322,4284,7100,12324,6873.401628,12086,9859,53070,6375,-5623,-9316,6454,54431,59445,47447,43754,59524
38001,ND,7644,5011,7047,9589,5460,4046,5138,5011,7501.782291,9478,9589,43270,1944,-9822,-14340,2255,43935,45214,33448,28930,45525
38003,ND,8016,5011,7047,9589,5460,4046,5186,5011,7122.904397,9478,9589,43263,2370,-9396,-13973,2681,44355,45633,33867,29290,45944
38005,ND,7644,5011,7047,9589,5460,4046,5138,5011,7173.42145,9478,9589,42941,1944,-9822,-14340,2255,43935,44885,33119,28601,45196
38007,ND,7740,5011,7047,9589,5460,4046,5150,5011,8082.728394,9478,9589,43947,1944,-9822,-14340,2255,44043,45891,34125,29607,46202
38009,ND,7644,5011,7047,9589,5460,4046,5138,5011,7350.231133,9478,9589,43118,1944,-9822,-14340,2255,43935,45062,33296,28778,45373
38011,ND,7644,5011,7047,9589,5460,4046,5138,5011,7501.782291,9478,9589,43270,1944,-9822,-14340,2255,43935,45214,33448,28930,45525
38013,ND,7644,5011,7047,9589,5460,4046,5138,5011,7905.91871,9478,9589,43674,1944,-9822,-14340,2255,43935,45618,33852,29334,45929
38015,ND,8448,5011,7047,9589,5460,4046,5241,4821,6946.094714,9478,10089,43828,2370,-9396,-13973,2681,44842,46198,34432,29855,46509
38017,ND,8208,5011,7047,9589,5460,4046,5210,5672,7097.645871,9478,9621,44123,2843,-8923,-13558,3154,44571,46966,35200,30565,47277
38019,ND,7644,5011,7047,9589,5460,4046,5138,5011,7249.197028,9478,9589,43017,1944,-9822,-14340,2255,43935,44961,33195,28677,45272
38021,ND,7644,5011,7047,9589,5460,4046,5138,5011,7223.938502,9478,9589,42992,1944,-9822,-14340,2255,43935,44936,33170,28652,45247
38023,ND,7644,5011,7047,9589,5460,4046,5138,5011,8360.572183,9478,9589,44129,1944,-9822,-14340,2255,43935,46073,34307,29789,46384
38025,ND,7644,5011,7047,9589,5460,4046,5138,5011,8032.211341,9478,9589,43800,1944,-9822,-14340,2255,43935,45744,33978,29460,46055
38027,ND,7644,5011,7047,9589,5460,4046,5138,5011,7426.006712,9478,9589,43194,1944,-9822,-14340,2255,43935,45138,33372,28854,45449
38029,ND,7644,5011,7047,9589,5460,4046,5138,5011,6996.611766,9478,9589,42765,1944,-9822,-14340,2255,43935,44709,32943,28425,45020
38031,ND,7644,5011,7047,9589,5460,4046,5138,5011,7375.489659,9478,9589,43143,1944,-9822,-14340,2255,43935,45087,33321,28803,45398
38033,ND,7644,5011,7047,9589,5460,4046,5138,5011,8082.728394,9478,9589,43851,1944,-9822,-14340,2255,43935,45795,34029,29511,46106
38035,ND,8700,5011,7047,9589,5460,4046,5273,4877,7021.870292,9478,9386,43509,2370,-9396,-13973,2681,45126,45879,34113,29536,46190
38037,ND,7644,5011,7047,9589,5460,4046,5138,5011,7097.645871,9478,9589,42866,1944,-9822,-14340,2255,43935,44810,33044,28526,45121
38039,ND,7644,5011,7047,9589,5460,4046,5138,5011,7097.645871,9478,9589,42866,1944,-9822,-14340,2255,43935,44810,33044,28526,45121
38041,ND,7644,5011,7047,9589,5460,4046,5138,5011,7451.265238,9478,9589,43219,1944,-9822,-14340,2255,43935,45163,33397,28879,45474
38043,ND,7644,5011,7047,9589,5460,4046,5138,5011,7047.128818,9478,9589,42815,1944,-9822,-14340,2255,43935,44759,32993,28475,45070
38045,ND,7644,5011,7047,9589,5460,4046,5138,5011,7400.748186,9478,9589,43169,1944,-9822,-14340,2255,43935,45113,33347,28829,45424
38047,ND,7644,5011,7047,9589,5460,4046,5138,5011,7047.128818,9478,9589,42815,1944,-9822,-14340,2255,43935,44759,32993,28475,45070
38049,ND,7644,5011,7047,9589,5460,4046,5138,5199,7350.231133,9478,9734,43451,2370,-9396,-13973,2681,43935,45821,34055,29478,46132
38051,ND,9348,5011,7047,9589,5460,4046,5355,5011,7047.128818,9478,9589,44519,2843,-8923,-13558,3154,45856,47362,35596,30961,47673
38053,ND,7644,5011,7047,9589,5460,4046,5138,5011,8133.245446,9478,9589,43901,1944,-9822,-14340,2255,43935,45845,34079,29561,46156
38055,ND,7644,5011,7047,9589,5460,4046,5138,5011,7097.645871,9478,9589,42866,1944,-9822,-14340,2255,43935,44810,33044,28526,45121
38057,ND,7644,5011,7047,9589,5460,4046,5138,5011,7299.714081,9478,9589,43068,1944,-9822,-14340,2255,43935,45012,33246,28728,45323
38059,ND,8448,5011,7047,9589,5460,4046,5241,4983,7527.040817,9478,10057,44540,2843,-8923,-13558,3154,44842,47383,35617,30982,47694
38061,ND,12828,5011,7047,9589,5460,4046,5799,5011,7855.401658,9478,9589,48807,3814,-7952,-12305,4125,49780,52621,40855,36502,52932
38063,ND,7644,5011,7047,9589,5460,4046,5138,5011,7047.128818,9478,9589,42815,1944,-9822,-14340,2255,43935,44759,32993,28475,45070
38065,ND,7644,5011,7047,9589,5460,4046,5138,6642,6996.611766,9478,10054,44861,2843,-8923,-13558,3154,43935,47704,35938,31303,48015
38067,ND,7644,5011,7047,9589,5460,4046,5138,5011,7021.870292,9478,9589,42790,1944,-9822,-14340,2255,43935,44734,32968,28450,45045
38069,ND,7644,5011,7047,9589,5460,4046,5138,5011,7350.231133,9478,9589,43118,1944,-9822,-14340,2255,43935,45062,33296,28778,45373
38071,ND,7848,5011,7047,9589,5460,4046,5164,5011,7072.387345,9478,9589,43044,2370,-9396,-13973,2681,44165,45414,33648,29071,45725
38073,ND,8232,5011,7047,9589,5460,4046,5213,5011,7148.162923,9478,9589,43504,2370,-9396,-13973,2681,44598,45874,34108,29531,46185
38075,ND,7644,5011,7047,9589,5460,4046,5138,5394,7375.489659,9478,9736,43674,2370,-9396,-13973,2681,43935,46044,34278,29701,46355
38077,ND,7644,5011,7047,9589,5460,4046,5138,4896,7097.645871,9478,9403,42565,1944,-9822,-14340,2255,43935,44509,32743,28225,44820
38079,ND,7644,5011,7047,9589,5460,4046,5138,5011,7173.42145,9478,9589,42941,1944,-9822,-14340,2255,43935,44885,33119,28601,45196
38081,ND,7644,5011,7047,9589,5460,4046,5138,5011,7097.645871,9478,9589,42866,1944,-9822,-14340,2255,43935,44810,33044,28526,45121
38083,ND,7644,5011,7047,9589,5460,4046,5138,5011,7122.904397,9478,9589,42891,1944,-9822,-14340,2255,43935,44835,33069,28551,45146
38085,ND,7644,5011,7047,9589,5460,4046,5138,5276,6996.611766,9478,10062,43503,2370,-9396,-13973,2681,43935,45873,34107,29530,46184
38087,ND,7740,5011,7047,9589,5460,4046,5150,5011,7476.523764,9478,9589,43341,1944,-9822,-14340,2255,44043,45285,33519,29001,45596
38089,ND,8904,5011,7047,9589,5460,4046,5299,5759,7451.265238,9478,10189,45827,3243,-8523,-13140,3554,45356,49070,37304,32687,49381
38091,ND,7644,5011,7047,9589,5460,4046,5138,5011,7097.645871,9478,9589,42866,1944,-9822,-14340,2255,43935,44810,33044,28526,45121
38093,ND,8004,5011,7047,9589,5460,4046,5184,4933,7476.523764,9478,9211,43148,1944,-9822,-14340,2255,44341,45092,33326,28808,45403
38095,ND,7644,5011,7047,9589,5460,4046,5138,5011,7148.162923,9478,9589,42916,1944,-9822,-14340,2255,43935,44860,33094,28576,45171
38097,ND,7764,5011,7047,9589,5460,4046,5154,5011,7097.645871,9478,9589,42986,1944,-9822,-14340,2255,44071,44930,33164,28646,45241
38099,ND,7644,5011,7047,9589,5460,4046,5138,5011,7047.128818,9478,9589,42815,1944,-9822,-14340,2255,43935,44759,32993,28475,45070
38101,ND,13392,5011,7047,9589,5460,4046,5871,5124,7375.489659,9478,9776,49191,4099,-7667,-11888,4410,50416,53290,41524,37303,53601
38103,ND,7644,5011,7047,9589,5460,4046,5138,5011,7097.645871,9478,9589,42866,1944,-9822,-14340,2255,43935,44810,33044,28526,45121
38105,ND,12636,5011,7047,9589,5460,4046,5774,5722,8107.98692,9478,10351,50341,4385,-7381,-11470,4696,49563,54726,42960,38871,55037
39001,OH,7368,16568,7047,9589,5244,4046,4976,16568,6339.890084,7918,9589,51829,6572,-4450,-8143,7627,54838,58401,47379,43686,59456
39003,OH,7860,16568,7047,9589,5244,4046,5038,15412,6264.114505,7918,9169,50670,6056,-4966,-8923,7111,55392,56726,45704,41747,57781
39005,OH,7692,16568,7047,9589,5244,4046,5017,15479,5961.012191,7918,9249,50344,6056,-4966,-8923,7111,55203,56400,45378,41421,57455
39007,OH,7416,16568,7047,9589,5244,4046,4982,15328,6491.441241,7918,8971,50171,6056,-4966,-8923,7111,54892,56227,45205,41248,57282
39009,OH,8412,16568,7047,9589,5244,4046,5108,17903,6718.767977,7918,8410,53408,6572,-4450,-8143,7627,56014,59980,48958,45265,61035
39011,OH,7704,16568,7047,9589,5244,4046,5019,15379,6137.821874,7918,9548,50733,6056,-4966,-8923,7111,55217,56789,45767,41810,57844
39013,OH,7368,16568,7047,9589,5244,4046,4976,15028,6137.821874,7918,8883,49380,6056,-4966,-8923,7111,54838,55436,44414,40457,56491
39015,OH,7368,16568,7047,9589,5244,4046,4976,16370,6668.250925,7918,9611,51981,6572,-4450,-8143,7627,54838,58553,47531,43838,59608
39017,OH,8820,16568,7047,9589,5244,4046,5159,17578,6870.319135,7918,9611,54844,7089,-3933,-7362,8144,56473,61933,50911,47482,62988
39019,OH,7944,16568,7047,9589,5244,4046,5049,15059,7400.748186,7918,9219,51587,6056,-4966,-8923,7111,55487,57643,46621,42664,58698
39021,OH,7368,16568,7047,9589,5244,4046,4976,15647,7021.870292,7918,9389,51389,6056,-4966,-8923,7111,54838,57445,46423,42466,58500
39023,OH,8556,16568,7047,9589,5244,4046,5126,15943,6365.14861,7918,9011,51839,6572,-4450,-8143,7627,56176,58411,47389,43696,59466
39025,OH,8820,16568,7047,9589,5244,4046,5159,18097,6769.28503,7918,9609,55259,7089,-3933,-7362,8144,56473,62348,51326,47897,63403
39027,OH,7776,16568,7047,9589,5244,4046,5028,16214,6036.787769,7918,9274,51264,6572,-4450,-8143,7627,55298,57836,46814,43121,58891
39029,OH,7368,16568,7047,9589,5244,4046,4976,15350,6289.373032,7918,9016,49987,6056,-4966,-8923,7111,54838,56043,45021,41064,57098
39031,OH,7368,16568,7047,9589,5244,4046,4976,15353,5758.943981,7918,9006,49450,6056,-4966,-8923,7111,54838,55506,44484,40527,56561
39033,OH,7488,16568,7047,9589,5244,4046,4991,14788,6668.250925,7918,8862,49770,6056,-4966,-8923,7111,54973,55826,44804,40847,56881
39035,OH,9000,16568,7047,9589,5244,4046,5182,18801,7097.645871,7918,9201,56063,7605,-3417,-6582,8660,56676,63668,52646,49481,64723
39037,OH,7368,16568,7047,9589,5244,4046,4976,14281,5935.753664,7918,9144,48692,5798,-5224,-9313,6853,54838,54490,43468,39379,55545
39039,OH,7368,16568,7047,9589,5244,4046,4976,15018,5859.978086,7918,9346,49556,6056,-4966,-8923,7111,54838,55612,44590,40633,56667
39041,OH,9672,16568,7047,9589,5244,4046,5266,20209,7148.162923,7918,9607,58600,8126,-2896,-5797,9181,57432,66726,55704,52803,67781
39043,OH,9552,16568,7047,9589,5244,4046,5251,16440,6087.304822,7918,9128,53171,7089,-3933,-7362,8144,57297,60260,49238,45809,61315
39045,OH,9672,16568,7047,9589,5244,4046,5266,17018,6744.026504,7918,9609,55007,7089,-3933,-7362,8144,57432,62096,51074,47645,63151
39047,OH,8412,16568,7047,9589,5244,4046,5108,15077,5859.978086,7918,8631,49944,6056,-4966,-8923,7111,56014,56000,44978,41021,57055
39049,OH,9672,16568,7047,9589,5244,4046,5266,19871,6996.611766,7918,9610,58114,8126,-2896,-5797,9181,57432,66240,55218,52317,67295
39051,OH,8124,16568,7047,9589,5244,4046,5072,15869,6946.094714,7918,9148,52052,6572,-4450,-8143,7627,55690,58624,47602,43909,59679
39053,OH,7368,16568,7047,9589,5244,4046,4976,16885,5834.719559,7918,8599,50650,6056,-4966,-8923,7111,54838,56706,45684,41727,57761
39055,OH,9000,16568,7047,9589,5244,4046,5182,17923,7905.91871,7918,9276,56069,7089,-3933,-7362,8144,56676,63158,52136,48707,64213
39057,OH,8544,16568,7047,9589,5244,4046,5124,17765,6668.250925,7918,9098,54040,7089,-3933,-7362,8144,56162,61129,50107,46678,62184
39059,OH,7368,16568,7047,9589,5244,4046,4976,15051,5910.495138,7918,8704,48998,6056,-4966,-8923,7111,54838,55054,44032,40075,56109
39061,OH,8820,16568,7047,9589,5244,4046,5159,19255,6693.509451,7918,9610,56343,7605,-3417,-6582,8660,56473,63948,52926,49761,65003
39063,OH,7548,16568,7047,9589,5244,4046,4999,16762,6996.611766,7918,9343,52614,6572,-4450,-8143,7627,55041,59186,48164,44471,60241
39065,OH,7368,16568,7047,9589,5244,4046,4976,16568,6693.509451,7918,9589,52183,6572,-4450,-8143,7627,54838,58755,47733,44040,59810
39067,OH,7368,16568,7047,9589,5244,4046,4976,16568,6440.924189,7918,9589,51930,6572,-4450,-8143,7627,54838,58502,47480,43787,59557
39069,OH,7488,16568,7047,9589,5244,4046,4991,16568,6744.026504,7918,9589,52353,6572,-4450,-8143,7627,54973,58925,47903,44210,59980
39071,OH,7368,16568,7047,9589,5244,4046,4976,16568,6440.924189,7918,9589,51930,6572,-4450,-8143,7627,54838,58502,47480,43787,59557
39073,OH,7368,16568,7047,9589,5244,4046,4976,15964,6845.060609,7918,9610,51751,6056,-4966,-8923,7111,54838,57807,46785,42828,58862
39075,OH,7368,16568,7047,9589,5244,4046,4976,16568,7122.904397,7918,9589,52612,6572,-4450,-8143,7627,54838,59184,48162,44469,60239
39077,OH,7368,16568,7047,9589,5244,4046,4976,16237,5961.012191,7918,9479,51009,6572,-4450,-8143,7627,54838,57581,46559,42866,58636
39079,OH,7368,16568,7047,9589,5244,4046,4976,15738,6567.21682,7918,8464,50101,6056,-4966,-8923,7111,54838,56157,45135,41178,57212
39081,OH,7368,16568,7047,9589,5244,4046,4976,14152,6314.631558,7918,8834,48633,5798,-5224,-9313,6853,54838,54431,43409,39320,55486
39083,OH,7740,16568,7047,9589,5244,4046,5023,15623,6339.890084,7918,9376,51043,6056,-4966,-8923,7111,55257,57099,46077,42120,58154
39085,OH,9000,16568,7047,9589,5244,4046,5182,17619,7097.645871,7918,9249,54930,7089,-3933,-7362,8144,56676,62019,50997,47568,63074
39087,OH,7716,16568,7047,9589,5244,4046,5020,15180,6289.373032,7918,8967,50116,6056,-4966,-8923,7111,55230,56172,45150,41193,57227
39089,OH,9672,16568,7047,9589,5244,4046,5266,16934,6693.509451,7918,9611,54875,7089,-3933,-7362,8144,57432,61964,50942,47513,63019
39091,OH,7572,16568,7047,9589,5244,4046,5002,15557,6036.787769,7918,9211,50341,6056,-4966,-8923,7111,55068,56397,45375,41418,57452
39093,OH,9000,16568,7047,9589,5244,4046,5182,16983,6769.28503,7918,9254,53971,7089,-3933,-7362,8144,56676,61060,50038,46609,62115
39095,OH,8124,16568,7047,9589,5244,4046,5072,17002,6567.21682,7918,9118,52775,6572,-4450,-8143,7627,55690,59347,48325,44632,60402
39097,OH,9672,16568,7047,9589,5244,4046,5266,16382,7122.904397,7918,9610,54751,7089,-3933,-7362,8144,57432,61840,50818,47389,62895
39099,OH,7644,16568,7047,9589,5244,4046,5011,15424,6567.21682,7918,8889,50488,6056,-4966,-8923,7111,55149,56544,45522,41565,57599
39101,OH,8400,16568,7047,9589,5244,4046,5106,15428,6137.821874,7918,8914,50844,6056,-4966,-8923,7111,56000,56900,45878,41921,57955
39103,OH,9000,16568,7047,9589,5244,4046,5182,17596,7072.387345,7918,9259,54892,7089,-3933,-7362,8144,56676,61981,50959,47530,63036
39105,OH,7368,16568,7047,9589,5244,4046,4976,16568,7021.870292,7918,9589,52511,6572,-4450,-8143,7627,54838,59083,48061,44368,60138
39107,OH,7368,16568,7047,9589,5244,4046,4976,15233,5733.685454,7918,9626,49925,6056,-4966,-8923,7111,54838,55981,44959,41002,57036
39109,OH,8544,16568,7047,9589,5244,4046,5124,15746,6390.407136,7918,9120,51764,6572,-4450,-8143,7627,56162,58336,47314,43621,59391
39111,OH,7368,16568,7047,9589,5244,4046,4976,16568,6516.699768,7918,9589,52006,6572,-4450,-8143,7627,54838,58578,47556,43863,59633
39113,OH,8544,16568,7047,9589,5244,4046,5124,17271,6466.182715,7918,9065,53310,6572,-4450,-8143,7627,56162,59882,48860,45167,60937
39115,OH,7368,16568,7047,9589,5244,4046,4976,16568,6415.665663,7918,9589,51905,6572,-4450,-8143,7627,54838,58477,47455,43762,59532
39117,OH,9672,16568,7047,9589,5244,4046,5266,15781,6946.094714,7918,9609,53973,7089,-3933,-7362,8144,57432,61062,50040,46611,62117
39119,OH,7632,16568,7047,9589,5244,4046,5010,15865,6238.855979,7918,9046,50746,6056,-4966,-8923,7111,55136,56802,45780,41823,57857
39121,OH,7368,16568,7047,9589,5244,4046,4976,16568,6264.114505,7918,9589,51753,6572,-4450,-8143,7627,54838,58325,47303,43610,59380
39123,OH,8124,16568,7047,9589,5244,4046,5072,16554,7375.489659,7918,9244,53262,6572,-4450,-8143,7627,55690,59834,48812,45119,60889
39125,OH,7368,16568,7047,9589,5244,4046,4976,16568,6466.182715,7918,9589,51955,6572,-4450,-8143,7627,54838,58527,47505,43812,59582
39127,OH,7368,16568,7047,9589,5244,4046,4976,15422,6870.319135,7918,9610,51234,6056,-4966,-8923,7111,54838,57290,46268,42311,58345
39129,OH,9672,16568,7047,9589,5244,4046,5266,16371,6062.046295,7918,9609,53677,7089,-3933,-7362,8144,57432,60766,49744,46315,61821
39131,OH,7368,16568,7047,9589,5244,4046,4976,16568,6567.21682,7918,9589,52056,6572,-4450,-8143,7627,54838,58628,47606,43913,59683
39133,OH,9000,16568,7047,9589,5244,4046,5182,18229,7173.42145,7918,9404,55770,7089,-3933,-7362,8144,56676,62859,51837,48408,63914
39135,OH,7896,16568,7047,9589,5244,4046,5043,16568,6567.21682,7918,9589,52584,6572,-4450,-8143,7627,55433,59156,48134,44441,60211
39137,OH,7512,16568,7047,9589,5244,4046,4995,16568,6516.699768,7918,9589,52150,6572,-4450,-8143,7627,55001,58722,47700,44007,59777
39139,OH,7368,16568,7047,9589,5244,4046,4976,15668,6491.441241,7918,8950,50441,6056,-4966,-8923,7111,54838,56497,45475,41518,57552
39141,OH,8424,16568,7047,9589,5244,4046,5109,16097,6087.304822,7918,8944,51517,6572,-4450,-8143,7627,56027,58089,47067,43374,59144
39143,OH,7368,16568,7047,9589,5244,4046,4976,15455,6087.304822,7918,9283,50157,6056,-4966,-8923,7111,54838,56213,45191,41234,57268
39145,OH,7368,16568,7047,9589,5244,4046,4976,15603,6188.338927,7918,8386,49509,6056,-4966,-8923,7111,54838,55565,44543,40586,56620
39147,OH,7368,16568,7047,9589,5244,4046,4976,14739,6188.338927,7918,9172,49432,6056,-4966,-8923,7111,54838,55488,44466,40509,56543
39149,OH,7884,16568,7047,9589,5244,4046,5041,16062,6062.046295,7918,9595,51567,6572,-4450,-8143,7627,55419,58139,47117,43424,59194
39151,OH,7944,16568,7047,9589,5244,4046,5049,15970,6668.250925,7918,9198,51744,6572,-4450,-8143,7627,55487,58316,47294,43601,59371
39153,OH,9000,16568,7047,9589,5244,4046,5182,17389,6946.094714,7918,9390,54689,7089,-3933,-7362,8144,56676,61778,50756,47327,62833
39155,OH,7644,16568,7047,9589,5244,4046,5011,15436,6415.665663,7918,8916,50375,6056,-4966,-8923,7111,55149,56431,45409,41452,57486
39157,OH,7764,16568,7047,9589,5244,4046,5026,15385,6466.182715,7918,9225,50804,6056,-4966,-8923,7111,55284,56860,45838,41881,57915
39159,OH,9600,16568,7047,9589,5244,4046,5257,17766,6314.631558,7918,9610,55255,7089,-3933,-7362,8144,57351,62344,51322,47893,63399
39161,OH,7368,16568,7047,9589,5244,4046,4976,14103,6996.611766,7918,9240,49672,5798,-5224,-9313,6853,54838,55470,44448,40359,56525
39163,OH,7368,16568,7047,9589,5244,4046,4976,16568,6365.14861,7918,9589,51854,6572,-4450,-8143,7627,54838,58426,47404,43711,59481
39165,OH,8820,16568,7047,9589,5244,4046,5159,18572,6718.767977,7918,9611,55685,7605,-3417,-6582,8660,56473,63290,52268,49103,64345
39167,OH,7368,16568,7047,9589,5244,4046,4976,15876,6541.958294,7918,8939,50689,6056,-4966,-8923,7111,54838,56745,45723,41766,57800
39169,OH,7716,16568,7047,9589,5244,4046,5020,16343,6264.114505,7918,9512,51799,6572,-4450,-8143,7627,55230,58371,47349,43656,59426
39171,OH,7368,16568,7047,9589,5244,4046,4976,16568,6668.250925,7918,9589,52157,6572,-4450,-8143,7627,54838,58729,47707,44014,59784
39173,OH,8124,16568,7047,9589,5244,4046,5072,17876,6491.441241,7918,9137,53593,7089,-3933,-7362,8144,55690,60682,49660,46231,61737
39175,OH,7368,16568,7047,9589,5244,4046,4976,16568,6895.577661,7918,9589,52385,6572,-4450,-8143,7627,54838,58957,47935,44242,60012
40001,OK,7200,11506,6898,9859,6659,4284,5061,11506,6700.330364,8990,9859,48539,5664,-5901,-10122,6176,51467,54203,42638,38417,54715
40003,OK,7200,11506,6898,9859,6659,4284,5061,11506,6601.432499,8990,9859,48440,5664,-5901,-10122,6176,51467,54104,42539,38318,54616
40005,OK,7200,11506,6898,9859,6659,4284,5061,11506,7046.472893,8990,9859,48885,5664,-5901,-10122,6176,51467,54549,42984,38763,55061
40007,OK,7200,11506,6898,9859,6659,4284,5061,11506,6873.401628,8990,9859,48712,5664,-5901,-10122,6176,51467,54376,42811,38590,54888
40009,OK,8196,11506,6898,9859,6659,4284,5186,11392,7343.166488,8990,9749,49954,5923,-5643,-9732,6434,52588,55877,44311,40222,56388
40011,OK,7596,11506,6898,9859,6659,4284,5111,11506,7170.095224,8990,9859,49405,5923,-5643,-9732,6434,51913,55328,43762,39673,55839
40013,OK,7224,11506,6898,9859,6659,4284,5064,11748,7071.197359,8990,8996,48313,5664,-5901,-10122,6176,51494,53977,42412,38191,54489
40015,OK,7200,11506,6898,9859,6659,4284,5061,11506,6848.677162,8990,9859,48688,5664,-5901,-10122,6176,51467,54352,42787,38566,54864
40017,OK,8676,11506,6898,9859,6659,4284,5246,13734,7788.206881,8990,9813,53285,6697,-4869,-8562,7208,53128,59982,48416,44723,60493
40019,OK,7428,11506,6898,9859,6659,4284,5090,11425,6477.810168,8990,9517,48122,5664,-5901,-10122,6176,51724,53786,42221,38000,54298
40021,OK,7200,11506,6898,9859,6659,4284,5061,12426,6725.054831,8990,9006,48631,5664,-5901,-10122,6176,51467,54295,42730,38509,54807
40023,OK,7200,11506,6898,9859,6659,4284,5061,11506,7095.921825,8990,9859,48935,5664,-5901,-10122,6176,51467,54599,43034,38813,55111
40025,OK,7200,11506,6898,9859,6659,4284,5061,11506,7046.472893,8990,9859,48885,5664,-5901,-10122,6176,51467,54549,42984,38763,55061
40027,OK,8676,11506,6898,9859,6659,4284,5246,14465,7293.717555,8990,9811,53519,6697,-4869,-8562,7208,53128,60216,48650,44957,60727
40029,OK,7200,11506,6898,9859,6659,4284,5061,11506,7145.370758,8990,9859,48984,5664,-5901,-10122,6176,51467,54648,43083,38862,55160
40031,OK,8760,11506,6898,9859,6659,4284,5256,12551,6749.779297,8990,9597,50931,6181,-5385,-9342,6692,53222,57112,45546,41589,57623
40033,OK,7260,11506,6898,9859,6659,4284,5069,10120,6725.054831,8990,9637,47016,5407,-6159,-10512,5918,51535,52423,40857,36504,52934
40035,OK,7200,11506,6898,9859,6659,4284,5061,11506,6725.054831,8990,9859,48564,5664,-5901,-10122,6176,51467,54228,42663,38442,54740
40037,OK,8868,11506,6898,9859,6659,4284,5270,12515,6972.299494,8990,9685,51315,6181,-5385,-9342,6692,53344,57496,45930,41973,58007
40039,OK,7200,11506,6898,9859,6659,4284,5061,12147,7343.166488,8990,9667,49631,5923,-5643,-9732,6434,51467,55554,43988,39899,56065
40041,OK,7200,11506,6898,9859,6659,4284,5061,11506,6873.401628,8990,9859,48712,5664,-5901,-10122,6176,51467,54376,42811,38590,54888
40043,OK,7200,11506,6898,9859,6659,4284,5061,11506,7367.890954,8990,9859,49207,5664,-5901,-10122,6176,51467,54871,43306,39085,55383
40045,OK,7200,11506,6898,9859,6659,4284,5061,11506,7268.993089,8990,9859,49108,5664,-5901,-10122,6176,51467,54772,43207,38986,55284
40047,OK,7416,11506,6898,9859,6659,4284,5088,10725,6354.187836,8990,9576,47345,5407,-6159,-10512,5918,51710,52752,41186,36833,53263
40049,OK,7200,11506,6898,9859,6659,4284,5061,11506,7095.921825,8990,9859,48935,5664,-5901,-10122,6176,51467,54599,43034,38813,55111
40051,OK,7200,11506,6898,9859,6659,4284,5061,12385,7046.472893,8990,9811,49717,5923,-5643,-9732,6434,51467,55640,44074,39985,56151
40053,OK,7200,11506,6898,9859,6659,4284,5061,11506,6378.912303,8990,9859,48218,5664,-5901,-10122,6176,51467,53882,42317,38096,54394
40055,OK,7704,11506,6898,9859,6659,4284,5124,11506,7145.370758,8990,9859,49488,5923,-5643,-9732,6434,52034,55411,43845,39756,55922
40057,OK,7200,11506,6898,9859,6659,4284,5061,11506,7219.544157,8990,9859,49059,5664,-5901,-10122,6176,51467,54723,43158,38937,55235
40059,OK,7200,11506,6898,9859,6659,4284,5061,11506,7318.442022,8990,9859,49157,5664,-5901,-10122,6176,51467,54821,43256,39035,55333
40061,OK,7200,11506,6898,9859,6659,4284,5061,11506,6675.605898,8990,9859,48515,5664,-5901,-10122,6176,51467,54179,42614,38393,54691
40063,OK,7200,11506,6898,9859,6659,4284,5061,11506,7046.472893,8990,9859,48885,5664,-5901,-10122,6176,51467,54549,42984,38763,55061
40065,OK,7200,11506,6898,9859,6659,4284,5061,10526,6947.575027,8990,9427,47375,5407,-6159,-10512,5918,51467,52782,41216,36863,53293
40067,OK,7200,11506,6898,9859,6659,4284,5061,11506,6749.779297,8990,9859,48589,5664,-5901,-10122,6176,51467,54253,42688,38467,54765
40069,OK,7200,11506,6898,9859,6659,4284,5061,11506,6823.952696,8990,9859,48663,5664,-5901,-10122,6176,51467,54327,42762,38541,54839
40071,OK,7632,11506,6898,9859,6659,4284,5115,10174,6131.66764,8990,9292,46504,5407,-6159,-10512,5918,51953,51911,40345,35992,52422
40073,OK,7920,11506,6898,9859,6659,4284,5151,11506,6972.299494,8990,9859,49531,5923,-5643,-9732,6434,52277,55454,43888,39799,55965
40075,OK,7200,11506,6898,9859,6659,4284,5061,11506,6898.126095,8990,9859,48737,5664,-5901,-10122,6176,51467,54401,42836,38615,54913
40077,OK,7200,11506,6898,9859,6659,4284,5061,11506,6799.22823,8990,9859,48638,5664,-5901,-10122,6176,51467,54302,42737,38516,54814
40079,OK,7200,11506,6898,9859,6659,4284,5061,10604,6626.156966,8990,9039,46743,5407,-6159,-10512,5918,51467,52150,40584,36231,52661
40081,OK,7200,11506,6898,9859,6659,4284,5061,11865,6997.02396,8990,9813,49149,5923,-5643,-9732,6434,51467,55072,43506,39417,55583
40083,OK,8676,11506,6898,9859,6659,4284,5246,13943,7318.442022,8990,9811,53023,6697,-4869,-8562,7208,53128,59720,48154,44461,60231
40085,OK,7200,11506,6898,9859,6659,4284,5061,11506,6947.575027,8990,9859,48787,5664,-5901,-10122,6176,51467,54451,42886,38665,54963
40087,OK,8676,11506,6898,9859,6659,4284,5246,13644,7170.095224,8990,9813,52577,6697,-4869,-8562,7208,53128,59274,47708,44015,59785
40089,OK,7200,11506,6898,9859,6659,4284,5061,11506,6997.02396,8990,9859,48836,5664,-5901,-10122,6176,51467,54500,42935,38714,55012
40091,OK,7224,11506,6898,9859,6659,4284,5064,11506,7120.646291,8990,9859,48984,5664,-5901,-10122,6176,51494,54648,43083,38862,55160
40093,OK,7200,11506,6898,9859,6659,4284,5061,11506,6700.330364,8990,9859,48539,5664,-5901,-10122,6176,51467,54203,42638,38417,54715
40095,OK,7380,11506,6898,9859,6659,4284,5084,11506,6749.779297,8990,9859,48769,5664,-5901,-10122,6176,51670,54433,42868,38647,54945
40097,OK,7200,11506,6898,9859,6659,4284,5061,11506,6898.126095,8990,9859,48737,5664,-5901,-10122,6176,51467,54401,42836,38615,54913
40099,OK,7428,11506,6898,9859,6659,4284,5090,11506,6848.677162,8990,9859,48916,5664,-5901,-10122,6176,51724,54580,43015,38794,55092
40101,OK,7200,11506,6898,9859,6659,4284,5061,11611,7021.748426,8990,8794,47901,5407,-6159,-10512,5918,51467,53308,41742,37389,53819
40103,OK,7200,11506,6898,9859,6659,4284,5061,11506,6873.401628,8990,9859,48712,5664,-5901,-10122,6176,51467,54376,42811,38590,54888
40105,OK,7248,11506,6898,9859,6659,4284,5067,11506,6873.401628,8990,9859,48760,5664,-5901,-10122,6176,51521,54424,42859,38638,54936
40107,OK,7200,11506,6898,9859,6659,4284,5061,11506,7095.921825,8990,9859,48935,5664,-5901,-10122,6176,51467,54599,43034,38813,55111
40109,OK,8676,11506,6898,9859,6659,4284,5246,13892,6873.401628,8990,9814,52530,6697,-4869,-8562,7208,53128,59227,47661,43968,59738
40111,OK,7260,11506,6898,9859,6659,4284,5069,11400,6823.952696,8990,9680,48438,5664,-5901,-10122,6176,51535,54102,42537,38316,54614
40113,OK,8868,11506,6898,9859,6659,4284,5270,12118,7095.921825,8990,9691,51047,6181,-5385,-9342,6692,53344,57228,45662,41705,57739
40115,OK,7524,11506,6898,9859,6659,4284,5102,10510,6453.085702,8990,8876,46637,5407,-6159,-10512,5918,51832,52044,40478,36125,52555
40117,OK,7200,11506,6898,9859,6659,4284,5061,12332,6972.299494,8990,9684,49463,5923,-5643,-9732,6434,51467,55386,43820,39731,55897
40119,OK,8436,11506,6898,9859,6659,4284,5216,13966,7615.135617,8990,8809,52100,6181,-5385,-9342,6692,52858,58281,46715,42758,58792
40121,OK,7908,11506,6898,9859,6659,4284,5150,10919,6972.299494,8990,9036,48110,5664,-5901,-10122,6176,52264,53774,42209,37988,54286
40123,OK,7200,11506,6898,9859,6659,4284,5061,10873,7194.81969,8990,9454,47996,5407,-6159,-10512,5918,51467,53403,41837,37484,53914
40125,OK,8712,11506,6898,9859,6659,4284,5250,11489,7491.513286,8990,9416,50383,5923,-5643,-9732,6434,53168,56306,44740,40651,56817
40127,OK,7200,11506,6898,9859,6659,4284,5061,11506,6997.02396,8990,9859,48836,5664,-5901,-10122,6176,51467,54500,42935,38714,55012
40129,OK,7200,11506,6898,9859,6659,4284,5061,11506,7367.890954,8990,9859,49207,5664,-5901,-10122,6176,51467,54871,43306,39085,55383
40131,OK,8868,11506,6898,9859,6659,4284,5270,13455,7170.095224,8990,9682,52450,6697,-4869,-8562,7208,53344,59147,47581,43888,59658
40133,OK,7200,11506,6898,9859,6659,4284,5061,11506,6922.850561,8990,9859,48762,5664,-5901,-10122,6176,51467,54426,42861,38640,54938
40135,OK,7200,11506,6898,9859,6659,4284,5061,10829,6650.881432,8990,9046,47000,5407,-6159,-10512,5918,51467,52407,40841,36488,52918
40137,OK,7200,11506,6898,9859,6659,4284,5061,10526,7244.268623,8990,9364,47609,5407,-6159,-10512,5918,51467,53016,41450,37097,53527
40139,OK,7368,11506,6898,9859,6659,4284,5082,12299,6898.126095,8990,10241,50079,6181,-5385,-9342,6692,51656,56260,44694,40737,56771
40141,OK,7200,11506,6898,9859,6659,4284,5061,11506,6725.054831,8990,9859,48564,5664,-5901,-10122,6176,51467,54228,42663,38442,54740
40143,OK,8868,11506,6898,9859,6659,4284,5270,14196,6823.952696,8990,9674,52836,6697,-4869,-8562,7208,53344,59533,47967,44274,60044
40145,OK,8868,11506,6898,9859,6659,4284,5270,13132,7194.81969,8990,9689,52158,6181,-5385,-9342,6692,53344,58339,46773,42816,58850
40147,OK,7872,11506,6898,9859,6659,4284,5145,11617,6477.810168,8990,9409,48649,5923,-5643,-9732,6434,52223,54572,43006,38917,55083
40149,OK,7200,11506,6898,9859,6659,4284,5061,11506,7268.993089,8990,9859,49108,5664,-5901,-10122,6176,51467,54772,43207,38986,55284
40151,OK,7224,11506,6898,9859,6659,4284,5064,11506,6675.605898,8990,9859,48539,5664,-5901,-10122,6176,51494,54203,42638,38417,54715
40153,OK,7200,11506,6898,9859,6659,4284,5061,11762,7244.268623,8990,9939,49419,5923,-5643,-9732,6434,51467,55342,43776,39687,55853
41001,OR,7848,7977,8234,8509,5956,4344,7693,7977,8499.768275,8050,8509,45228,6795,-5193,-9828,6884,50561,52023,40035,35400,52112
41003,OR,9888,7977,8234,8509,5956,4344,8071,9387,9149.05613,8050,8147,48965,8175,-3813,-8034,8264,52979,57140,45152,40931,57229
41005,OR,11064,7977,8234,8509,5956,4344,8288,9890,8912.951455,8050,8549,50810,8808,-3180,-7137,8897,54372,59618,47630,43673,59707
41007,OR,9204,7977,8234,8509,5956,4344,7944,8291,8352.202854,8050,8022,46263,7542,-4446,-8931,7631,52168,53805,41817,37332,53894
41009,OR,11064,7977,8234,8509,5956,4344,8288,8091,9178.569214,8050,8555,49283,8175,-3813,-8034,8264,54372,57458,45470,41249,57547
41011,OR,8292,7977,8234,8509,5956,4344,7775,7454,8765.386034,8050,7494,44400,6291,-5697,-10274,6380,51087,50691,38703,34126,50780
41013,OR,8136,7977,8234,8509,5956,4344,7746,7772,14786.05523,8050,7527,50615,6795,-5193,-9828,6884,50902,57410,45422,40787,57499
41015,OR,9588,7977,8234,8509,5956,4344,8015,9337,9385.160804,8050,7341,48045,7542,-4446,-8931,7631,52623,55587,43599,39114,55676
41017,OR,9636,7977,8234,8509,5956,4344,8024,8552,8853.925287,8050,8168,47604,7542,-4446,-8931,7631,52680,55146,43158,38673,55235
41019,OR,7848,7977,8234,8509,5956,4344,7693,8194,8057.072011,8050,7779,44272,6795,-5193,-9828,6884,50561,51067,39079,34444,51156
41021,OR,7644,7977,8234,8509,5956,4344,7655,7977,8617.820612,8050,8509,45142,6795,-5193,-9828,6884,50319,51937,39949,35314,52026
41023,OR,7644,7977,8234,8509,5956,4344,7655,7977,8175.124348,8050,8509,44699,6795,-5193,-9828,6884,50319,51494,39506,34871,51583
41025,OR,7644,7977,8234,8509,5956,4344,7655,7977,8411.229022,8050,8509,44935,6795,-5193,-9828,6884,50319,51730,39742,35107,51819
41027,OR,10020,7977,8234,8509,5956,4344,8095,8456,9709.804731,8050,8642,49222,7859,-4129,-8482,7948,53135,57081,45093,40740,57170
41029,OR,10008,7977,8234,8509,5956,4344,8093,9057,8234.150517,8050,7923,47616,7859,-4129,-8482,7948,53121,55475,43487,39134,55564
41031,OR,7644,7977,8234,8509,5956,4344,7655,7977,8971.977624,8050,8509,45496,6795,-5193,-9828,6884,50319,52291,40303,35668,52380
41033,OR,9768,7977,8234,8509,5956,4344,8048,8216,8735.87295,8050,7372,46486,7226,-4762,-9379,7315,52836,53712,41724,37107,53801
41035,OR,8304,7977,8234,8509,5956,4344,7777,7770,8971.977624,8050,7568,45007,6795,-5193,-9828,6884,51101,51802,39814,35179,51891
41037,OR,7644,7977,8234,8509,5956,4344,7655,7977,8411.229022,8050,8509,44935,6795,-5193,-9828,6884,50319,51730,39742,35107,51819
41039,OR,10008,7977,8234,8509,5956,4344,8093,8923,8440.742107,8050,7905,47670,7859,-4129,-8482,7948,53121,55529,43541,39188,55618
41041,OR,9012,7977,8234,8509,5956,4344,7908,8400,9591.752394,8050,7819,47216,7226,-4762,-9379,7315,51940,54442,42454,37837,54531
41043,OR,9024,7977,8234,8509,5956,4344,7911,8256,8116.09818,8050,8192,45981,7542,-4446,-8931,7631,51955,53523,41535,37050,53612
41045,OR,7644,7977,8234,8509,5956,4344,7655,7465,7466.810325,8050,7711,42681,6291,-5697,-10274,6380,50319,48972,36984,32407,49061
41047,OR,9360,7977,8234,8509,5956,4344,7973,8994,8027.558927,8050,8335,47110,7859,-4129,-8482,7948,52353,54969,42981,38628,55058
41049,OR,7644,7977,8234,8509,5956,4344,7655,8297,8204.637432,8050,8405,44944,6795,-5193,-9828,6884,50319,51739,39751,35116,51828
41051,OR,11064,7977,8234,8509,5956,4344,8288,10405,9031.003793,8050,8556,51450,8808,-3180,-7137,8897,54372,60258,48270,44313,60347
41053,OR,9360,7977,8234,8509,5956,4344,7973,8502,8765.386034,8050,8347,47369,7542,-4446,-8931,7631,52353,54911,42923,38438,55000
41055,OR,7644,7977,8234,8509,5956,4344,7655,7977,8381.715938,8050,8509,44906,6795,-5193,-9828,6884,50319,51701,39713,35078,51790
41057,OR,9108,7977,8234,8509,5956,4344,7926,7977,9237.595383,8050,8509,47226,7542,-4446,-8931,7631,52054,54768,42780,38295,54857
41059,OR,8424,7977,8234,8509,5956,4344,7799,7676,8558.794444,8050,8417,45470,7226,-4762,-9379,7315,51243,52696,40708,36091,52785
41061,OR,7764,7977,8234,8509,5956,4344,7677,7822,8942.46454,8050,7996,44919,6795,-5193,-9828,6884,50461,51714,39726,35091,51803
41063,OR,7644,7977,8234,8509,5956,4344,7655,7977,8411.229022,8050,8509,44935,6795,-5193,-9828,6884,50319,51730,39742,35107,51819
41065,OR,8760,7977,8234,8509,5956,4344,7862,8354,9149.05613,8050,7886,46543,7226,-4762,-9379,7315,51642,53769,41781,37164,53858
41067,OR,11064,7977,8234,8509,5956,4344,8288,10584,8440.742107,8050,8551,51034,8808,-3180,-7137,8897,54372,59842,47854,43897,59931
41069,OR,7644,7977,8234,8509,5956,4344,7655,7977,8440.742107,8050,8509,44965,6795,-5193,-9828,6884,50319,51760,39772,35137,51849
41071,OR,11064,7977,8234,8509,5956,4344,8288,9092,8558.794444,8050,8546,49655,8492,-3496,-7585,8581,54372,58147,46159,42070,58236
42001,PA,9924,12784,8011,7901,5639,3987,6241,12974,9561.690913,8483,8093,53023,7387,-4354,-8311,7723,54487,60410,48669,44712,60746
42003,PA,9468,12784,8011,7901,5639,3987,6174,12643,8212.142946,8483,7581,50374,7387,-4354,-8311,7723,53964,57761,46020,42063,58097
42005,PA,7644,12784,8011,7901,5639,3987,5908,11258,8326.998092,8483,7633,47332,6616,-5125,-9478,6952,51874,53948,42207,37854,54284
42007,PA,9468,12784,8011,7901,5639,3987,6174,11713,7551.725856,8483,7621,48824,7131,-4611,-8700,7466,53964,55955,44213,40124,56290
42009,PA,7644,12784,8011,7901,5639,3987,5908,12784,8958.701396,8483,7901,49758,6873,-4868,-9089,7209,51874,56631,44890,40669,56967
42011,PA,10308,12784,8011,7901,5639,3987,6297,13545,8154.715373,8483,7962,52440,7902,-3840,-7533,8237,54927,60342,48600,44907,60677
42013,PA,8208,12784,8011,7901,5639,3987,5990,11522,7838.863721,8483,7451,47490,6616,-5125,-9478,6952,52520,54106,42365,38012,54442
42015,PA,7644,12784,8011,7901,5639,3987,5908,11710,7408.156923,8483,7650,46882,6616,-5125,-9478,6952,51874,53498,41757,37404,53834
42017,PA,13620,12784,8011,7901,5639,3987,6780,15520,8872.560036,8483,8342,58825,8931,-2811,-5976,9266,58722,67756,56014,52849,68091
42019,PA,9468,12784,8011,7901,5639,3987,6174,12807,8212.142946,8483,7626,50583,7387,-4354,-8311,7723,53964,57970,46229,42272,58306
42021,PA,7644,12784,8011,7901,5639,3987,5908,11087,7810.149935,8483,7259,46270,6359,-5383,-9868,6694,51874,52629,40887,36402,52964
42023,PA,7644,12784,8011,7901,5639,3987,5908,12784,7925.005081,8483,7901,48724,6873,-4868,-9089,7209,51874,55597,43856,39635,55933
42025,PA,11688,12784,8011,7901,5639,3987,6498,12655,7322.015564,8483,7955,52091,7902,-3840,-7533,8237,56508,59993,48251,44558,60328
42027,PA,10968,12784,8011,7901,5639,3987,6393,13104,8958.701396,8483,7657,53158,7902,-3840,-7533,8237,55683,61060,49318,45625,61395
42029,PA,13620,12784,8011,7901,5639,3987,6780,15864,9906.256351,8483,8333,60193,9445,-2296,-5197,9781,58722,69638,57897,54996,69974
42031,PA,7644,12784,8011,7901,5639,3987,5908,12784,6862.594979,8483,7901,47662,6873,-4868,-9089,7209,51874,54535,42794,38573,54871
42033,PA,7644,12784,8011,7901,5639,3987,5908,11163,7523.012069,8483,7332,46132,6359,-5383,-9868,6694,51874,52491,40749,36264,52826
42035,PA,8688,12784,8011,7901,5639,3987,6060,11732,8183.429159,8483,7422,48496,6873,-4868,-9089,7209,53070,55369,43628,39407,55705
42037,PA,8004,12784,8011,7901,5639,3987,5961,11931,7953.718867,8483,7566,47925,6616,-5125,-9478,6952,52287,54541,42800,38447,54877
42039,PA,7716,12784,8011,7901,5639,3987,5919,11402,7580.439642,8483,7400,46568,6359,-5383,-9868,6694,51957,52927,41185,36700,53262
42041,PA,10140,12784,8011,7901,5639,3987,6272,13321,8527.994598,8483,7859,52318,7387,-4354,-8311,7723,54734,59705,47964,44007,60041
42043,PA,10140,12784,8011,7901,5639,3987,6272,13357,8068.574013,8483,7857,51892,7387,-4354,-8311,7723,54734,59279,47538,43581,59615
42045,PA,13620,12784,8011,7901,5639,3987,6780,15332,9016.128969,8483,8375,58813,8931,-2811,-5976,9266,58722,67744,56002,52837,68079
42047,PA,7644,12784,8011,7901,5639,3987,5908,12784,8298.284306,8483,7901,49097,6873,-4868,-9089,7209,51874,55970,44229,40008,56306
42049,PA,7992,12784,8011,7901,5639,3987,5959,11908,7982.432654,8483,7576,47928,6616,-5125,-9478,6952,52273,54544,42803,38450,54880
42051,PA,9468,12784,8011,7901,5639,3987,6174,11167,7637.867215,8483,7633,48376,6873,-4868,-9089,7209,53964,55249,43508,39287,55585
42053,PA,8340,12784,8011,7901,5639,3987,6010,12784,7293.301777,8483,7901,48788,7131,-4611,-8700,7466,52672,55919,44177,40088,56254
42055,PA,8952,12784,8011,7901,5639,3987,6099,12610,8011.14644,8483,7835,49879,7131,-4611,-8700,7466,53373,57010,45268,41179,57345
42057,PA,7644,12784,8011,7901,5639,3987,5908,12784,8097.2878,8483,7901,48896,6873,-4868,-9089,7209,51874,55769,44028,39807,56105
42059,PA,7644,12784,8011,7901,5639,3987,5908,12784,7178.446631,8483,7901,47977,6873,-4868,-9089,7209,51874,54850,43109,38888,55186
42061,PA,7644,12784,8011,7901,5639,3987,5908,11193,8039.860227,8483,7355,46701,6359,-5383,-9868,6694,51874,53060,41318,36833,53395
42063,PA,8220,12784,8011,7901,5639,3987,5992,11639,8671.56353,8483,7462,48462,6616,-5125,-9478,6952,52534,55078,43337,38984,55414
42065,PA,7644,12784,8011,7901,5639,3987,5908,12784,6719.026047,8483,7901,47518,6873,-4868,-9089,7209,51874,54391,42650,38429,54727
42067,PA,7644,12784,8011,7901,5639,3987,5908,12784,8700.277317,8483,7901,49499,6873,-4868,-9089,7209,51874,56372,44631,40410,56708
42069,PA,8328,12784,8011,7901,5639,3987,6008,12439,8212.142946,8483,7508,48957,6873,-4868,-9089,7209,52658,55830,44089,39868,56166
42071,PA,10776,12784,8011,7901,5639,3987,6365,13499,8413.139452,8483,8030,53188,7902,-3840,-7533,8237,55463,61090,49348,45655,61425
42073,PA,8196,12784,8011,7901,5639,3987,5989,11300,7637.867215,8483,7431,47035,6616,-5125,-9478,6952,52507,53651,41910,37557,53987
42075,PA,8556,12784,8011,7901,5639,3987,6041,12905,7896.291294,8483,7908,49735,7131,-4611,-8700,7466,52919,56866,45124,41035,57201
42077,PA,11688,12784,8011,7901,5639,3987,6498,14177,8326.998092,8483,7959,54621,8416,-3325,-6754,8752,56508,63037,51296,47867,63373
42079,PA,8328,12784,8011,7901,5639,3987,6008,12200,7867.577508,8483,7511,48377,6873,-4868,-9089,7209,52658,55250,43509,39288,55586
42081,PA,7860,12784,8011,7901,5639,3987,5940,11846,7752.722362,8483,7564,47492,6616,-5125,-9478,6952,52122,54108,42367,38014,54444
42083,PA,7644,12784,8011,7901,5639,3987,5908,10733,8499.280811,8483,7275,46621,6359,-5383,-9868,6694,51874,52980,41238,36753,53315
42085,PA,7692,12784,8011,7901,5639,3987,5915,11413,7006.163912,8483,7340,45921,6359,-5383,-9868,6694,51929,52280,40538,36053,52615
42087,PA,7644,12784,8011,7901,5639,3987,5908,11322,7092.305272,8483,7353,45882,6359,-5383,-9868,6694,51874,52241,40499,36014,52576
42089,PA,10452,12784,8011,7901,5639,3987,6318,13463,7982.432654,8483,8098,52465,7902,-3840,-7533,8237,55092,60367,48625,44932,60702
42091,PA,13620,12784,8011,7901,5639,3987,6780,15753,8556.708384,8483,8355,58754,9445,-2296,-5197,9781,58722,68199,56458,53557,68535
42093,PA,8304,12784,8011,7901,5639,3987,6004,12276,7953.718867,8483,7567,48572,6873,-4868,-9089,7209,52630,55445,43704,39483,55781
42095,PA,11688,12784,8011,7901,5639,3987,6498,14108,8413.139452,8483,7956,54636,8416,-3325,-6754,8752,56508,63052,51311,47882,63388
42097,PA,7644,12784,8011,7901,5639,3987,5908,11952,8240.856733,8483,7213,47519,6616,-5125,-9478,6952,51874,54135,42394,38041,54471
42099,PA,10140,12784,8011,7901,5639,3987,6272,12409,8470.567025,8483,7868,51357,7387,-4354,-8311,7723,54734,58744,47003,43046,59080
42101,PA,13620,12784,8011,7901,5639,3987,6780,14751,8240.856733,8483,8448,57530,8931,-2811,-5976,9266,58722,66461,54719,51554,66796
42103,PA,13932,12784,8011,7901,5639,3987,6825,12718,8987.415182,8483,8483,56591,8416,-3325,-6754,8752,59079,65007,53266,49837,65343
42105,PA,7644,12784,8011,7901,5639,3987,5908,12784,7551.725856,8483,7901,48351,6873,-4868,-9089,7209,51874,55224,43483,39262,55560
42107,PA,7644,12784,8011,7901,5639,3987,5908,12288,7666.581002,8483,7396,47464,6616,-5125,-9478,6952,51874,54080,42339,37986,54416
42109,PA,7740,12784,8011,7901,5639,3987,5922,11639,7465.584496,8483,7740,47055,6616,-5125,-9478,6952,51984,53671,41930,37577,54007
42111,PA,7644,12784,8011,7901,5639,3987,5908,11349,7322.015564,8483,7465,46251,6359,-5383,-9868,6694,51874,52610,40868,36383,52945
42113,PA,7644,12784,8011,7901,5639,3987,5908,12784,8011.14644,8483,7901,48810,6873,-4868,-9089,7209,51874,55683,43942,39721,56019
42115,PA,8124,12784,8011,7901,5639,3987,5978,12784,9532.977126,8483,7901,50812,7131,-4611,-8700,7466,52424,57943,46201,42112,58278
42117,PA,7764,12784,8011,7901,5639,3987,5926,12784,8240.856733,8483,7901,49160,6873,-4868,-9089,7209,52012,56033,44292,40071,56369
42119,PA,8316,12784,8011,7901,5639,3987,6006,12095,8872.560036,8483,7290,49043,6873,-4868,-9089,7209,52644,55916,44175,39954,56252
42121,PA,7704,12784,8011,7901,5639,3987,5917,10814,7149.732845,8483,7385,45523,6359,-5383,-9868,6694,51943,51882,40140,35655,52217
42123,PA,7644,12784,8011,7901,5639,3987,5908,11103,6776.45362,8483,7450,45444,6359,-5383,-9868,6694,51874,51803,40061,35576,52138
42125,PA,9468,12784,8011,7901,5639,3987,6174,12047,8585.422171,8483,7621,50192,7131,-4611,-8700,7466,53964,57323,45581,41492,57658
42127,PA,8508,12784,8011,7901,5639,3987,6034,12784,8700.277317,8483,7901,50363,7131,-4611,-8700,7466,52864,57494,45752,41663,57829
42129,PA,9468,12784,8011,7901,5639,3987,6174,11820,8039.860227,8483,7625,49422,7131,-4611,-8700,7466,53964,56553,44811,40722,56888
42131,PA,8328,12784,8011,7901,5639,3987,6008,11937,8355.711879,8483,7552,48643,6873,-4868,-9089,7209,52658,55516,43775,39554,55852
42133,PA,10032,12784,8011,7901,5639,3987,6256,13357,8355.711879,8483,8054,52269,7387,-4354,-8311,7723,54610,59656,47915,43958,59992
44001,RI,10956,11557,8011,7901,5872,3987,7029,13939,11341.94568,8147,7901,56272,7678,-4380,-8073,7697,55313,63950,51892,48199,63969
44003,RI,10956,11557,8011,7901,5872,3987,7029,11918,8470.567025,8147,7901,51380,7150,-4908,-8865,7169,55313,58530,46472,42515,58549
44005,RI,12692,11557,8011,7901,5872,3987,7294,13172,8929.987609,8147,7901,54829,7678,-4380,-8073,7697,57314,62507,50449,46756,62526
44007,RI,10956,11557,8011,7901,5872,3987,7029,12354,8039.860227,8147,7901,51385,7150,-4908,-8865,7169,55313,58535,46477,42520,58554
44009,RI,11098,11557,8011,7901,5872,3987,7051,12561,10164.68043,8147,7902,53860,7150,-4908,-8865,7169,55477,61010,48952,44995,61029
45001,SC,7608,10176,6898,9859,6114,4284,6038,9551,6774.503763,9506,8773,46497,5246,-6831,-11316,5246,50977,51743,39666,35181,51743
45003,SC,8760,10176,6898,9859,6114,4284,6217,10444,6626.156966,9506,9606,49226,6136,-5941,-10030,6136,52308,55362,43285,39196,55362
45005,SC,7620,10176,6898,9859,6114,4284,6040,10176,6601.432499,9506,9859,48046,5839,-6238,-10459,5839,50991,53885,41808,37587,53885
45007,SC,7824,10176,6898,9859,6114,4284,6072,9857,6453.085702,9506,9526,47450,5543,-6534,-10887,5543,51227,52993,40916,36563,52993
45009,SC,7608,10176,6898,9859,6114,4284,6038,10176,6700.330364,9506,9859,48133,5839,-6238,-10459,5839,50977,53972,41895,37674,53972
45011,SC,7608,10176,6898,9859,6114,4284,6038,10176,6601.432499,9506,9859,48034,5839,-6238,-10459,5839,50977,53873,41796,37575,53873
45013,SC,10596,10176,6898,9859,6114,4284,6502,12822,7738.757949,9506,9666,54612,7025,-5052,-8745,7025,54429,61637,49560,45867,61637
45015,SC,10752,10176,6898,9859,6114,4284,6526,11537,7021.748426,9506,9834,52934,7025,-5052,-8745,7025,54609,59959,47882,44189,59959
45017,SC,9516,10176,6898,9859,6114,4284,6334,10537,6601.432499,9506,9706,50150,6432,-5645,-9602,6432,53181,56582,44505,40548,56582
45019,SC,10752,10176,6898,9859,6114,4284,6526,13119,7318.442022,9506,9832,54812,7618,-4459,-7888,7618,54609,62430,50353,46924,62430
45021,SC,7608,10176,6898,9859,6114,4284,6038,10634,5834.974044,9506,8763,46630,5543,-6534,-10887,5543,50977,52173,40096,35743,52173
45023,SC,7608,10176,6898,9859,6114,4284,6038,9345,6823.952696,9506,9841,47407,5543,-6534,-10887,5543,50977,52950,40873,36520,52950
45025,SC,7608,10176,6898,9859,6114,4284,6038,10176,6576.708033,9506,9859,48010,5839,-6238,-10459,5839,50977,53849,41772,37551,53849
45027,SC,7608,10176,6898,9859,6114,4284,6038,10176,6551.983567,9506,9859,47985,5839,-6238,-10459,5839,50977,53824,41747,37526,53824
45029,SC,8496,10176,6898,9859,6114,4284,6176,10176,6873.401628,9506,9859,49194,6136,-5941,-10030,6136,52003,55330,43253,39164,55330
45031,SC,7884,10176,6898,9859,6114,4284,6081,10253,6725.054831,9506,9350,48002,5839,-6238,-10459,5839,51296,53841,41764,37543,53841
45033,SC,7608,10176,6898,9859,6114,4284,6038,10176,6626.156966,9506,9859,48059,5839,-6238,-10459,5839,50977,53898,41821,37600,53898
45035,SC,10752,10176,6898,9859,6114,4284,6526,11411,6922.850561,9506,9833,52709,7025,-5052,-8745,7025,54609,59734,47657,43964,59734
45037,SC,8760,10176,6898,9859,6114,4284,6217,10538,6972.299494,9506,9617,49678,6136,-5941,-10030,6136,52308,55814,43737,39648,55814
45039,SC,9516,10176,6898,9859,6114,4284,6334,9921,6502.534634,9506,9701,49431,6136,-5941,-10030,6136,53181,55567,43490,39401,55567
45041,SC,7800,10176,6898,9859,6114,4284,6068,10418,6477.810168,9506,9333,47819,5839,-6238,-10459,5839,51199,53658,41581,37360,53658
45043,SC,8664,10176,6898,9859,6114,4284,6202,12228,7219.544157,9506,9142,51044,6432,-5645,-9602,6432,52197,57476,45399,41442,57476
45045,SC,8820,10176,6898,9859,6114,4284,6226,10644,6576.708033,9506,9514,49345,6136,-5941,-10030,6136,52377,55481,43404,39315,55481
45047,SC,7608,10176,6898,9859,6114,4284,6038,9892,6280.014438,9506,8714,46284,5246,-6831,-11316,5246,50977,51530,39453,34968,51530
45049,SC,7608,10176,6898,9859,6114,4284,6038,10176,6403.636769,9506,9859,47837,5839,-6238,-10459,5839,50977,53676,41599,37378,53676
45051,SC,9660,10176,6898,9859,6114,4284,6357,12678,7046.472893,9506,9232,52406,7025,-5052,-8745,7025,53348,59431,47354,43661,59431
45053,SC,8808,10176,6898,9859,6114,4284,6225,11129,7293.717555,9506,9682,50702,6432,-5645,-9602,6432,52364,57134,45057,41100,57134
45055,SC,7680,10176,6898,9859,6114,4284,6049,10404,6873.401628,9506,9698,48445,5839,-6238,-10459,5839,51060,54284,42207,37986,54284
45057,SC,7788,10176,6898,9859,6114,4284,6066,9302,6477.810168,9506,9841,47199,5543,-6534,-10887,5543,51185,52742,40665,36312,52742
45059,SC,7608,10176,6898,9859,6114,4284,6038,10458,5810.249578,9506,9513,47179,5839,-6238,-10459,5839,50977,53018,40941,36720,53018
45061,SC,7608,10176,6898,9859,6114,4284,6038,10176,6477.810168,9506,9859,47911,5839,-6238,-10459,5839,50977,53750,41673,37452,53750
45063,SC,9516,10176,6898,9859,6114,4284,6334,10783,6601.432499,9506,9696,50387,6432,-5645,-9602,6432,53181,56819,44742,40785,56819
45065,SC,7608,10176,6898,9859,6114,4284,6038,10176,6626.156966,9506,9859,48059,5839,-6238,-10459,5839,50977,53898,41821,37600,53898
45067,SC,7608,10176,6898,9859,6114,4284,6038,10176,6403.636769,9506,9859,47837,5839,-6238,-10459,5839,50977,53676,41599,37378,53676
45069,SC,7608,10176,6898,9859,6114,4284,6038,9400,6378.912303,9506,8448,45624,5246,-6831,-11316,5246,50977,50870,38793,34308,50870
45071,SC,8460,10176,6898,9859,6114,4284,6170,10049,6453.085702,9506,9413,48164,5839,-6238,-10459,5839,51961,54003,41926,37705,54003
45073,SC,7608,10176,6898,9859,6114,4284,6038,10198,6205.841039,9506,9118,46920,5543,-6534,-10887,5543,50977,52463,40386,36033,52463
45075,SC,8088,10176,6898,9859,6114,4284,6113,10878,6675.605898,9506,8687,48119,5839,-6238,-10459,5839,51532,53958,41881,37660,53958
45077,SC,8820,10176,6898,9859,6114,4284,6226,10477,6997.02396,9506,9519,49603,6136,-5941,-10030,6136,52377,55739,43662,39573,55739
45079,SC,9516,10176,6898,9859,6114,4284,6334,10936,6626.156966,9506,9693,50561,6432,-5645,-9602,6432,53181,56993,44916,40959,56993
45081,SC,9516,10176,6898,9859,6114,4284,6334,10220,6601.432499,9506,9703,49831,6432,-5645,-9602,6432,53181,56263,44186,40229,56263
45083,SC,8136,10176,6898,9859,6114,4284,6120,9754,6428.361235,9506,9427,47536,5839,-6238,-10459,5839,51587,53375,41298,37077,53375
45085,SC,9228,10176,6898,9859,6114,4284,6290,10369,6378.912303,9506,9422,49188,6136,-5941,-10030,6136,52849,55324,43247,39158,55324
45087,SC,7692,10176,6898,9859,6114,4284,6051,9237,6725.054831,9506,9413,46857,5543,-6534,-10887,5543,51074,52400,40323,35970,52400
45089,SC,7608,10176,6898,9859,6114,4284,6038,10176,6527.2591,9506,9859,47960,5839,-6238,-10459,5839,50977,53799,41722,37501,53799
45091,SC,9756,10176,6898,9859,6114,4284,6372,10818,7071.197359,9506,9842,51277,6432,-5645,-9602,6432,53459,57709,45632,41675,57709
46003,SD,7776,30324,7047,9589,6547,4046,4651,30324,7173.42145,9622,9589,68530,6245,-1653,-3234,10424,69980,74775,66877,65296,78954
46005,SD,7128,30324,7047,9589,6547,4046,4576,29015,7350.231133,9622,9154,66316,5792,-2106,-3951,9971,69257,72108,64210,62365,76287
46007,SD,7128,30324,7047,9589,6547,4046,4576,30324,7324.972607,9622,9589,68034,5792,-2106,-3951,9971,69257,73826,65928,64083,78005
46009,SD,7128,30324,7047,9589,6547,4046,4576,30324,7426.006712,9622,9589,68135,5792,-2106,-3951,9971,69257,73927,66029,64184,78106
46011,SD,7488,30324,7047,9589,6547,4046,4618,34646,7703.8505,9622,9476,72982,7151,-555,-1800,11330,69659,80133,72427,71182,84312
46013,SD,7476,30324,7047,9589,6547,4046,4617,32319,7451.265238,9622,9443,70358,6245,-1653,-3234,10424,69646,76603,68705,67124,80782
46015,SD,7128,30324,7047,9589,6547,4046,4576,30324,7198.679976,9622,9589,67908,5792,-2106,-3951,9971,69257,73700,65802,63957,77879
46017,SD,8304,30324,7047,9589,6547,4046,4712,30324,7299.714081,9622,9589,69185,6245,-1653,-3234,10424,70569,75430,67532,65951,79609
46019,SD,7128,30324,7047,9589,6547,4046,4576,30324,7577.557869,9622,9589,68287,5792,-2106,-3951,9971,69257,74079,66181,64336,78258
46021,SD,7128,30324,7047,9589,6547,4046,4576,30324,6845.060609,9622,9589,67554,5792,-2106,-3951,9971,69257,73346,65448,63603,77525
46023,SD,7128,30324,7047,9589,6547,4046,4576,30324,7173.42145,9622,9589,67882,5792,-2106,-3951,9971,69257,73674,65776,63931,77853
46025,SD,7128,30324,7047,9589,6547,4046,4576,30324,7375.489659,9622,9589,68084,5792,-2106,-3951,9971,69257,73876,65978,64133,78055
46027,SD,7800,30324,7047,9589,6547,4046,4654,35308,7021.870292,9622,8630,72428,7151,-555,-1800,11330,70007,79579,71873,70628,83758
46029,SD,7152,30324,7047,9589,6547,4046,4579,32695,7274.455555,9622,9396,70186,6245,-1653,-3234,10424,69284,76431,68533,66952,80610
46031,SD,7128,30324,7047,9589,6547,4046,4576,30324,6845.060609,9622,9589,67554,5792,-2106,-3951,9971,69257,73346,65448,63603,77525
46033,SD,8460,30324,7047,9589,6547,4046,4730,33333,7552.299343,9622,9491,72505,6698,-1200,-2517,10877,70743,79203,71305,69988,83382
46035,SD,7704,30324,7047,9589,6547,4046,4643,31003,7122.904397,9622,9309,68807,6245,-1653,-3234,10424,69900,75052,67154,65573,79231
46037,SD,7128,30324,7047,9589,6547,4046,4576,30324,7299.714081,9622,9589,68009,5792,-2106,-3951,9971,69257,73801,65903,64058,77980
46039,SD,7128,30324,7047,9589,6547,4046,4576,30324,7451.265238,9622,9589,68160,5792,-2106,-3951,9971,69257,73952,66054,64209,78131
46041,SD,7128,30324,7047,9589,6547,4046,4576,30324,7350.231133,9622,9589,68059,5792,-2106,-3951,9971,69257,73851,65953,64108,78030
46043,SD,7128,30324,7047,9589,6547,4046,4576,30324,7249.197028,9622,9589,67958,5792,-2106,-3951,9971,69257,73750,65852,64007,77929
46045,SD,7872,30324,7047,9589,6547,4046,4662,28147,7400.748186,9622,9470,66557,5792,-2106,-3951,9971,70087,72349,64451,62606,76528
46047,SD,8892,30324,7047,9589,6547,4046,4780,30324,7451.265238,9622,9589,69924,6245,-1653,-3234,10424,71225,76169,68271,66690,80348
46049,SD,7128,30324,7047,9589,6547,4046,4576,30324,7274.455555,9622,9589,67983,5792,-2106,-3951,9971,69257,73775,65877,64032,77954
46051,SD,7128,30324,7047,9589,6547,4046,4576,30324,7426.006712,9622,9589,68135,5792,-2106,-3951,9971,69257,73927,66029,64184,78106
46053,SD,7128,30324,7047,9589,6547,4046,4576,30324,6870.319135,9622,9589,67579,5792,-2106,-3951,9971,69257,73371,65473,63628,77550
46055,SD,7128,30324,7047,9589,6547,4046,4576,30324,7426.006712,9622,9589,68135,5792,-2106,-3951,9971,69257,73927,66029,64184,78106
46057,SD,7128,30324,7047,9589,6547,4046,4576,30324,7451.265238,9622,9589,68160,5792,-2106,-3951,9971,69257,73952,66054,64209,78131
46059,SD,7128,30324,7047,9589,6547,4046,4576,30324,7274.455555,9622,9589,67983,5792,-2106,-3951,9971,69257,73775,65877,64032,77954
46061,SD,7200,30324,7047,9589,6547,4046,4585,28284,7198.679976,9622,9355,65706,5339,-2559,-4668,9518,69338,71045,63147,61038,75224
46063,SD,7128,30324,7047,9589,6547,4046,4576,30324,7956.435763,9622,9589,68665,5792,-2106,-3951,9971,69257,74457,66559,64714,78636
46065,SD,7680,30324,7047,9589,6547,4046,4640,35382,7223.938502,9622,9704,73658,7151,-555,-1800,11330,69873,80809,73103,71858,84988
46067,SD,7128,30324,7047,9589,6547,4046,4576,30324,7148.162923,9622,9589,67857,5792,-2106,-3951,9971,69257,73649,65751,63906,77828
46069,SD,7128,30324,7047,9589,6547,4046,4576,30324,7299.714081,9622,9589,68009,5792,-2106,-3951,9971,69257,73801,65903,64058,77980
46071,SD,7128,30324,7047,9589,6547,4046,4576,30324,7451.265238,9622,9589,68160,5792,-2106,-3951,9971,69257,73952,66054,64209,78131
46073,SD,7128,30324,7047,9589,6547,4046,4576,30324,7173.42145,9622,9589,67882,5792,-2106,-3951,9971,69257,73674,65776,63931,77853
46075,SD,7128,30324,7047,9589,6547,4046,4576,30324,7274.455555,9622,9589,67983,5792,-2106,-3951,9971,69257,73775,65877,64032,77954
46077,SD,7128,30324,7047,9589,6547,4046,4576,30324,7350.231133,9622,9589,68059,5792,-2106,-3951,9971,69257,73851,65953,64108,78030
46079,SD,7128,30324,7047,9589,6547,4046,4576,30324,7148.162923,9622,9589,67857,5792,-2106,-3951,9971,69257,73649,65751,63906,77828
46081,SD,7296,30324,7047,9589,6547,4046,4596,34885,8310.05513,9622,8974,73133,6698,-1200,-2517,10877,69445,79831,71933,70616,84010
46083,SD,9120,30324,7047,9589,6547,4046,4806,38942,8512.12334,9622,9876,80118,8510,1764,351,12689,71479,88628,81882,80469,92807
46085,SD,7128,30324,7047,9589,6547,4046,4576,30324,7274.455555,9622,9589,67983,5792,-2106,-3951,9971,69257,73775,65877,64032,77954
46087,SD,9120,30324,7047,9589,6547,4046,4806,27673,7173.42145,9622,9850,67484,5792,-2106,-3951,9971,71479,73276,65378,63533,77455
46089,SD,7128,30324,7047,9589,6547,4046,4576,30324,7527.040817,9622,9589,68236,5792,-2106,-3951,9971,69257,74028,66130,64285,78207
46091,SD,7128,30324,7047,9589,6547,4046,4576,30324,7426.006712,9622,9589,68135,5792,-2106,-3951,9971,69257,73927,66029,64184,78106
46093,SD,7860,30324,7047,9589,6547,4046,4661,35963,6314.631558,9622,9483,73288,7604,218,-1083,11783,70074,80892,73506,72205,85071
46095,SD,7128,30324,7047,9589,6547,4046,4576,30324,7552.299343,9622,9589,68261,5792,-2106,-3951,9971,69257,74053,66155,64310,78232
46097,SD,7128,30324,7047,9589,6547,4046,4576,30324,7375.489659,9622,9589,68084,5792,-2106,-3951,9971,69257,73876,65978,64133,78055
46099,SD,9120,30324,7047,9589,6547,4046,4806,34624,7097.645871,9622,9904,74413,7604,218,-1083,11783,71479,82017,74631,73330,86196
46101,SD,7128,30324,7047,9589,6547,4046,4576,30324,7148.162923,9622,9589,67857,5792,-2106,-3951,9971,69257,73649,65751,63906,77828
46103,SD,9312,30324,7047,9589,6547,4046,4828,36504,7476.523764,9622,9473,76433,8057,991,-366,12236,71693,84490,77424,76067,88669
46105,SD,7680,30324,7047,9589,6547,4046,4640,30324,7299.714081,9622,9589,68561,6245,-1653,-3234,10424,69873,74806,66908,65327,78985
46107,SD,7128,30324,7047,9589,6547,4046,4576,30324,7274.455555,9622,9589,67983,5792,-2106,-3951,9971,69257,73775,65877,64032,77954
46109,SD,7128,30324,7047,9589,6547,4046,4576,30324,7274.455555,9622,9589,67983,5792,-2106,-3951,9971,69257,73775,65877,64032,77954
46111,SD,7128,30324,7047,9589,6547,4046,4576,30324,7173.42145,9622,9589,67882,5792,-2106,-3951,9971,69257,73674,65776,63931,77853
46113,SD,7128,30324,7047,9589,6547,4046,4576,30324,7451.265238,9622,9589,68160,5792,-2106,-3951,9971,69257,73952,66054,64209,78131
46115,SD,7128,30324,7047,9589,6547,4046,4576,30324,7249.197028,9622,9589,67958,5792,-2106,-3951,9971,69257,73750,65852,64007,77929
46117,SD,8460,30324,7047,9589,6547,4046,4730,35793,7350.231133,9622,9695,74967,7604,218,-1083,11783,70743,82571,75185,73884,86750
46119,SD,8184,30324,7047,9589,6547,4046,4698,31600,7274.455555,9622,9685,70412,6698,-1200,-2517,10877,70435,77110,69212,67895,81289
46121,SD,7128,30324,7047,9589,6547,4046,4576,30324,7148.162923,9622,9589,67857,5792,-2106,-3951,9971,69257,73649,65751,63906,77828
46123,SD,7128,30324,7047,9589,6547,4046,4576,30324,7223.938502,9622,9589,67933,5792,-2106,-3951,9971,69257,73725,65827,63982,77904
46125,SD,9120,30324,7047,9589,6547,4046,4806,28729,7148.162923,9622,9851,68516,6245,-1653,-3234,10424,71479,74761,66863,65282,78940
46127,SD,8352,30324,7047,9589,6547,4046,4717,33735,6996.611766,9622,9639,72390,7151,-555,-1800,11330,70622,79541,71835,70590,83720
46129,SD,7128,30324,7047,9589,6547,4046,4576,30324,7299.714081,9622,9589,68009,5792,-2106,-3951,9971,69257,73801,65903,64058,77980
46135,SD,7128,30324,7047,9589,6547,4046,4576,32750,7223.938502,9622,9390,70160,6245,-1653,-3234,10424,69257,76405,68507,66926,80584
46137,SD,7128,30324,7047,9589,6547,4046,4576,30324,7426.006712,9622,9589,68135,5792,-2106,-3951,9971,69257,73927,66029,64184,78106
47001,TN,9288,10381,6898,9859,5990,4284,7089,10152,7664.58455,8606,9344,49339,8210,-3756,-7977,8321,53789,57549,45583,41362,57660
47003,TN,7392,10381,6898,9859,5990,4284,6757,9660,7071.197359,8606,9526,46539,7637,-4329,-8814,7748,51561,54176,42210,37725,54287
47005,TN,6756,10381,6898,9859,5990,4284,6645,10381,7120.646291,8606,9859,47007,7637,-4329,-8814,7748,50813,54644,42678,38193,54755
47007,TN,6756,10381,6898,9859,5990,4284,6645,10381,7244.268623,8606,9859,47130,7637,-4329,-8814,7748,50813,54767,42801,38316,54878
47009,TN,9288,10381,6898,9859,5990,4284,7089,10146,7639.860083,8606,9343,49307,8210,-3756,-7977,8321,53789,57517,45551,41330,57628
47011,TN,7788,10381,6898,9859,5990,4284,6826,9957,6972.299494,8606,9304,46911,7637,-4329,-8814,7748,52026,54548,42582,38097,54659
47013,TN,6756,10381,6898,9859,5990,4284,6645,9372,7194.81969,8606,9357,45570,7351,-4615,-9232,7462,50813,52921,40955,36338,53032
47015,TN,10212,10381,6898,9859,5990,4284,7251,9474,6922.850561,8606,9872,49371,8497,-3469,-7558,8608,54875,57868,45902,41813,57979
47017,TN,6756,10381,6898,9859,5990,4284,6645,10381,7071.197359,8606,9859,46957,7637,-4329,-8814,7748,50813,54594,42628,38143,54705
47019,TN,7752,10381,6898,9859,5990,4284,6820,9795,7343.166488,8606,8745,46525,7637,-4329,-8814,7748,51984,54162,42196,37711,54273
47021,TN,10212,10381,6898,9859,5990,4284,7251,9803,7293.717555,8606,9872,50071,8497,-3469,-7558,8608,54875,58568,46602,42513,58679
47023,TN,8220,10381,6898,9859,5990,4284,6902,9535,7046.472893,8606,9438,47129,7637,-4329,-8814,7748,52534,54766,42800,38315,54877
47025,TN,6756,10381,6898,9859,5990,4284,6645,10381,6774.503763,8606,9859,46661,7637,-4329,-8814,7748,50813,54298,42332,37847,54409
47027,TN,6756,10381,6898,9859,5990,4284,6645,10381,6823.952696,8606,9859,46710,7637,-4329,-8814,7748,50813,54347,42381,37896,54458
47029,TN,6756,10381,6898,9859,5990,4284,6645,10355,7046.472893,8606,8316,45364,7351,-4615,-9232,7462,50813,52715,40749,36132,52826
47031,TN,7380,10381,6898,9859,5990,4284,6755,9986,7268.993089,8606,9153,46679,7637,-4329,-8814,7748,51547,54316,42350,37865,54427
47033,TN,6984,10381,6898,9859,5990,4284,6685,8639,7046.472893,8606,9443,45002,6950,-5016,-9651,7061,51081,51952,39986,35351,52063
47035,TN,7056,10381,6898,9859,5990,4284,6698,9673,7442.064353,8606,8480,45541,6950,-5016,-9651,7061,51166,52491,40525,35890,52602
47037,TN,10212,10381,6898,9859,5990,4284,7251,12450,7194.81969,8606,9876,52623,9356,-2610,-6303,9467,54875,61979,50013,46320,62090
47039,TN,6756,10381,6898,9859,5990,4284,6645,10381,7120.646291,8606,9859,47007,7637,-4329,-8814,7748,50813,54644,42678,38193,54755
47041,TN,6756,10381,6898,9859,5990,4284,6645,10381,6799.22823,8606,9859,46685,7637,-4329,-8814,7748,50813,54322,42356,37871,54433
47043,TN,10212,10381,6898,9859,5990,4284,7251,9999,6527.2591,8606,9872,49500,8497,-3469,-7558,8608,54875,57997,46031,41942,58108
47045,TN,6924,10381,6898,9859,5990,4284,6675,9065,7021.748426,8606,8947,44848,6950,-5016,-9651,7061,51011,51798,39832,35197,51909
47047,TN,9360,10381,6898,9859,5990,4284,7102,9944,7442.064353,8606,9774,49410,8210,-3756,-7977,8321,53874,57620,45654,41433,57731
47049,TN,6756,10381,6898,9859,5990,4284,6645,10381,6947.575027,8606,9859,46834,7637,-4329,-8814,7748,50813,54471,42505,38020,54582
47051,TN,6996,10381,6898,9859,5990,4284,6687,9048,7145.370758,8606,9184,45264,7351,-4615,-9232,7462,51095,52615,40649,36032,52726
47053,TN,6756,10381,6898,9859,5990,4284,6645,10381,7219.544157,8606,9859,47106,7637,-4329,-8814,7748,50813,54743,42777,38292,54854
47055,TN,7428,10381,6898,9859,5990,4284,6763,10381,7095.921825,8606,9859,47654,7924,-4042,-8395,8035,51603,55578,43612,39259,55689
47057,TN,7644,10381,6898,9859,5990,4284,6801,10083,7714.033482,8606,9369,47700,7637,-4329,-8814,7748,51857,55337,43371,38886,55448
47059,TN,7008,10381,6898,9859,5990,4284,6690,9929,7071.197359,8606,8550,45448,7351,-4615,-9232,7462,51110,52799,40833,36216,52910
47061,TN,6756,10381,6898,9859,5990,4284,6645,10381,7268.993089,8606,9859,47155,7637,-4329,-8814,7748,50813,54792,42826,38341,54903
47063,TN,7644,10381,6898,9859,5990,4284,6801,9586,7021.748426,8606,8945,46087,7351,-4615,-9232,7462,51857,53438,41472,36855,53549
47065,TN,8148,10381,6898,9859,5990,4284,6889,10488,7367.890954,8606,9486,48380,7924,-4042,-8395,8035,52449,56304,44338,39985,56415
47067,TN,6756,10381,6898,9859,5990,4284,6645,10381,7021.748426,8606,9859,46908,7637,-4329,-8814,7748,50813,54545,42579,38094,54656
47069,TN,6756,10381,6898,9859,5990,4284,6645,10381,7095.921825,8606,9859,46982,7637,-4329,-8814,7748,50813,54619,42653,38168,54730
47071,TN,6756,10381,6898,9859,5990,4284,6645,10381,7021.748426,8606,9859,46908,7637,-4329,-8814,7748,50813,54545,42579,38094,54656
47073,TN,7404,10381,6898,9859,5990,4284,6759,9852,7071.197359,8606,8774,45991,7351,-4615,-9232,7462,51575,53342,41376,36759,53453
47075,TN,7656,10381,6898,9859,5990,4284,6803,10381,7095.921825,8606,9859,47882,7924,-4042,-8395,8035,51871,55806,43840,39487,55917
47077,TN,6780,10381,6898,9859,5990,4284,6650,10381,7194.81969,8606,9859,47105,7637,-4329,-8814,7748,50842,54742,42776,38291,54853
47079,TN,6948,10381,6898,9859,5990,4284,6679,9894,6972.299494,8606,8598,45302,7351,-4615,-9232,7462,51039,52653,40687,36070,52764
47081,TN,7584,10381,6898,9859,5990,4284,6791,10117,7540.962218,8606,9871,48004,7924,-4042,-8395,8035,51787,55928,43962,39609,56039
47083,TN,6756,10381,6898,9859,5990,4284,6645,10381,6922.850561,8606,9859,46809,7637,-4329,-8814,7748,50813,54446,42480,37995,54557
47085,TN,6756,10381,6898,9859,5990,4284,6645,10381,6774.503763,8606,9859,46661,7637,-4329,-8814,7748,50813,54298,42332,37847,54409
47087,TN,6756,10381,6898,9859,5990,4284,6645,9679,6873.401628,8606,8663,44862,6950,-5016,-9651,7061,50813,51812,39846,35211,51923
47089,TN,7644,10381,6898,9859,5990,4284,6801,10399,7417.339887,8606,8969,47320,7637,-4329,-8814,7748,51857,54957,42991,38506,55068
47091,TN,6756,10381,6898,9859,5990,4284,6645,10381,7392.615421,8606,9859,47279,7637,-4329,-8814,7748,50813,54916,42950,38465,55027
47093,TN,9288,10381,6898,9859,5990,4284,7089,10888,7318.442022,8606,9343,49727,8497,-3469,-7558,8608,53789,58224,46258,42169,58335
47095,TN,6756,10381,6898,9859,5990,4284,6645,10381,6428.361235,8606,9859,46314,7637,-4329,-8814,7748,50813,53951,41985,37500,54062
47097,TN,6756,10381,6898,9859,5990,4284,6645,10381,6873.401628,8606,9859,46759,7637,-4329,-8814,7748,50813,54396,42430,37945,54507
47099,TN,6756,10381,6898,9859,5990,4284,6645,9314,6823.952696,8606,8962,44746,6950,-5016,-9651,7061,50813,51696,39730,35095,51807
47101,TN,6756,10381,6898,9859,5990,4284,6645,10381,6898.126095,8606,9859,46784,7637,-4329,-8814,7748,50813,54421,42455,37970,54532
47103,TN,6756,10381,6898,9859,5990,4284,6645,10381,7194.81969,8606,9859,47081,7637,-4329,-8814,7748,50813,54718,42752,38267,54829
47105,TN,9288,10381,6898,9859,5990,4284,7089,10098,7491.513286,8606,9357,49124,8210,-3756,-7977,8321,53789,57334,45368,41147,57445
47107,TN,7020,10381,6898,9859,5990,4284,6692,9913,7318.442022,8606,8910,46051,7351,-4615,-9232,7462,51124,53402,41436,36819,53513
47109,TN,6756,10381,6898,9859,5990,4284,6645,10381,6898.126095,8606,9859,46784,7637,-4329,-8814,7748,50813,54421,42455,37970,54532
47111,TN,6756,10381,6898,9859,5990,4284,6645,9702,7071.197359,8606,9872,46291,7637,-4329,-8814,7748,50813,53928,41962,37477,54039
47113,TN,8220,10381,6898,9859,5990,4284,6902,9708,7021.748426,8606,9401,47240,7924,-4042,-8395,8035,52534,55164,43198,38845,55275
47115,TN,8148,10381,6898,9859,5990,4284,6889,9573,7219.544157,8606,9508,47338,7924,-4042,-8395,8035,52449,55262,43296,38943,55373
47117,TN,7812,10381,6898,9859,5990,4284,6830,9304,6947.575027,8606,9532,46486,7637,-4329,-8814,7748,52054,54123,42157,37672,54234
47119,TN,7416,10381,6898,9859,5990,4284,6761,9916,6922.850561,8606,9873,47017,7637,-4329,-8814,7748,51589,54654,42688,38203,54765
47121,TN,6756,10381,6898,9859,5990,4284,6645,10381,7268.993089,8606,9859,47155,7637,-4329,-8814,7748,50813,54792,42826,38341,54903
47123,TN,6756,10381,6898,9859,5990,4284,6645,10381,7442.064353,8606,9859,47328,7637,-4329,-8814,7748,50813,54965,42999,38514,55076
47125,TN,9204,10381,6898,9859,5990,4284,7074,10194,6997.02396,8606,9713,48998,8210,-3756,-7977,8321,53690,57208,45242,41021,57319
47127,TN,7212,10381,6898,9859,5990,4284,6725,8738,7145.370758,8606,9214,45200,6950,-5016,-9651,7061,51349,52150,40184,35549,52261
47129,TN,6756,10381,6898,9859,5990,4284,6645,10057,7689.309016,8606,9386,46778,7351,-4615,-9232,7462,50813,54129,42163,37546,54240
47131,TN,6756,10381,6898,9859,5990,4284,6645,9244,7046.472893,8606,8766,44702,6950,-5016,-9651,7061,50813,51652,39686,35051,51763
47133,TN,6756,10381,6898,9859,5990,4284,6645,9503,7738.757949,8606,8644,45532,6950,-5016,-9651,7061,50813,52482,40516,35881,52593
47135,TN,6756,10381,6898,9859,5990,4284,6645,10381,7194.81969,8606,9859,47081,7637,-4329,-8814,7748,50813,54718,42752,38267,54829
47137,TN,6756,10381,6898,9859,5990,4284,6645,10381,6823.952696,8606,9859,46710,7637,-4329,-8814,7748,50813,54347,42381,37896,54458
47139,TN,7788,10381,6898,9859,5990,4284,6826,9573,7021.748426,8606,9355,46628,7637,-4329,-8814,7748,52026,54265,42299,37814,54376
47141,TN,7176,10381,6898,9859,5990,4284,6719,10079,6749.779297,8606,8554,45449,7351,-4615,-9232,7462,51307,52800,40834,36217,52911
47143,TN,6756,10381,6898,9859,5990,4284,6645,10211,7367.890954,8606,8800,46024,7351,-4615,-9232,7462,50813,53375,41409,36792,53486
47145,TN,7296,10381,6898,9859,5990,4284,6740,9964,7343.166488,8606,9353,46845,7637,-4329,-8814,7748,51448,54482,42516,38031,54593
47147,TN,10212,10381,6898,9859,5990,4284,7251,9589,6675.605898,8606,9872,49239,8497,-3469,-7558,8608,54875,57736,45770,41681,57847
47149,TN,10212,10381,6898,9859,5990,4284,7251,10610,7021.748426,8606,9873,50607,8783,-3183,-7140,8894,54875,59390,47424,43467,59501
47151,TN,6756,10381,6898,9859,5990,4284,6645,10381,7244.268623,8606,9859,47130,7637,-4329,-8814,7748,50813,54767,42801,38316,54878
47153,TN,8148,10381,6898,9859,5990,4284,6889,9935,7145.370758,8606,9504,47623,7924,-4042,-8395,8035,52449,55547,43581,39228,55658
47155,TN,8676,10381,6898,9859,5990,4284,6982,10524,7689.309016,8606,9503,49282,8210,-3756,-7977,8321,53070,57492,45526,41305,57603
47157,TN,9360,10381,6898,9859,5990,4284,7102,11029,6898.126095,8606,9778,49955,8497,-3469,-7558,8608,53874,58452,46486,42397,58563
47159,TN,6876,10381,6898,9859,5990,4284,6666,9868,6774.503763,8606,9872,46280,7637,-4329,-8814,7748,50954,53917,41951,37466,54028
47161,TN,6756,10381,6898,9859,5990,4284,6645,10381,6947.575027,8606,9859,46834,7637,-4329,-8814,7748,50813,54471,42505,38020,54582
47163,TN,7404,10381,6898,9859,5990,4284,6759,9823,7516.237752,8606,8764,46397,7351,-4615,-9232,7462,51575,53748,41782,37165,53859
47165,TN,10212,10381,6898,9859,5990,4284,7251,10475,6774.503763,8606,9874,50225,8783,-3183,-7140,8894,54875,59008,47042,43085,59119
47167,TN,9360,10381,6898,9859,5990,4284,7102,9768,7170.095224,8606,9773,48961,8210,-3756,-7977,8321,53874,57171,45205,40984,57282
47169,TN,10212,10381,6898,9859,5990,4284,7251,9894,6749.779297,8606,9872,49617,8497,-3469,-7558,8608,54875,58114,46148,42059,58225
47171,TN,7752,10381,6898,9859,5990,4284,6820,9190,7244.268623,8606,8751,45826,7351,-4615,-9232,7462,51984,53177,41211,36594,53288
47173,TN,9288,10381,6898,9859,5990,4284,7089,10310,7343.166488,8606,9367,49198,8210,-3756,-7977,8321,53789,57408,45442,41221,57519
47175,TN,6756,10381,6898,9859,5990,4284,6645,10381,7021.748426,8606,9859,46908,7637,-4329,-8814,7748,50813,54545,42579,38094,54656
47177,TN,6756,10381,6898,9859,5990,4284,6645,9254,6997.02396,8606,8771,44668,6950,-5016,-9651,7061,50813,51618,39652,35017,51729
47179,TN,7752,10381,6898,9859,5990,4284,6820,10681,7268.993089,8606,8733,47325,7637,-4329,-8814,7748,51984,54962,42996,38511,55073
47181,TN,6756,10381,6898,9859,5990,4284,6645,10381,6873.401628,8606,9859,46759,7637,-4329,-8814,7748,50813,54396,42430,37945,54507
47183,TN,6756,10381,6898,9859,5990,4284,6645,9462,7417.339887,8606,8645,45170,6950,-5016,-9651,7061,50813,52120,40154,35519,52231
47185,TN,7128,10381,6898,9859,5990,4284,6711,10381,6898.126095,8606,9859,47156,7924,-4042,-8395,8035,51251,55080,43114,38761,55191
47187,TN,10212,10381,6898,9859,5990,4284,7251,12051,7367.890954,8606,9874,52395,8783,-3183,-7140,8894,54875,61178,49212,45255,61289
47189,TN,10212,10381,6898,9859,5990,4284,7251,10241,6675.605898,8606,9873,49892,8783,-3183,-7140,8894,54875,58675,46709,42752,58786
48001,TX,8040,5523,6898,9859,6534,4284,4716,5835,6527.2591,7910,9364,41960,3828,-7984,-12502,4093,45854,45788,33976,29458,46053
48003,TX,7644,5523,6898,9859,6534,4284,4670,5571,6403.636769,7910,10368,42180,3828,-7984,-12502,4093,45412,46008,34196,29678,46273
48005,TX,8556,5523,6898,9859,6534,4284,4775,5762,6329.46337,7910,9546,42387,3828,-7984,-12502,4093,46429,46215,34403,29885,46480
48007,TX,8424,5523,6898,9859,6534,4284,4760,6347,6181.116572,7910,9823,42969,4195,-7617,-12194,4460,46282,47164,35352,30775,47429
48009,TX,8544,5523,6898,9859,6534,4284,4774,5380,6329.46337,7910,9586,42033,3828,-7984,-12502,4093,46416,45861,34049,29531,46126
48011,TX,8832,5523,6898,9859,6534,4284,4807,4902,6774.503763,7910,9830,42532,3828,-7984,-12502,4093,46737,46360,34548,30030,46625
48013,TX,8268,5523,6898,9859,6534,4284,4742,6074,6205.841039,7910,10072,42813,4195,-7617,-12194,4460,46108,47008,35196,30619,47273
48015,TX,8400,5523,6898,9859,6534,4284,4757,6108,6972.299494,7910,10313,43987,4195,-7617,-12194,4460,46255,48182,36370,31793,48447
48017,TX,7848,5523,6898,9859,6534,4284,4693,5523,6922.850561,7910,9859,42347,3828,-7984,-12502,4093,45639,46175,34363,29845,46440
48019,TX,10284,5523,6898,9859,6534,4284,4974,6189,7046.472893,7910,10070,45784,4950,-6862,-11479,5215,48356,50734,38922,34305,50999
48021,TX,12888,5523,6898,9859,6534,4284,5274,6335,5859.698511,7910,10484,47761,5629,-6183,-10404,5894,51260,53390,41578,37357,53655
48023,TX,7644,5523,6898,9859,6534,4284,4670,5523,6280.014438,7910,9859,41500,3828,-7984,-12502,4093,45412,45328,33516,28998,45593
48025,TX,7932,5523,6898,9859,6534,4284,4703,5476,5513.555983,7910,9296,40412,3462,-8350,-12811,3727,45733,43874,32062,27601,44139
48027,TX,8808,5523,6898,9859,6534,4284,4804,6120,5859.698511,7910,10180,43162,4609,-7203,-11838,4874,46710,47771,35959,31324,48036
48029,TX,10284,5523,6898,9859,6534,4284,4974,6130,6082.218707,7910,10114,44805,4950,-6862,-11479,5215,48356,49755,37943,33326,50020
48031,TX,9660,5523,6898,9859,6534,4284,4902,5523,6403.636769,7910,9859,43640,4609,-7203,-11838,4874,47660,48249,36437,31802,48514
48033,TX,7836,5523,6898,9859,6534,4284,4692,5523,6057.494241,7910,9859,41469,3828,-7984,-12502,4093,45626,45297,33485,28967,45562
48035,TX,7644,5523,6898,9859,6534,4284,4670,5523,5958.596376,7910,9859,41179,3828,-7984,-12502,4093,45412,45007,33195,28677,45272
48037,TX,8448,5523,6898,9859,6534,4284,4763,5768,6230.565505,7910,9369,42009,3828,-7984,-12502,4093,46309,45837,34025,29507,46102
48039,TX,9936,5523,6898,9859,6534,4284,4934,6401,6576.708033,7910,10353,45461,4950,-6862,-11479,5215,47968,50411,38599,33982,50676
48041,TX,10416,5523,6898,9859,6534,4284,4989,6651,6354.187836,7910,9238,44853,4950,-6862,-11479,5215,48503,49803,37991,33374,50068
48043,TX,8916,5523,6898,9859,6534,4284,4816,5523,6997.02396,7910,9859,43489,4195,-7617,-12194,4460,46830,47684,35872,31295,47949
48045,TX,7644,5523,6898,9859,6534,4284,4670,5523,6675.605898,7910,9859,41896,3828,-7984,-12502,4093,45412,45724,33912,29394,45989
48047,TX,7644,5523,6898,9859,6534,4284,4670,5523,5464.10705,7910,9859,40684,3828,-7984,-12502,4093,45412,44512,32700,28182,44777
48049,TX,8028,5523,6898,9859,6534,4284,4714,5631,6601.432499,7910,9105,41560,3462,-8350,-12811,3727,45840,45022,33210,28749,45287
48051,TX,10416,5523,6898,9859,6534,4284,4989,5839,6378.912303,7910,9254,44081,4609,-7203,-11838,4874,48503,48690,36878,32243,48955
48053,TX,8184,5523,6898,9859,6534,4284,4732,5523,6106.943174,7910,9859,41867,3828,-7984,-12502,4093,46014,45695,33883,29365,45960
48055,TX,12888,5523,6898,9859,6534,4284,5274,6188,5464.10705,7910,10508,47242,5629,-6183,-10404,5894,51260,52871,41059,36838,53136
48057,TX,8520,5523,6898,9859,6534,4284,4771,5736,5736.076179,7910,9640,41826,3828,-7984,-12502,4093,46389,45654,33842,29324,45919
48059,TX,9480,5523,6898,9859,6534,4284,4881,5642,6205.841039,7910,9549,43070,4195,-7617,-12194,4460,47459,47265,35453,30876,47530
48061,TX,8112,5523,6898,9859,6534,4284,4724,5721,5216.862387,7910,9481,40725,3828,-7984,-12502,4093,45934,44553,32741,28223,44818
48063,TX,7644,5523,6898,9859,6534,4284,4670,5523,6576.708033,7910,9859,41797,3828,-7984,-12502,4093,45412,45625,33813,29295,45890
48065,TX,8832,5523,6898,9859,6534,4284,4807,5248,6774.503763,7910,9831,42880,4195,-7617,-12194,4460,46737,47075,35263,30686,47340
48067,TX,7644,5523,6898,9859,6534,4284,4670,5523,6601.432499,7910,9859,41821,3828,-7984,-12502,4093,45412,45649,33837,29319,45914
48069,TX,7644,5523,6898,9859,6534,4284,4670,5523,7046.472893,7910,9859,42266,3828,-7984,-12502,4093,45412,46094,34282,29764,46359
48071,TX,11112,5523,6898,9859,6534,4284,5069,6251,7639.860083,7910,10318,47515,5176,-6636,-11121,5441,49279,52691,40879,36394,52956
48073,TX,7644,5523,6898,9859,6534,4284,4670,5689,6502.534634,7910,9086,41116,3462,-8350,-12811,3727,45412,44578,32766,28305,44843
48075,TX,7968,5523,6898,9859,6534,4284,4707,5523,6725.054831,7910,9859,42269,3828,-7984,-12502,4093,45773,46097,34285,29767,46362
48077,TX,8544,5523,6898,9859,6534,4284,4774,5357,6230.565505,7910,9583,41909,3828,-7984,-12502,4093,46416,45737,33925,29407,46002
48079,TX,7644,5523,6898,9859,6534,4284,4670,5523,6675.605898,7910,9859,41896,3828,-7984,-12502,4093,45412,45724,33912,29394,45989
48081,TX,7644,5523,6898,9859,6534,4284,4670,5523,6057.494241,7910,9859,41277,3828,-7984,-12502,4093,45412,45105,33293,28775,45370
48083,TX,7644,5523,6898,9859,6534,4284,4670,5523,6181.116572,7910,9859,41401,3828,-7984,-12502,4093,45412,45229,33417,28899,45494
48085,TX,10956,5523,6898,9859,6534,4284,5051,6904,7120.646291,7910,10277,47452,5403,-6409,-10762,5668,49105,52855,41043,36690,53120
48087,TX,7644,5523,6898,9859,6534,4284,4670,5523,6799.22823,7910,9859,42019,3828,-7984,-12502,4093,45412,45847,34035,29517,46112
48089,TX,7644,5523,6898,9859,6534,4284,4670,5523,5884.422977,7910,9859,41104,3828,-7984,-12502,4093,45412,44932,33120,28602,45197
48091,TX,10284,5523,6898,9859,6534,4284,4974,6391,6725.054831,7910,10081,45675,4950,-6862,-11479,5215,48356,50625,38813,34196,50890
48093,TX,7644,5523,6898,9859,6534,4284,4670,5523,6477.810168,7910,9859,41698,3828,-7984,-12502,4093,45412,45526,33714,29196,45791
48095,TX,12204,5523,6898,9859,6534,4284,5195,5523,6106.943174,7910,9859,45887,5176,-6636,-11121,5441,50497,51063,39251,34766,51328
48097,TX,9756,5523,6898,9859,6534,4284,4913,5751,7244.268623,7910,9760,44705,4609,-7203,-11838,4874,47767,49314,37502,32867,49579
48099,TX,8808,5523,6898,9859,6534,4284,4804,5891,6082.218707,7910,10158,43134,4195,-7617,-12194,4460,46710,47329,35517,30940,47594
48101,TX,7644,5523,6898,9859,6534,4284,4670,5523,6725.054831,7910,9859,41945,3828,-7984,-12502,4093,45412,45773,33961,29443,46038
48103,TX,8952,5523,6898,9859,6534,4284,4821,5523,6304.738904,7910,9859,42833,4195,-7617,-12194,4460,46871,47028,35216,30639,47293
48105,TX,7644,5523,6898,9859,6534,4284,4670,5523,5736.076179,7910,9859,40956,3828,-7984,-12502,4093,45412,44784,32972,28454,45049
48107,TX,9288,5523,6898,9859,6534,4284,4859,4846,6551.983567,7910,9690,42569,3828,-7984,-12502,4093,47245,46397,34585,30067,46662
48109,TX,7644,5523,6898,9859,6534,4284,4670,5523,6453.085702,7910,9859,41673,3828,-7984,-12502,4093,45412,45501,33689,29171,45766
48111,TX,7644,5523,6898,9859,6534,4284,4670,5523,6725.054831,7910,9859,41945,3828,-7984,-12502,4093,45412,45773,33961,29443,46038
48113,TX,10956,5523,6898,9859,6534,4284,5051,6704,6749.779297,7910,10311,46914,5403,-6409,-10762,5668,49105,52317,40505,36152,52582
48115,TX,7644,5523,6898,9859,6534,4284,4670,4909,6428.361235,7910,8775,39950,3095,-8717,-13119,3360,45412,43045,31233,26831,43310
48117,TX,7656,5523,6898,9859,6534,4284,4671,5377,6774.503763,7910,9892,41894,3828,-7984,-12502,4093,45425,45722,33910,29392,45987
48119,TX,10956,5523,6898,9859,6534,4284,5051,5523,6700.330364,7910,9859,45232,4950,-6862,-11479,5215,49105,50182,38370,33753,50447
48121,TX,10956,5523,6898,9859,6534,4284,5051,6781,7095.921825,7910,10285,47312,5403,-6409,-10762,5668,49105,52715,40903,36550,52980
48123,TX,7644,5523,6898,9859,6534,4284,4670,5523,5266.31132,7910,9859,40486,3828,-7984,-12502,4093,45412,44314,32502,27984,44579
48125,TX,7644,5523,6898,9859,6534,4284,4670,5523,6551.983567,7910,9859,41772,3828,-7984,-12502,4093,45412,45600,33788,29270,45865
48127,TX,7644,5523,6898,9859,6534,4284,4670,5523,5167.413455,7910,9859,40387,3828,-7984,-12502,4093,45412,44215,32403,27885,44480
48129,TX,7644,5523,6898,9859,6534,4284,4670,5523,6972.299494,7910,9859,42192,3828,-7984,-12502,4093,45412,46020,34208,29690,46285
48131,TX,8496,5523,6898,9859,6534,4284,4768,5523,5538.280449,7910,9859,41610,3828,-7984,-12502,4093,46362,45438,33626,29108,45703
48133,TX,7644,5523,6898,9859,6534,4284,4670,5523,6502.534634,7910,9859,41723,3828,-7984,-12502,4093,45412,45551,33739,29221,45816
48135,TX,11904,5523,6898,9859,6534,4284,5161,6125,6156.392106,7910,10104,46483,5403,-6409,-10762,5668,50163,51886,40074,35721,52151
48137,TX,7644,5523,6898,9859,6534,4284,4670,5523,5736.076179,7910,9859,40956,3828,-7984,-12502,4093,45412,44784,32972,28454,45049
48139,TX,10956,5523,6898,9859,6534,4284,5051,6072,6403.636769,7910,10244,45870,5176,-6636,-11121,5441,49105,51046,39234,34749,51311
48141,TX,8964,5523,6898,9859,6534,4284,4822,5812,6280.014438,7910,9953,43203,4195,-7617,-12194,4460,46884,47398,35586,31009,47663
48143,TX,8328,5523,6898,9859,6534,4284,4749,6033,6304.738904,7910,9221,42081,3828,-7984,-12502,4093,46175,45909,34097,29579,46174
48145,TX,7812,5523,6898,9859,6534,4284,4689,5332,5834.974044,7910,9603,40776,3462,-8350,-12811,3727,45599,44238,32426,27965,44503
48147,TX,7824,5523,6898,9859,6534,4284,4691,5523,6601.432499,7910,9859,42001,3828,-7984,-12502,4093,45613,45829,34017,29499,46094
48149,TX,7920,5523,6898,9859,6534,4284,4702,5523,5785.525112,7910,9859,41282,3828,-7984,-12502,4093,45720,45110,33298,28780,45375
48151,TX,7644,5523,6898,9859,6534,4284,4670,5523,6131.66764,7910,9859,41352,3828,-7984,-12502,4093,45412,45180,33368,28850,45445
48153,TX,7644,5523,6898,9859,6534,4284,4670,5523,6551.983567,7910,9859,41772,3828,-7984,-12502,4093,45412,45600,33788,29270,45865
48155,TX,7644,5523,6898,9859,6534,4284,4670,5523,6898.126095,7910,9859,42118,3828,-7984,-12502,4093,45412,45946,34134,29616,46211
48157,TX,11112,5523,6898,9859,6534,4284,5069,6492,6650.881432,7910,10345,46794,5403,-6409,-10762,5668,49279,52197,40385,36032,52462
48159,TX,7644,5523,6898,9859,6534,4284,4670,5523,6626.156966,7910,9859,41846,3828,-7984,-12502,4093,45412,45674,33862,29344,45939
48161,TX,9420,5523,6898,9859,6534,4284,4875,5523,6304.738904,7910,9859,43301,4195,-7617,-12194,4460,47393,47496,35684,31107,47761
48163,TX,7644,5523,6898,9859,6534,4284,4670,5523,6082.218707,7910,9859,41302,3828,-7984,-12502,4093,45412,45130,33318,28800,45395
48165,TX,7668,5523,6898,9859,6534,4284,4673,5523,6403.636769,7910,9859,41648,3828,-7984,-12502,4093,45439,45476,33664,29146,45741
48167,TX,11112,5523,6898,9859,6534,4284,5069,6336,6947.575027,7910,10363,46953,5176,-6636,-11121,5441,49279,52129,40317,35832,52394
48169,TX,7644,5523,6898,9859,6534,4284,4670,5523,6551.983567,7910,9859,41772,3828,-7984,-12502,4093,45412,45600,33788,29270,45865
48171,TX,10500,5523,6898,9859,6534,4284,4999,6098,6255.289971,7910,9482,44530,4950,-6862,-11479,5215,48597,49480,37668,33051,49745
48173,TX,7836,5523,6898,9859,6534,4284,4692,5800,6255.289971,7910,9503,41588,3828,-7984,-12502,4093,45626,45416,33604,29086,45681
48175,TX,8772,5523,6898,9859,6534,4284,4800,5694,5785.525112,7910,9884,42329,4195,-7617,-12194,4460,46670,46524,34712,30135,46789
48177,TX,7644,5523,6898,9859,6534,4284,4670,5523,6205.841039,7910,9859,41426,3828,-7984,-12502,4093,45412,45254,33442,28924,45519
48179,TX,7644,5523,6898,9859,6534,4284,4670,5212,7021.748426,7910,9262,41334,3462,-8350,-12811,3727,45412,44796,32984,28523,45061
48181,TX,9672,5523,6898,9859,6534,4284,4904,5774,6428.361235,7910,9509,43577,4609,-7203,-11838,4874,47674,48186,36374,31739,48451
48183,TX,9576,5523,6898,9859,6534,4284,4893,5918,6502.534634,7910,9650,43841,4609,-7203,-11838,4874,47567,48450,36638,32003,48715
48185,TX,7644,5523,6898,9859,6534,4284,4670,5523,6997.02396,7910,9859,42217,3828,-7984,-12502,4093,45412,46045,34233,29715,46310
48187,TX,10284,5523,6898,9859,6534,4284,4974,6009,6304.738904,7910,10083,44875,4950,-6862,-11479,5215,48356,49825,38013,33396,50090
48189,TX,7644,5523,6898,9859,6534,4284,4670,5174,6626.156966,7910,9575,41214,3462,-8350,-12811,3727,45412,44676,32864,28403,44941
48191,TX,7644,5523,6898,9859,6534,4284,4670,5523,6725.054831,7910,9859,41945,3828,-7984,-12502,4093,45412,45773,33961,29443,46038
48193,TX,7644,5523,6898,9859,6534,4284,4670,5523,6008.045308,7910,9859,41228,3828,-7984,-12502,4093,45412,45056,33244,28726,45321
48195,TX,7644,5523,6898,9859,6534,4284,4670,5523,6725.054831,7910,9859,41945,3828,-7984,-12502,4093,45412,45773,33961,29443,46038
48197,TX,7740,5523,6898,9859,6534,4284,4681,5523,6650.881432,7910,9859,41967,3828,-7984,-12502,4093,45519,45795,33983,29465,46060
48199,TX,9672,5523,6898,9859,6534,4284,4904,5992,6403.636769,7910,9469,43730,4609,-7203,-11838,4874,47674,48339,36527,31892,48604
48201,TX,11112,5523,6898,9859,6534,4284,5069,6682,6576.708033,7910,10404,46969,5403,-6409,-10762,5668,49279,52372,40560,36207,52637
48203,TX,7644,5523,6898,9859,6534,4284,4670,5909,6527.2591,7910,9736,42010,3828,-7984,-12502,4093,45412,45838,34026,29508,46103
48205,TX,7644,5523,6898,9859,6534,4284,4670,5523,6700.330364,7910,9859,41920,3828,-7984,-12502,4093,45412,45748,33936,29418,46013
48207,TX,7644,5523,6898,9859,6534,4284,4670,5523,6898.126095,7910,9859,42118,3828,-7984,-12502,4093,45412,45946,34134,29616,46211
48209,TX,12888,5523,6898,9859,6534,4284,5274,6647,6354.187836,7910,10514,48597,5856,-5956,-10045,6121,51260,54453,42641,38552,54718
48211,TX,8412,5523,6898,9859,6534,4284,4758,5523,6922.850561,7910,9859,42911,3828,-7984,-12502,4093,46268,46739,34927,30409,47004
48213,TX,8232,5523,6898,9859,6534,4284,4738,6086,6551.983567,7910,9234,42298,3828,-7984,-12502,4093,46068,46126,34314,29796,46391
48215,TX,7860,5523,6898,9859,6534,4284,4695,5739,5291.035786,7910,9695,40780,3828,-7984,-12502,4093,45653,44608,32796,28278,44873
48217,TX,8400,5523,6898,9859,6534,4284,4757,5523,6774.503763,7910,9859,42751,3828,-7984,-12502,4093,46255,46579,34767,30249,46844
48219,TX,8532,5523,6898,9859,6534,4284,4772,5470,6601.432499,7910,9995,42793,4195,-7617,-12194,4460,46402,46988,35176,30599,47253
48221,TX,10248,5523,6898,9859,6534,4284,4970,6404,7021.748426,7910,10250,46118,4950,-6862,-11479,5215,48316,51068,39256,34639,51333
48223,TX,8460,5523,6898,9859,6534,4284,4764,5630,6626.156966,7910,9436,42346,3828,-7984,-12502,4093,46322,46174,34362,29844,46439
48225,TX,7860,5523,6898,9859,6534,4284,4695,5523,5785.525112,7910,9859,41222,3828,-7984,-12502,4093,45653,45050,33238,28720,45315
48227,TX,7848,5523,6898,9859,6534,4284,4693,5359,6008.045308,7910,9425,40834,3462,-8350,-12811,3727,45639,44296,32484,28023,44561
48229,TX,7644,5523,6898,9859,6534,4284,4670,5774,6428.361235,7910,9887,41927,3828,-7984,-12502,4093,45412,45755,33943,29425,46020
48231,TX,10956,5523,6898,9859,6534,4284,5051,6043,6700.330364,7910,10249,46143,5176,-6636,-11121,5441,49105,51319,39507,35022,51584
48233,TX,8520,5523,6898,9859,6534,4284,4771,5278,7120.646291,7910,9501,42613,3828,-7984,-12502,4093,46389,46441,34629,30111,46706
48235,TX,8760,5523,6898,9859,6534,4284,4799,5225,5983.320842,7910,9628,41791,3828,-7984,-12502,4093,46657,45619,33807,29289,45884
48237,TX,7992,5523,6898,9859,6534,4284,4710,5523,7120.646291,7910,9859,42689,3828,-7984,-12502,4093,45800,46517,34705,30187,46782
48239,TX,9024,5523,6898,9859,6534,4284,4829,5523,5760.800645,7910,9859,42361,4195,-7617,-12194,4460,46951,46556,34744,30167,46821
48241,TX,8724,5523,6898,9859,6534,4284,4794,5523,6304.738904,7910,9859,42605,4195,-7617,-12194,4460,46616,46800,34988,30411,47065
48243,TX,7644,5523,6898,9859,6534,4284,4670,5523,7071.197359,7910,9859,42291,3828,-7984,-12502,4093,45412,46119,34307,29789,46384
48245,TX,9672,5523,6898,9859,6534,4284,4904,5769,6032.769775,7910,9441,43109,4195,-7617,-12194,4460,47674,47304,35492,30915,47569
48247,TX,7644,5523,6898,9859,6534,4284,4670,5523,5291.035786,7910,9859,40511,3828,-7984,-12502,4093,45412,44339,32527,28009,44604
48249,TX,9120,5523,6898,9859,6534,4284,4840,5712,5513.555983,7910,9722,42261,4195,-7617,-12194,4460,47058,46456,34644,30067,46721
48251,TX,11256,5523,6898,9859,6534,4284,5086,6128,5834.974044,7910,10249,45662,5176,-6636,-11121,5441,49440,50838,39026,34541,51103
48253,TX,9480,5523,6898,9859,6534,4284,4881,5158,7219.544157,7910,9556,43607,4195,-7617,-12194,4460,47459,47802,35990,31413,48067
48255,TX,7644,5523,6898,9859,6534,4284,4670,5523,6131.66764,7910,9859,41352,3828,-7984,-12502,4093,45412,45180,33368,28850,45445
48257,TX,10956,5523,6898,9859,6534,4284,5051,6106,6997.02396,7910,10240,46493,5176,-6636,-11121,5441,49105,51669,39857,35372,51934
48259,TX,10128,5523,6898,9859,6534,4284,4956,6712,6700.330364,7910,10072,45807,5176,-6636,-11121,5441,48182,50983,39171,34686,51248
48261,TX,8964,5523,6898,9859,6534,4284,4822,4638,5464.10705,7910,9600,40860,3828,-7984,-12502,4093,46884,44688,32876,28358,44953
48263,TX,9084,5523,6898,9859,6534,4284,4836,5523,6700.330364,7910,9859,43360,4195,-7617,-12194,4460,47018,47555,35743,31166,47820
48265,TX,9456,5523,6898,9859,6534,4284,4879,6080,6255.289971,7910,9103,43088,4195,-7617,-12194,4460,47433,47283,35471,30894,47548
48267,TX,8088,5523,6898,9859,6534,4284,4721,5523,6255.289971,7910,9859,41919,3828,-7984,-12502,4093,45907,45747,33935,29417,46012
48269,TX,7836,5523,6898,9859,6534,4284,4692,5523,6823.952696,7910,9859,42236,3828,-7984,-12502,4093,45626,46064,34252,29734,46329
48271,TX,7644,5523,6898,9859,6534,4284,4670,5523,5117.964522,7910,9859,40338,3828,-7984,-12502,4093,45412,44166,32354,27836,44431
48273,TX,8448,5523,6898,9859,6534,4284,4763,5735,5933.871909,7910,9559,41871,3828,-7984,-12502,4093,46309,45699,33887,29369,45964
48275,TX,7644,5523,6898,9859,6534,4284,4670,5523,6823.952696,7910,9859,42044,3828,-7984,-12502,4093,45412,45872,34060,29542,46137
48277,TX,7644,5523,6898,9859,6534,4284,4670,5350,6725.054831,7910,9286,41199,3462,-8350,-12811,3727,45412,44661,32849,28388,44926
48279,TX,7644,5523,6898,9859,6534,4284,4670,5523,6551.983567,7910,9859,41772,3828,-7984,-12502,4093,45412,45600,33788,29270,45865
48281,TX,7644,5523,6898,9859,6534,4284,4670,5828,6304.738904,7910,10134,42104,3828,-7984,-12502,4093,45412,45932,34120,29602,46197
48283,TX,7644,5523,6898,9859,6534,4284,4670,5523,5389.933651,7910,9859,40610,3828,-7984,-12502,4093,45412,44438,32626,28108,44703
48285,TX,7644,5523,6898,9859,6534,4284,4670,5523,5785.525112,7910,9859,41006,3828,-7984,-12502,4093,45412,44834,33022,28504,45099
48287,TX,7644,5523,6898,9859,6534,4284,4670,5523,6626.156966,7910,9859,41846,3828,-7984,-12502,4093,45412,45674,33862,29344,45939
48289,TX,7824,5523,6898,9859,6534,4284,4691,5523,6304.738904,7910,9859,41705,3828,-7984,-12502,4093,45613,45533,33721,29203,45798
48291,TX,11112,5523,6898,9859,6534,4284,5069,6273,6205.841039,7910,10306,46090,5176,-6636,-11121,5441,49279,51266,39454,34969,51531
48293,TX,9036,5523,6898,9859,6534,4284,4830,5523,5909.147443,7910,9859,42521,4195,-7617,-12194,4460,46964,46716,34904,30327,46981
48295,TX,7644,5523,6898,9859,6534,4284,4670,5523,6823.952696,7910,9859,42044,3828,-7984,-12502,4093,45412,45872,34060,29542,46137
48297,TX,7644,5523,6898,9859,6534,4284,4670,5523,5834.974044,7910,9859,41055,3828,-7984,-12502,4093,45412,44883,33071,28553,45148
48299,TX,7644,5523,6898,9859,6534,4284,4670,5523,6057.494241,7910,9859,41277,3828,-7984,-12502,4093,45412,45105,33293,28775,45370
48301,TX,7836,5523,6898,9859,6534,4284,4692,5523,7244.268623,7910,9859,42656,3828,-7984,-12502,4093,45626,46484,34672,30154,46749
48303,TX,9288,5523,6898,9859,6534,4284,4859,5980,6551.983567,7910,9689,43703,4609,-7203,-11838,4874,47245,48312,36500,31865,48577
48305,TX,7644,5523,6898,9859,6534,4284,4670,5286,6551.983567,7910,9692,41368,3462,-8350,-12811,3727,45412,44830,33018,28557,45095
48307,TX,7644,5523,6898,9859,6534,4284,4670,5523,6576.708033,7910,9859,41797,3828,-7984,-12502,4093,45412,45625,33813,29295,45890
48309,TX,9060,5523,6898,9859,6534,4284,4833,5907,5810.249578,7910,9622,42592,4195,-7617,-12194,4460,46991,46787,34975,30398,47052
48311,TX,7836,5523,6898,9859,6534,4284,4692,5523,5933.871909,7910,9859,41346,3828,-7984,-12502,4093,45626,45174,33362,28844,45439
48313,TX,7644,5523,6898,9859,6534,4284,4670,5523,6378.912303,7910,9859,41599,3828,-7984,-12502,4093,45412,45427,33615,29097,45692
48315,TX,7644,5523,6898,9859,6534,4284,4670,5523,6700.330364,7910,9859,41920,3828,-7984,-12502,4093,45412,45748,33936,29418,46013
48317,TX,7644,5523,6898,9859,6534,4284,4670,5339,6280.014438,7910,10645,42102,3828,-7984,-12502,4093,45412,45930,34118,29600,46195
48319,TX,7644,5523,6898,9859,6534,4284,4670,5523,6181.116572,7910,9859,41401,3828,-7984,-12502,4093,45412,45229,33417,28899,45494
48321,TX,8604,5523,6898,9859,6534,4284,4781,5725,5686.627247,7910,9625,41835,4195,-7617,-12194,4460,46483,46030,34218,29641,46295
48323,TX,7644,5523,6898,9859,6534,4284,4670,5534,4870.719859,7910,9384,39627,3462,-8350,-12811,3727,45412,43089,31277,26816,43354
48325,TX,8316,5523,6898,9859,6534,4284,4747,6295,5538.280449,7910,10074,42418,4195,-7617,-12194,4460,46161,46613,34801,30224,46878
48327,TX,7644,5523,6898,9859,6534,4284,4670,5523,6008.045308,7910,9859,41228,3828,-7984,-12502,4093,45412,45056,33244,28726,45321
48329,TX,11220,5523,6898,9859,6534,4284,5082,6316,6453.085702,7910,10757,46941,5403,-6409,-10762,5668,49400,52344,40532,36179,52609
48331,TX,7644,5523,6898,9859,6534,4284,4670,5523,6428.361235,7910,9859,41648,3828,-7984,-12502,4093,45412,45476,33664,29146,45741
48333,TX,7644,5523,6898,9859,6534,4284,4670,5523,6181.116572,7910,9859,41401,3828,-7984,-12502,4093,45412,45229,33417,28899,45494
48335,TX,7644,5523,6898,9859,6534,4284,4670,5523,6230.565505,7910,9859,41451,3828,-7984,-12502,4093,45412,45279,33467,28949,45544
48337,TX,7944,5523,6898,9859,6534,4284,4705,5523,6453.085702,7910,9859,41973,3828,-7984,-12502,4093,45747,45801,33989,29471,46066
48339,TX,11112,5523,6898,9859,6534,4284,5069,6624,6922.850561,7910,10344,47197,5403,-6409,-10762,5668,49279,52600,40788,36435,52865
48341,TX,8196,5523,6898,9859,6534,4284,4734,5619,6725.054831,7910,10644,43379,4195,-7617,-12194,4460,46028,47574,35762,31185,47839
48343,TX,7644,5523,6898,9859,6534,4284,4670,5523,6453.085702,7910,9859,41673,3828,-7984,-12502,4093,45412,45501,33689,29171,45766
48345,TX,7644,5523,6898,9859,6534,4284,4670,5523,6675.605898,7910,9859,41896,3828,-7984,-12502,4093,45412,45724,33912,29394,45989
48347,TX,8592,5523,6898,9859,6534,4284,4779,5988,6799.22823,7910,8921,42494,3828,-7984,-12502,4093,46469,46322,34510,29992,46587
48349,TX,8784,5523,6898,9859,6534,4284,4801,5716,5834.974044,7910,9459,41988,4195,-7617,-12194,4460,46683,46183,34371,29794,46448
48351,TX,7644,5523,6898,9859,6534,4284,4670,5636,6329.46337,7910,9496,41299,3462,-8350,-12811,3727,45412,44761,32949,28488,45026
48353,TX,7644,5523,6898,9859,6534,4284,4670,5037,6131.66764,7910,9058,40065,3095,-8717,-13119,3360,45412,43160,31348,26946,43425
48355,TX,10068,5523,6898,9859,6534,4284,4949,6087,5909.147443,7910,9832,44090,4950,-6862,-11479,5215,48115,49040,37228,32611,49305
48357,TX,7728,5523,6898,9859,6534,4284,4680,5523,6551.983567,7910,9859,41856,3828,-7984,-12502,4093,45506,45684,33872,29354,45949
48359,TX,8196,5523,6898,9859,6534,4284,4734,5428,6725.054831,7910,9831,42374,3828,-7984,-12502,4093,46028,46202,34390,29872,46467
48361,TX,9672,5523,6898,9859,6534,4284,4904,5747,6329.46337,7910,9459,43401,4195,-7617,-12194,4460,47674,47596,35784,31207,47861
48363,TX,8628,5523,6898,9859,6534,4284,4783,5926,6551.983567,7910,9431,42731,4195,-7617,-12194,4460,46509,46926,35114,30537,47191
48365,TX,7644,5523,6898,9859,6534,4284,4670,5523,6156.392106,7910,9859,41376,3828,-7984,-12502,4093,45412,45204,33392,28874,45469
48367,TX,11256,5523,6898,9859,6534,4284,5086,6359,7417.339887,7910,10242,47468,5176,-6636,-11121,5441,49440,52644,40832,36347,52909
48369,TX,7644,5523,6898,9859,6534,4284,4670,5523,6972.299494,7910,9859,42192,3828,-7984,-12502,4093,45412,46020,34208,29690,46285
48371,TX,7752,5523,6898,9859,6534,4284,4682,5523,6329.46337,7910,9859,41657,3828,-7984,-12502,4093,45532,45485,33673,29155,45750
48373,TX,7644,5523,6898,9859,6534,4284,4670,5523,6156.392106,7910,9859,41376,3828,-7984,-12502,4093,45412,45204,33392,28874,45469
48375,TX,8832,5523,6898,9859,6534,4284,4807,5712,6428.361235,7910,9840,43005,4195,-7617,-12194,4460,46737,47200,35388,30811,47465
48377,TX,7644,5523,6898,9859,6534,4284,4670,5523,7343.166488,7910,9859,42563,3828,-7984,-12502,4093,45412,46391,34579,30061,46656
48379,TX,7644,5523,6898,9859,6534,4284,4670,5523,6823.952696,7910,9859,42044,3828,-7984,-12502,4093,45412,45872,34060,29542,46137
48381,TX,8832,5523,6898,9859,6534,4284,4807,6041,7293.717555,7910,9837,44198,4195,-7617,-12194,4460,46737,48393,36581,32004,48658
48383,TX,7644,5523,6898,9859,6534,4284,4670,5523,6181.116572,7910,9859,41401,3828,-7984,-12502,4093,45412,45229,33417,28899,45494
48385,TX,7644,5523,6898,9859,6534,4284,4670,5523,6082.218707,7910,9859,41302,3828,-7984,-12502,4093,45412,45130,33318,28800,45395
48387,TX,7644,5523,6898,9859,6534,4284,4670,5523,6428.361235,7910,9859,41648,3828,-7984,-12502,4093,45412,45476,33664,29146,45741
48389,TX,7644,5523,6898,9859,6534,4284,4670,5254,6403.636769,7910,9755,41250,3462,-8350,-12811,3727,45412,44712,32900,28439,44977
48391,TX,7800,5523,6898,9859,6534,4284,4688,5523,5834.974044,7910,9859,41211,3828,-7984,-12502,4093,45586,45039,33227,28709,45304
48393,TX,7836,5523,6898,9859,6534,4284,4692,5523,6972.299494,7910,9859,42384,3828,-7984,-12502,4093,45626,46212,34400,29882,46477
48395,TX,10416,5523,6898,9859,6534,4284,4989,5830,6082.218707,7910,9254,43776,4609,-7203,-11838,4874,48503,48385,36573,31938,48650
48397,TX,10956,5523,6898,9859,6534,4284,5051,6528,6947.575027,7910,10239,46865,5176,-6636,-11121,5441,49105,52041,40229,35744,52306
48399,TX,7644,5523,6898,9859,6534,4284,4670,5523,6057.494241,7910,9859,41277,3828,-7984,-12502,4093,45412,45105,33293,28775,45370
48401,TX,8184,5523,6898,9859,6534,4284,4732,5618,6551.983567,7910,9650,42198,3828,-7984,-12502,4093,46014,46026,34214,29696,46291
48403,TX,7644,5523,6898,9859,6534,4284,4670,5523,6502.534634,7910,9859,41723,3828,-7984,-12502,4093,45412,45551,33739,29221,45816
48405,TX,7644,5523,6898,9859,6534,4284,4670,5523,6502.534634,7910,9859,41723,3828,-7984,-12502,4093,45412,45551,33739,29221,45816
48407,TX,11112,5523,6898,9859,6534,4284,5069,5523,7194.81969,7910,9859,45883,4950,-6862,-11479,5215,49279,50833,39021,34404,51098
48409,TX,10068,5523,6898,9859,6534,4284,4949,5840,5711.351713,7910,9829,43642,4609,-7203,-11838,4874,48115,48251,36439,31804,48516
48411,TX,7644,5523,6898,9859,6534,4284,4670,5523,6156.392106,7910,9859,41376,3828,-7984,-12502,4093,45412,45204,33392,28874,45469
48413,TX,7644,5523,6898,9859,6534,4284,4670,5523,5983.320842,7910,9859,41203,3828,-7984,-12502,4093,45412,45031,33219,28701,45296
48415,TX,7644,5523,6898,9859,6534,4284,4670,5338,6205.841039,7910,9630,41013,3462,-8350,-12811,3727,45412,44475,32663,28202,44740
48417,TX,7644,5523,6898,9859,6534,4284,4670,5523,6131.66764,7910,9859,41352,3828,-7984,-12502,4093,45412,45180,33368,28850,45445
48419,TX,7644,5523,6898,9859,6534,4284,4670,5523,6601.432499,7910,9859,41821,3828,-7984,-12502,4093,45412,45649,33837,29319,45914
48421,TX,7644,5523,6898,9859,6534,4284,4670,5523,6626.156966,7910,9859,41846,3828,-7984,-12502,4093,45412,45674,33862,29344,45939
48423,TX,10500,5523,6898,9859,6534,4284,4999,6125,6799.22823,7910,9703,45321,4950,-6862,-11479,5215,48597,50271,38459,33842,50536
48425,TX,7644,5523,6898,9859,6534,4284,4670,6031,6156.392106,7910,10233,42259,4195,-7617,-12194,4460,45412,46454,34642,30065,46719
48427,TX,7644,5523,6898,9859,6534,4284,4670,4916,5736.076179,7910,9272,39762,3095,-8717,-13119,3360,45412,42857,31045,26643,43122
48429,TX,7944,5523,6898,9859,6534,4284,4705,5523,6675.605898,7910,9859,42196,3828,-7984,-12502,4093,45747,46024,34212,29694,46289
48431,TX,8328,5523,6898,9859,6534,4284,4749,5523,6230.565505,7910,9859,42135,3828,-7984,-12502,4093,46175,45963,34151,29633,46228
48433,TX,7644,5523,6898,9859,6534,4284,4670,5523,6725.054831,7910,9859,41945,3828,-7984,-12502,4093,45412,45773,33961,29443,46038
48435,TX,7644,5523,6898,9859,6534,4284,4670,5523,5661.90278,7910,9859,40882,3828,-7984,-12502,4093,45412,44710,32898,28380,44975
48437,TX,7644,5523,6898,9859,6534,4284,4670,5523,6700.330364,7910,9859,41920,3828,-7984,-12502,4093,45412,45748,33936,29418,46013
48439,TX,11256,5523,6898,9859,6534,4284,5086,6391,6725.054831,7910,10281,46847,5403,-6409,-10762,5668,49440,52250,40438,36085,52515
48441,TX,9480,5523,6898,9859,6534,4284,4881,5694,6057.494241,7910,9504,42930,4195,-7617,-12194,4460,47459,47125,35313,30736,47390
48443,TX,7644,5523,6898,9859,6534,4284,4670,5523,5513.555983,7910,9859,40734,3828,-7984,-12502,4093,45412,44562,32750,28232,44827
48445,TX,7644,5523,6898,9859,6534,4284,4670,5523,6551.983567,7910,9859,41772,3828,-7984,-12502,4093,45412,45600,33788,29270,45865
48447,TX,7644,5523,6898,9859,6534,4284,4670,5523,6848.677162,7910,9859,42069,3828,-7984,-12502,4093,45412,45897,34085,29567,46162
48449,TX,7644,5523,6898,9859,6534,4284,4670,5653,6329.46337,7910,9854,41674,3828,-7984,-12502,4093,45412,45502,33690,29172,45767
48451,TX,8760,5523,6898,9859,6534,4284,4799,5685,5983.320842,7910,9584,42206,4195,-7617,-12194,4460,46657,46401,34589,30012,46666
48453,TX,12888,5523,6898,9859,6534,4284,5274,7136,6774.503763,7910,10553,49546,5856,-5956,-10045,6121,51260,55402,43590,39501,55667
48455,TX,7644,5523,6898,9859,6534,4284,4670,5925,6280.014438,7910,8418,40461,3462,-8350,-12811,3727,45412,43923,32111,27650,44188
48457,TX,7644,5523,6898,9859,6534,4284,4670,5523,6428.361235,7910,9859,41648,3828,-7984,-12502,4093,45412,45476,33664,29146,45741
48459,TX,9576,5523,6898,9859,6534,4284,4893,5840,6428.361235,7910,9653,43691,4609,-7203,-11838,4874,47567,48300,36488,31853,48565
48461,TX,7644,5523,6898,9859,6534,4284,4670,5523,6329.46337,7910,9859,41549,3828,-7984,-12502,4093,45412,45377,33565,29047,45642
48463,TX,7644,5523,6898,9859,6534,4284,4670,5512,5612.453848,7910,9161,40123,3462,-8350,-12811,3727,45412,43585,31773,27312,43850
48465,TX,7644,5523,6898,9859,6534,4284,4670,5708,5216.862387,7910,9929,40692,3828,-7984,-12502,4093,45412,44520,32708,28190,44785
48467,TX,8688,5523,6898,9859,6534,4284,4790,5523,6700.330364,7910,9859,42964,4195,-7617,-12194,4460,46576,47159,35347,30770,47424
48469,TX,8772,5523,6898,9859,6534,4284,4800,5929,5933.871909,7910,9888,42716,4195,-7617,-12194,4460,46670,46911,35099,30522,47176
48471,TX,8568,5523,6898,9859,6534,4284,4776,6518,6502.534634,7910,8297,42080,3828,-7984,-12502,4093,46442,45908,34096,29578,46173
48473,TX,11112,5523,6898,9859,6534,4284,5069,6472,7392.615421,7910,10325,47495,5403,-6409,-10762,5668,49279,52898,41086,36733,53163
48475,TX,7644,5523,6898,9859,6534,4284,4670,5523,6205.841039,7910,9859,41426,3828,-7984,-12502,4093,45412,45254,33442,28924,45519
48477,TX,8784,5523,6898,9859,6534,4284,4801,5942,6329.46337,7910,9539,42788,4195,-7617,-12194,4460,46683,46983,35171,30594,47248
48479,TX,9324,5523,6898,9859,6534,4284,4863,6009,5142.688988,7910,10081,42751,4609,-7203,-11838,4874,47285,47360,35548,30913,47625
48481,TX,8448,5523,6898,9859,6534,4284,4763,5688,5810.249578,7910,9669,41809,3828,-7984,-12502,4093,46309,45637,33825,29307,45902
48483,TX,7644,5523,6898,9859,6534,4284,4670,5523,6922.850561,7910,9859,42143,3828,-7984,-12502,4093,45412,45971,34159,29641,46236
48485,TX,8544,5523,6898,9859,6534,4284,4774,5693,6181.116572,7910,9543,42156,3828,-7984,-12502,4093,46416,45984,34172,29654,46249
48487,TX,8052,5523,6898,9859,6534,4284,4717,5012,6280.014438,7910,9290,40828,3462,-8350,-12811,3727,45867,44290,32478,28017,44555
48489,TX,7716,5523,6898,9859,6534,4284,4678,5263,4944.893258,7910,8811,38928,3095,-8717,-13119,3360,45492,42023,30211,25809,42288
48491,TX,12888,5523,6898,9859,6534,4284,5274,6413,6650.881432,7910,10517,48663,5629,-6183,-10404,5894,51260,54292,42480,38259,54557
48493,TX,10284,5523,6898,9859,6534,4284,4974,6250,6255.289971,7910,10067,45050,4950,-6862,-11479,5215,48356,50000,38188,33571,50265
48495,TX,7644,5523,6898,9859,6534,4284,4670,5523,6403.636769,7910,9859,41624,3828,-7984,-12502,4093,45412,45452,33640,29122,45717
48497,TX,9540,5523,6898,9859,6534,4284,4888,6357,7021.748426,7910,10238,45351,4950,-6862,-11479,5215,47526,50301,38489,33872,50566
48499,TX,7956,5523,6898,9859,6534,4284,4706,5523,6774.503763,7910,9859,42307,3828,-7984,-12502,4093,45760,46135,34323,29805,46400
48501,TX,7836,5523,6898,9859,6534,4284,4692,5523,7120.646291,7910,9859,42533,3828,-7984,-12502,4093,45626,46361,34549,30031,46626
48503,TX,8796,5523,6898,9859,6534,4284,4803,5523,6280.014438,7910,9859,42652,4195,-7617,-12194,4460,46697,46847,35035,30458,47112
48505,TX,7644,5523,6898,9859,6534,4284,4670,5865,5266.31132,7910,9137,40107,3462,-8350,-12811,3727,45412,43569,31757,27296,43834
48507,TX,7644,5523,6898,9859,6534,4284,4670,5523,5266.31132,7910,9859,40486,3828,-7984,-12502,4093,45412,44314,32502,27984,44579
49001,UT,7488,14625,8234,8509,5221,4344,6470,14625,8145.611264,7594,8509,50706,5263,-3679,-7636,8398,54891,55969,47027,43070,59104
49003,UT,7476,14625,8234,8509,5221,4344,6468,14078,8588.307528,7594,9381,51462,5263,-3679,-7636,8398,54877,56725,47783,43826,59860
49005,UT,7644,14625,8234,8509,5221,4344,6496,15417,8086.585095,7594,8936,52021,5816,-3126,-6819,8951,55073,57837,48895,45202,60972
49007,UT,7476,14625,8234,8509,5221,4344,6468,14206,8381.715938,7594,8261,50262,5263,-3679,-7636,8398,54877,55525,46583,42626,58660
49009,UT,9264,14625,8234,8509,5221,4344,6763,14625,9149.05613,7594,8509,53485,5816,-3126,-6819,8951,56960,59301,50359,46666,62436
49011,UT,9264,14625,8234,8509,5221,4344,6763,16144,8057.072011,7594,9467,54870,6369,-2573,-6002,9504,56960,61239,52297,48868,64374
49013,UT,8064,14625,8234,8509,5221,4344,6565,14625,7968.532758,7594,8509,51105,5263,-3679,-7636,8398,55562,56368,47426,43469,59503
49015,UT,7476,14625,8234,8509,5221,4344,6468,14625,8027.558927,7594,8509,50576,5263,-3679,-7636,8398,54877,55839,46897,42940,58974
49017,UT,7860,14625,8234,8509,5221,4344,6531,14625,8145.611264,7594,8509,51078,5263,-3679,-7636,8398,55324,56341,47399,43442,59476
49019,UT,8400,14625,8234,8509,5221,4344,6621,14625,9060.516877,7594,8509,52533,5263,-3679,-7636,8398,55954,57796,48854,44897,60931
49021,UT,7476,14625,8234,8509,5221,4344,6468,16050,8293.176685,7594,8403,52160,5816,-3126,-6819,8951,54877,57976,49034,45341,61111
49023,UT,8748,14625,8234,8509,5221,4344,6678,13504,7968.532758,7594,9318,51476,5263,-3679,-7636,8398,56359,56739,47797,43840,59874
49025,UT,9480,14625,8234,8509,5221,4344,6799,14625,8647.333697,7594,8509,53199,5816,-3126,-6819,8951,57212,59015,50073,46380,62150
49027,UT,7476,14625,8234,8509,5221,4344,6468,14625,7939.019674,7594,8509,50487,5263,-3679,-7636,8398,54877,55750,46808,42851,58885
49029,UT,9264,14625,8234,8509,5221,4344,6763,15076,7939.019674,7594,9335,53552,5816,-3126,-6819,8951,56960,59368,50426,46733,62503
49031,UT,9348,14625,8234,8509,5221,4344,6777,14625,8086.585095,7594,8509,52507,5816,-3126,-6819,8951,57058,58323,49381,45688,61458
49033,UT,9444,14625,8234,8509,5221,4344,6793,14625,7998.045842,7594,8509,52514,5816,-3126,-6819,8951,57170,58330,49388,45695,61465
49035,UT,10512,14625,8234,8509,5221,4344,6970,17470,7909.50659,7594,9521,57351,6922,-2020,-5185,10057,58415,64273,55331,52166,67408
49037,UT,7476,14625,8234,8509,5221,4344,6468,14625,8883.438371,7594,8509,51431,5263,-3679,-7636,8398,54877,56694,47752,43795,59829
49039,UT,7644,14625,8234,8509,5221,4344,6496,14625,8116.09818,7594,8509,50832,5263,-3679,-7636,8398,55073,56095,47153,43196,59230
49041,UT,7476,14625,8234,8509,5221,4344,6468,14625,8027.558927,7594,8509,50576,5263,-3679,-7636,8398,54877,55839,46897,42940,58974
49043,UT,10968,14625,8234,8509,5221,4344,7045,19561,10447.63184,7594,9419,62334,8028,-914,-3551,11163,58946,70362,61420,58783,73497
49045,UT,9204,14625,8234,8509,5221,4344,6754,14708,8234.150517,7594,9387,53472,5816,-3126,-6819,8951,56891,59288,50346,46653,62423
49047,UT,10896,14625,8234,8509,5221,4344,7033,15593,8617.820612,7594,9243,56288,6369,-2573,-6002,9504,58862,62657,53715,50286,65792
49049,UT,8748,14625,8234,8509,5221,4344,6678,17098,7820.967337,7594,9470,55074,6369,-2573,-6002,9504,56359,61443,52501,49072,64578
49051,UT,10092,14625,8234,8509,5221,4344,6900,16290,9178.569214,7594,9477,56976,6922,-2020,-5185,10057,57925,63898,54956,51791,67033
49053,UT,9036,14625,8234,8509,5221,4344,6726,15918,8116.09818,7594,8498,53506,5816,-3126,-6819,8951,56695,59322,50380,46687,62457
49055,UT,7476,14625,8234,8509,5221,4344,6468,14625,8617.820612,7594,8509,51166,5263,-3679,-7636,8398,54877,56429,47487,43530,59564
49057,UT,9264,14625,8234,8509,5221,4344,6763,15760,7673.401915,7594,9471,54107,6369,-2573,-6002,9504,56960,60476,51534,48105,63611
50001,VT,10440,9307,8011,7901,5969,3987,6581,9307,10796.38373,13715,7901,56146,8440,-3405,-7098,8672,52196,64586,52741,49048,64818
50003,VT,10032,9307,8011,7901,5969,3987,6520,10771,8614.135957,13715,7550,54669,8993,-2852,-6281,9225,51727,63662,51817,48388,63894
50005,VT,8136,9307,8011,7901,5969,3987,6234,9307,9934.970137,13715,7901,52981,7887,-3958,-7915,8119,49545,60868,49023,45066,61100
50007,VT,15708,9307,8011,7901,5969,3987,7375,8555,9389.408193,13715,8272,59626,10099,-1746,-4647,10331,58258,69725,57880,54979,69957
50009,VT,8088,9307,8011,7901,5969,3987,6227,8835,9619.118486,13715,7249,51492,7611,-4234,-8323,7843,49490,59103,47258,43169,59335
50011,VT,15708,9307,8011,7901,5969,3987,7375,8363,10049.82528,13715,8250,60072,10099,-1746,-4647,10331,58258,70171,58326,55425,70403
50013,VT,15708,9307,8011,7901,5969,3987,7375,10376,8901.273823,13715,8261,60948,10811,-1034,-3671,11043,58258,71759,59914,57277,71991
50015,VT,11304,9307,8011,7901,5969,3987,6711,9307,10681.52859,13715,7901,56896,8993,-2852,-6281,9225,53190,65889,54044,50615,66121
50017,VT,9768,9307,8011,7901,5969,3987,6480,12417,10394.39072,13715,7747,58028,8993,-2852,-6281,9225,51423,67021,55176,51747,67253
50019,VT,8484,9307,8011,7901,5969,3987,6287,9307,9446.835767,13715,7901,52841,7887,-3958,-7915,8119,49946,60728,48883,44926,60960
50021,VT,9900,9307,8011,7901,5969,3987,6500,8390,8614.135957,13715,7577,52183,7887,-3958,-7915,8119,51575,60070,48225,44268,60302
50023,VT,10800,9307,8011,7901,5969,3987,6636,11262,10566.67344,13715,7817,58147,8993,-2852,-6281,9225,52611,67140,55295,51866,67372
50025,VT,9984,9307,8011,7901,5969,3987,6513,9307,10164.68043,13715,7901,55059,8440,-3405,-7098,8672,51672,63499,51654,47961,63731
50027,VT,10620,9307,8011,7901,5969,3987,6608,10578,10825.09752,13715,7739,57464,8993,-2852,-6281,9225,52403,66457,54612,51183,66689
51001,VA,8808,12682,6898,9859,6530,4284,6270,12682,6799.22823,8462,9859,50894,1282,-10541,-14498,1536,55331,52176,40353,36396,52430
51003,VA,12096,12682,6898,9859,6530,4284,6747,12825,7689.309016,8462,9708,55064,2330,-9493,-12922,2584,59096,57394,45571,42142,57648
51005,VA,7404,12682,6898,9859,6530,4284,6066,12682,7170.095224,8462,9859,49861,1021,-10802,-14891,1275,53723,50882,39059,34970,51136
51007,VA,11808,12682,6898,9859,6530,4284,6706,14042,7194.81969,8462,9999,55790,2330,-9493,-12922,2584,58767,58120,46297,42868,58374
51009,VA,7884,12682,6898,9859,6530,4284,6136,11549,6848.677162,8462,9522,48550,758,-11065,-15286,1012,54273,49308,37485,33264,49562
51011,VA,7884,12682,6898,9859,6530,4284,6136,12730,6972.299494,8462,9517,49849,1021,-10802,-14891,1275,54273,50870,39047,34958,51124
51013,VA,17628,12682,6898,9859,6530,4284,7551,12937,9098.603595,8462,11831,64241,9818,-2005,-4378,10072,65432,74059,62236,59863,74313
51015,VA,8628,12682,6898,9859,6530,4284,6244,12327,7071.197359,8462,9494,50266,1282,-10541,-14498,1536,55125,51548,39725,35768,51802
51017,VA,7404,12682,6898,9859,6530,4284,6066,12682,7120.646291,8462,9859,49812,1021,-10802,-14891,1275,53723,50833,39010,34921,51087
51019,VA,7884,12682,6898,9859,6530,4284,6136,12678,7491.513286,8462,9515,50315,1021,-10802,-14891,1275,54273,51336,39513,35424,51590
51021,VA,7404,12682,6898,9859,6530,4284,6066,12682,6848.677162,8462,9859,49540,1021,-10802,-14891,1275,53723,50561,38738,34649,50815
51023,VA,8640,12682,6898,9859,6530,4284,6246,13040,7516.237752,8462,9510,51452,1282,-10541,-14498,1536,55139,52734,40911,36954,52988
51025,VA,7404,12682,6898,9859,6530,4284,6066,12682,6551.983567,8462,9859,49243,1021,-10802,-14891,1275,53723,50264,38441,34352,50518
51027,VA,7404,12682,6898,9859,6530,4284,6066,12682,6650.881432,8462,9859,49342,1021,-10802,-14891,1275,53723,50363,38540,34451,50617
51029,VA,7764,12682,6898,9859,6530,4284,6118,12996,7293.717555,8462,9732,50531,1282,-10541,-14498,1536,54135,51813,39990,36033,52067
51031,VA,7884,12682,6898,9859,6530,4284,6136,13741,6774.503763,8462,9510,50655,1282,-10541,-14498,1536,54273,51937,40114,36157,52191
51033,VA,11808,12682,6898,9859,6530,4284,6706,12226,6997.02396,8462,9985,53762,1806,-10017,-13710,2060,58767,55568,43745,40052,55822
51035,VA,7404,12682,6898,9859,6530,4284,6066,12682,6650.881432,8462,9859,49342,1021,-10802,-14891,1275,53723,50363,38540,34451,50617
51036,VA,11808,12682,6898,9859,6530,4284,6706,11686,7417.339887,8462,9993,53651,1806,-10017,-13710,2060,58767,55457,43634,39941,55711
51037,VA,7404,12682,6898,9859,6530,4284,6066,12682,6799.22823,8462,9859,49490,1021,-10802,-14891,1275,53723,50511,38688,34599,50765
51041,VA,11808,12682,6898,9859,6530,4284,6706,11655,7318.442022,8462,10000,53528,1806,-10017,-13710,2060,58767,55334,43511,39818,55588
51043,VA,17628,12682,6898,9859,6530,4284,7551,16465,7639.860083,8462,11182,65661,10342,-1481,-3590,10596,65432,76003,64180,62071,76257
51045,VA,8640,12682,6898,9859,6530,4284,6246,12029,7244.268623,8462,9525,50185,1021,-10802,-14891,1275,55139,51206,39383,35294,51460
51047,VA,9888,12682,6898,9859,6530,4284,6427,12230,6749.779297,8462,11214,52828,1806,-10017,-13710,2060,56568,54634,42811,39118,54888
51049,VA,11808,12682,6898,9859,6530,4284,6706,12682,6947.575027,8462,9859,54043,1806,-10017,-13710,2060,58767,55849,44026,40333,56103
51051,VA,7404,12682,6898,9859,6530,4284,6066,12211,6799.22823,8462,8543,47704,497,-11326,-15679,751,53723,48201,36378,32025,48455
51053,VA,11808,12682,6898,9859,6530,4284,6706,11956,6749.779297,8462,9992,53252,1806,-10017,-13710,2060,58767,55058,43235,39542,55312
51057,VA,9984,12682,6898,9859,6530,4284,6441,12682,7071.197359,8462,9859,52342,1806,-10017,-13710,2060,56678,54148,42325,38632,54402
51059,VA,17628,12682,6898,9859,6530,4284,7551,12043,8480.491937,8462,11469,62366,9294,-2529,-5166,9548,65432,71660,59837,57200,71914
51061,VA,17628,12682,6898,9859,6530,4284,7551,12148,8505.216404,8462,11194,62221,9294,-2529,-5166,9548,65432,71515,59692,57055,71769
51063,VA,7404,12682,6898,9859,6530,4284,6066,11798,7095.921825,8462,9406,48450,758,-11065,-15286,1012,53723,49208,37385,33164,49462
51065,VA,12096,12682,6898,9859,6530,4284,6747,12937,7689.309016,8462,9729,55197,2330,-9493,-12922,2584,59096,57527,45704,42275,57781
51067,VA,7404,12682,6898,9859,6530,4284,6066,13020,7021.748426,8462,9507,49699,1021,-10802,-14891,1275,53723,50720,38897,34808,50974
51069,VA,9648,12682,6898,9859,6530,4284,6392,11837,6873.401628,8462,9775,50879,1282,-10541,-14498,1536,56293,52161,40338,36381,52415
51071,VA,7404,12682,6898,9859,6530,4284,6066,13075,7343.166488,8462,9391,49959,1021,-10802,-14891,1275,53723,50980,39157,35068,51234
51073,VA,13560,12682,6898,9859,6530,4284,6960,11986,7293.717555,8462,10109,55694,2330,-9493,-12922,2584,60773,58024,46201,42772,58278
51075,VA,11808,12682,6898,9859,6530,4284,6706,12048,7466.788819,8462,9994,54063,1806,-10017,-13710,2060,58767,55869,44046,40353,56123
51077,VA,7404,12682,6898,9859,6530,4284,6066,12682,6947.575027,8462,9859,49639,1021,-10802,-14891,1275,53723,50660,38837,34748,50914
51079,VA,12096,12682,6898,9859,6530,4284,6747,16077,7565.686685,8462,9729,58213,2854,-8969,-12134,3108,59096,61067,49244,46079,61321
51081,VA,7404,12682,6898,9859,6530,4284,6066,12682,6576.708033,8462,9859,49268,1021,-10802,-14891,1275,53723,50289,38466,34377,50543
51083,VA,7404,12682,6898,9859,6530,4284,6066,12682,6626.156966,8462,9859,49317,1021,-10802,-14891,1275,53723,50338,38515,34426,50592
51085,VA,11808,12682,6898,9859,6530,4284,6706,13882,7318.442022,8462,9996,55750,2330,-9493,-12922,2584,58767,58080,46257,42828,58334
51087,VA,11808,12682,6898,9859,6530,4284,6706,11596,7318.442022,8462,10010,53478,1806,-10017,-13710,2060,58767,55284,43461,39768,55538
51089,VA,7404,12682,6898,9859,6530,4284,6066,12040,6725.054831,8462,8455,47370,497,-11326,-15679,751,53723,47867,36044,31691,48121
51091,VA,7404,12682,6898,9859,6530,4284,6066,12682,7021.748426,8462,9859,49713,1021,-10802,-14891,1275,53723,50734,38911,34822,50988
51093,VA,13560,12682,6898,9859,6530,4284,6960,12133,7392.615421,8462,10100,55931,2330,-9493,-12922,2584,60773,58261,46438,43009,58515
51095,VA,13560,12682,6898,9859,6530,4284,6960,12962,8999.705729,8462,10112,58380,2854,-8969,-12134,3108,60773,61234,49411,46246,61488
51097,VA,11808,12682,6898,9859,6530,4284,6706,12682,7540.962218,8462,9859,54636,1806,-10017,-13710,2060,58767,56442,44619,40926,56696
51099,VA,11568,12682,6898,9859,6530,4284,6671,12682,7318.442022,8462,9859,54173,1806,-10017,-13710,2060,58492,55979,44156,40463,56233
51101,VA,11808,12682,6898,9859,6530,4284,6706,11491,7466.788819,8462,10001,53513,1806,-10017,-13710,2060,58767,55319,43496,39803,55573
51103,VA,9624,12682,6898,9859,6530,4284,6388,12682,7318.442022,8462,9859,52229,1282,-10541,-14498,1536,56265,53511,41688,37731,53765
51105,VA,7404,12682,6898,9859,6530,4284,6066,12682,6601.432499,8462,9859,49292,1021,-10802,-14891,1275,53723,50313,38490,34401,50567
51107,VA,17628,12682,6898,9859,6530,4284,7551,12564,8257.971741,8462,11341,62536,9294,-2529,-5166,9548,65432,71830,60007,57370,72084
51109,VA,8604,12682,6898,9859,6530,4284,6240,12682,7145.370758,8462,9859,51036,1282,-10541,-14498,1536,55097,52318,40495,36538,52572
51111,VA,7404,12682,6898,9859,6530,4284,6066,12682,6551.983567,8462,9859,49243,1021,-10802,-14891,1275,53723,50264,38441,34352,50518
51113,VA,8208,12682,6898,9859,6530,4284,6183,12682,6922.850561,8462,9859,50418,1282,-10541,-14498,1536,54644,51700,39877,35920,51954
51115,VA,13560,12682,6898,9859,6530,4284,6960,13431,7565.686685,8462,10109,57412,2854,-8969,-12134,3108,60773,60266,48443,45278,60520
51117,VA,7404,12682,6898,9859,6530,4284,6066,12682,6576.708033,8462,9859,49268,1021,-10802,-14891,1275,53723,50289,38466,34377,50543
51119,VA,7548,12682,6898,9859,6530,4284,6087,12682,7738.757949,8462,9859,50574,1021,-10802,-14891,1275,53888,51595,39772,35683,51849
51121,VA,8592,12682,6898,9859,6530,4284,6239,12227,7887.104746,8462,9359,50811,1021,-10802,-14891,1275,55084,51832,40009,35920,52086
51125,VA,12096,12682,6898,9859,6530,4284,6747,12834,7392.615421,8462,9728,54797,2330,-9493,-12922,2584,59096,57127,45304,41875,57381
51127,VA,11808,12682,6898,9859,6530,4284,6706,13276,7466.788819,8462,9992,55289,2330,-9493,-12922,2584,58767,57619,45796,42367,57873
51131,VA,8496,12682,6898,9859,6530,4284,6225,12682,7219.544157,8462,9859,51003,1282,-10541,-14498,1536,54974,52285,40462,36505,52539
51133,VA,7896,12682,6898,9859,6530,4284,6138,12682,7367.890954,8462,9859,50551,1282,-10541,-14498,1536,54287,51833,40010,36053,52087
51135,VA,8592,12682,6898,9859,6530,4284,6239,12682,6576.708033,8462,9859,50456,1282,-10541,-14498,1536,55084,51738,39915,35958,51992
51137,VA,9924,12682,6898,9859,6530,4284,6432,12682,7244.268623,8462,9859,52455,1806,-10017,-13710,2060,56609,54261,42438,38745,54515
51139,VA,7824,12682,6898,9859,6530,4284,6127,12682,6848.677162,8462,9859,49960,1282,-10541,-14498,1536,54204,51242,39419,35462,51496
51141,VA,7404,12682,6898,9859,6530,4284,6066,12682,6972.299494,8462,9859,49663,1021,-10802,-14891,1275,53723,50684,38861,34772,50938
51143,VA,7404,12682,6898,9859,6530,4284,6066,11559,6947.575027,8462,8667,47323,497,-11326,-15679,751,53723,47820,35997,31644,48074
51145,VA,11808,12682,6898,9859,6530,4284,6706,13092,7170.095224,8462,9999,54815,2330,-9493,-12922,2584,58767,57145,45322,41893,57399
51147,VA,8460,12682,6898,9859,6530,4284,6219,12682,6626.156966,8462,9859,50373,1282,-10541,-14498,1536,54932,51655,39832,35875,51909
51149,VA,11808,12682,6898,9859,6530,4284,6706,13913,6576.708033,8462,9990,55033,2330,-9493,-12922,2584,58767,57363,45540,42111,57617
51153,VA,17628,12682,6898,9859,6530,4284,7551,12304,7392.615421,8462,11342,61412,9294,-2529,-5166,9548,65432,70706,58883,56246,70960
51155,VA,7404,12682,6898,9859,6530,4284,6066,16410,7021.748426,8462,9358,52940,1806,-10017,-13710,2060,53723,54746,42923,39230,55000
51157,VA,11880,12682,6898,9859,6530,4284,6716,12147,7392.615421,8462,11124,55289,2330,-9493,-12922,2584,58849,57619,45796,42367,57873
51159,VA,8628,12682,6898,9859,6530,4284,6244,12682,7046.472893,8462,9859,50961,1282,-10541,-14498,1536,55125,52243,40420,36463,52497
51161,VA,8640,12682,6898,9859,6530,4284,6246,13198,7540.962218,8462,9472,51597,1282,-10541,-14498,1536,55139,52879,41056,37099,53133
51163,VA,7656,12682,6898,9859,6530,4284,6103,12682,6997.02396,8462,9859,49940,1021,-10802,-14891,1275,54012,50961,39138,35049,51215
51165,VA,8880,12682,6898,9859,6530,4284,6280,12283,6749.779297,8462,9745,50404,1282,-10541,-14498,1536,55413,51686,39863,35906,51940
51167,VA,7404,12682,6898,9859,6530,4284,6066,12682,6848.677162,8462,9859,49540,1021,-10802,-14891,1275,53723,50561,38738,34649,50815
51169,VA,7404,12682,6898,9859,6530,4284,6066,12746,6997.02396,8462,8823,48716,758,-11065,-15286,1012,53723,49474,37651,33430,49728
51171,VA,8568,12682,6898,9859,6530,4284,6235,12682,7046.472893,8462,9859,50901,1282,-10541,-14498,1536,55056,52183,40360,36403,52437
51173,VA,7404,12682,6898,9859,6530,4284,6066,12682,6650.881432,8462,9859,49342,1021,-10802,-14891,1275,53723,50363,38540,34451,50617
51175,VA,8976,12682,6898,9859,6530,4284,6294,12682,7071.197359,8462,9859,51334,1282,-10541,-14498,1536,55523,52616,40793,36836,52870
51177,VA,17628,12682,6898,9859,6530,4284,7551,11791,6675.605898,8462,11203,60044,9294,-2529,-5166,9548,65432,69338,57515,54878,69592
51179,VA,17628,12682,6898,9859,6530,4284,7551,12490,7071.197359,8462,11221,61157,9294,-2529,-5166,9548,65432,70451,58628,55991,70705
51181,VA,13560,12682,6898,9859,6530,4284,6960,12682,7120.646291,8462,9859,55968,2330,-9493,-12922,2584,60773,58298,46475,43046,58552
51183,VA,11808,12682,6898,9859,6530,4284,6706,12627,7219.544157,8462,10000,54400,2330,-9493,-12922,2584,58767,56730,44907,41478,56984
51185,VA,7404,12682,6898,9859,6530,4284,6066,15170,6650.881432,8462,8512,50483,1282,-10541,-14498,1536,53723,51765,39942,35985,52019
51187,VA,10968,12682,6898,9859,6530,4284,6584,11806,7639.860083,8462,11236,54396,1806,-10017,-13710,2060,57805,56202,44379,40686,56456
51191,VA,7404,12682,6898,9859,6530,4284,6066,12653,6725.054831,8462,8767,48295,758,-11065,-15286,1012,53723,49053,37230,33009,49307
51193,VA,8508,12682,6898,9859,6530,4284,6226,12682,7343.166488,8462,9859,51138,1282,-10541,-14498,1536,54987,52420,40597,36640,52674
51195,VA,7404,12682,6898,9859,6530,4284,6066,12394,6898.126095,8462,8520,47962,497,-11326,-15679,751,53723,48459,36636,32283,48713
51197,VA,7404,12682,6898,9859,6530,4284,6066,12682,7219.544157,8462,9859,49911,1021,-10802,-14891,1275,53723,50932,39109,35020,51186
51199,VA,13560,12682,6898,9859,6530,4284,6960,12291,7540.962218,8462,10116,56255,2330,-9493,-12922,2584,60773,58585,46762,43333,58839
51510,VA,17628,12682,6898,9859,6530,4284,7551,11450,9296.399325,8462,11792,62912,9294,-2529,-5166,9548,65432,72206,60383,57746,72460
51515,VA,7884,12682,6898,9859,6530,4284,6136,13361,7194.81969,8462,9463,50649,1282,-10541,-14498,1536,54273,51931,40108,36151,52185
51520,VA,7404,12682,6898,9859,6530,4284,6066,14248,6972.299494,8462,8707,50077,1282,-10541,-14498,1536,53723,51359,39536,35579,51613
51530,VA,7656,12682,6898,9859,6530,4284,6103,12682,7071.197359,8462,9859,50014,1021,-10802,-14891,1275,54012,51035,39212,35123,51289
51540,VA,12096,12682,6898,9859,6530,4284,6747,11861,8851.358932,8462,9675,55229,1806,-10017,-13710,2060,59096,57035,45212,41519,57289
51550,VA,13560,12682,6898,9859,6530,4284,6960,11740,7120.646291,8462,10131,55297,2330,-9493,-12922,2584,60773,57627,45804,42375,57881
51560,VA,7404,12682,6898,9859,6530,4284,6066,12682,6898,8462,9859,49589,1021,-10802,-14891,1275,53723,50610,38787,34698,50864
51570,VA,11808,12682,6898,9859,6530,4284,6706,12629,7120.646291,8462,10003,54306,2330,-9493,-12922,2584,58767,56636,44813,41384,56890
51580,VA,7404,12682,6898,9859,6530,4284,6066,12682,6675.605898,8462,9859,49367,1021,-10802,-14891,1275,53723,50388,38565,34476,50642
51590,VA,7404,12682,6898,9859,6530,4284,6066,11970,6181.116572,8462,8546,46847,497,-11326,-15679,751,53723,47344,35521,31168,47598
51595,VA,7404,12682,6898,9859,6530,4284,6066,12682,6502.534634,8462,9859,49194,1021,-10802,-14891,1275,53723,50215,38392,34303,50469
51600,VA,17628,12682,6898,9859,6530,4284,7551,11617,9568.368454,8462,11466,63025,9294,-2529,-5166,9548,65432,72319,60496,57859,72573
51610,VA,17628,12682,6898,9859,6530,4284,7551,13862,8628.838735,8462,11618,64482,9818,-2005,-4378,10072,65432,74300,62477,60104,74554
51620,VA,8976,12682,6898,9859,6530,4284,6294,12682,7021.748426,8462,9859,51285,1282,-10541,-14498,1536,55523,52567,40744,36787,52821
51630,VA,17628,12682,6898,9859,6530,4284,7551,16606,8208.522808,8462,11407,66596,10342,-1481,-3590,10596,65432,76938,65115,63006,77192
51640,VA,7404,12682,6898,9859,6530,4284,6066,12682,6848.677162,8462,9859,49540,1021,-10802,-14891,1275,53723,50561,38738,34649,50815
51650,VA,13560,12682,6898,9859,6530,4284,6960,12024,7046.472893,8462,10144,55520,2330,-9493,-12922,2584,60773,57850,46027,42598,58104
51660,VA,8880,12682,6898,9859,6530,4284,6280,11678,7021.748426,8462,9726,50051,1021,-10802,-14891,1275,55413,51072,39249,35160,51326
51670,VA,11808,12682,6898,9859,6530,4284,6706,13612,7120.646291,8462,10008,55295,2330,-9493,-12922,2584,58767,57625,45802,42373,57879
51678,VA,7656,12682,6898,9859,6530,4284,6103,12682,7120.646291,8462,9859,50064,1021,-10802,-14891,1275,54012,51085,39262,35173,51339
51680,VA,7884,12682,6898,9859,6530,4284,6136,13679,7071.197359,8462,9467,50847,1282,-10541,-14498,1536,54273,52129,40306,36349,52383
51683,VA,17628,12682,6898,9859,6530,4284,7551,12158,6725.054831,8462,11441,60698,9294,-2529,-5166,9548,65432,69992,58169,55532,70246
51685,VA,17628,12682,6898,9859,6530,4284,7551,11578,7417.339887,8462,11417,60786,9294,-2529,-5166,9548,65432,70080,58257,55620,70334
51690,VA,7404,12682,6898,9859,6530,4284,6066,15434,6601.432499,8462,8357,50543,1282,-10541,-14498,1536,53723,51825,40002,36045,52079
51700,VA,13560,12682,6898,9859,6530,4284,6960,16630,6823.952696,8462,10148,59908,3378,-8445,-11346,3632,60773,63286,51463,48562,63540
51710,VA,13560,12682,6898,9859,6530,4284,6960,13875,7095.921825,8462,10177,57454,2854,-8969,-12134,3108,60773,60308,48485,45320,60562
51720,VA,7404,12682,6898,9859,6530,4284,6066,12883,6873.401628,8462,8417,48323,758,-11065,-15286,1012,53723,49081,37258,33037,49335
51730,VA,11808,12682,6898,9859,6530,4284,6706,13510,6898.126095,8462,10011,54973,2330,-9493,-12922,2584,58767,57303,45480,42051,57557
51735,VA,13560,12682,6898,9859,6530,4284,6960,11977,7021.748426,8462,10106,55411,2330,-9493,-12922,2584,60773,57741,45918,42489,57995
51740,VA,13560,12682,6898,9859,6530,4284,6960,12580,7219.544157,8462,10150,56256,2330,-9493,-12922,2584,60773,58586,46763,43334,58840
51750,VA,8592,12682,6898,9859,6530,4284,6239,14743,7540.962218,8462,9310,52931,1806,-10017,-13710,2060,55084,54737,42914,39221,54991
51760,VA,11808,12682,6898,9859,6530,4284,6706,14571,8356.869606,8462,10036,57518,2854,-8969,-12134,3108,58767,60372,48549,45384,60626
51770,VA,8640,12682,6898,9859,6530,4284,6246,11324,6823.952696,8462,9426,48960,1021,-10802,-14891,1275,55139,49981,38158,34069,50235
51775,VA,8640,12682,6898,9859,6530,4284,6246,13304,7268.993089,8462,9453,51412,1282,-10541,-14498,1536,55139,52694,40871,36914,52948
51790,VA,8628,12682,6898,9859,6530,4284,6244,13557,7367.890954,8462,9440,51739,1282,-10541,-14498,1536,55125,53021,41198,37241,53275
51800,VA,13560,12682,6898,9859,6530,4284,6960,12074,7343.166488,8462,10121,55844,2330,-9493,-12922,2584,60773,58174,46351,42922,58428
51810,VA,13560,12682,6898,9859,6530,4284,6960,12119,7540.962218,8462,10148,56114,2330,-9493,-12922,2584,60773,58444,46621,43192,58698
51820,VA,8628,12682,6898,9859,6530,4284,6244,13586,7293.717555,8462,9436,51690,1282,-10541,-14498,1536,55125,52972,41149,37192,53226
51830,VA,13560,12682,6898,9859,6530,4284,6960,12949,7961.278145,8462,10144,57361,2854,-8969,-12134,3108,60773,60215,48392,45227,60469
51840,VA,9648,12682,6898,9859,6530,4284,6392,12391,7318.442022,8462,9761,51864,1282,-10541,-14498,1536,56293,53146,41323,37366,53400
53001,WA,7644,20148,8234,8509,5550,4344,4856,19185,8322.68977,7138,8648,55282,6526,-4824,-8253,7253,59285,61808,50458,47029,62535
53003,WA,7908,20148,8234,8509,5550,4344,4887,19031,7732.428084,7138,8056,54210,6526,-4824,-8253,7253,59580,60736,49386,45957,61463
53005,WA,9048,20148,8234,8509,5550,4344,5018,20903,7939.019674,7138,8843,58214,7432,-3918,-6819,8159,60851,65646,54296,51395,66373
53007,WA,9708,20148,8234,8509,5550,4344,5094,20254,9562.23931,7138,8494,59500,7432,-3918,-6819,8159,61587,66932,55582,52681,67659
53009,WA,9060,20148,8234,8509,5550,4344,5019,19190,8499.768275,7138,7761,55992,6526,-4824,-8253,7253,60864,62518,51168,47739,63245
53011,WA,11064,20148,8234,8509,5550,4344,5250,22170,8293.176685,7138,8550,61559,7885,-3465,-6102,8612,63099,69444,58094,55457,70171
53013,WA,7644,20148,8234,8509,5550,4344,4856,16810,8175.124348,7138,8141,52252,6073,-5277,-8970,6800,59285,58325,46975,43282,59052
53015,WA,8196,20148,8234,8509,5550,4344,4920,19952,8499.768275,7138,8071,56201,6526,-4824,-8253,7253,59901,62727,51377,47948,63454
53017,WA,9708,20148,8234,8509,5550,4344,5094,20565,8027.558927,7138,8494,58276,7432,-3918,-6819,8159,61587,65708,54358,51457,66435
53019,WA,7644,20148,8234,8509,5550,4344,4856,20148,8440.742107,7138,8509,56224,6979,-4371,-7536,7706,59285,63203,51853,48688,63930
53021,WA,9048,20148,8234,8509,5550,4344,5018,19167,8145.611264,7138,8832,56674,6979,-4371,-7536,7706,60851,63653,52303,49138,64380
53023,WA,7644,20148,8234,8509,5550,4344,4856,20148,8322.68977,7138,8509,56106,6979,-4371,-7536,7706,59285,63085,51735,48570,63812
53025,WA,7920,20148,8234,8509,5550,4344,4888,20451,8765.386034,7138,8476,57095,6979,-4371,-7536,7706,59593,64074,52724,49559,64801
53027,WA,8232,20148,8234,8509,5550,4344,4924,18057,9503.213141,7138,7851,55125,6073,-5277,-8970,6800,59941,61198,49848,46155,61925
53029,WA,10752,20148,8234,8509,5550,4344,5214,20712,9650.778563,7138,8238,60835,7432,-3918,-6819,8159,62751,68267,56917,54016,68994
53031,WA,10860,20148,8234,8509,5550,4344,5227,20148,10949.35427,7138,8509,61948,7432,-3918,-6819,8159,62872,69380,58030,55129,70107
53033,WA,13476,20148,8234,8509,5550,4344,5528,27365,9503.213141,7138,9075,70902,9697,-1653,-3234,10424,65789,80599,69249,67668,81326
53035,WA,11412,20148,8234,8509,5550,4344,5290,22267,8735.87295,7138,8803,62699,8338,-3012,-5385,9065,63487,71037,59687,57314,71764
53037,WA,9540,20148,8234,8509,5550,4344,5075,20937,10300.06642,7138,8001,60260,7432,-3918,-6819,8159,61400,67692,56342,53441,68419
53039,WA,7932,20148,8234,8509,5550,4344,4889,20148,8558.794444,7138,8509,56630,6979,-4371,-7536,7706,59606,63609,52259,49094,64336
53041,WA,8796,20148,8234,8509,5550,4344,4989,19419,8824.412203,7138,7929,56451,6526,-4824,-8253,7253,60570,62977,51627,48198,63704
53043,WA,7788,20148,8234,8509,5550,4344,4873,20148,8322.68977,7138,8509,56250,6979,-4371,-7536,7706,59446,63229,51879,48714,63956
53045,WA,9888,20148,8234,8509,5550,4344,5115,19436,8853.925287,7138,8028,57689,6979,-4371,-7536,7706,61788,64668,53318,50153,65395
53047,WA,7644,20148,8234,8509,5550,4344,4856,20148,8175.124348,7138,8509,55958,6979,-4371,-7536,7706,59285,62937,51587,48422,63664
53049,WA,8340,20148,8234,8509,5550,4344,4936,20148,8529.28136,7138,8509,57008,6979,-4371,-7536,7706,60061,63987,52637,49472,64714
53051,WA,7644,20148,8234,8509,5550,4344,4856,17165,8234.150517,7138,8168,52694,6073,-5277,-8970,6800,59285,58767,47417,43724,59494
53053,WA,11988,20148,8234,8509,5550,4344,5357,23106,8676.846781,7138,9038,64290,8338,-3012,-5385,9065,64130,72628,61278,58905,73355
53055,WA,10236,20148,8234,8509,5550,4344,5155,20148,8499.768275,7138,8509,58875,7432,-3918,-6819,8159,62176,66307,54957,52056,67034
53057,WA,10896,20148,8234,8509,5550,4344,5231,21769,8440.742107,7138,8413,61001,7885,-3465,-6102,8612,62912,68886,57536,54899,69613
53059,WA,11064,20148,8234,8509,5550,4344,5250,19154,8499.768275,7138,8549,58749,7432,-3918,-6819,8159,63099,66181,54831,51930,66908
53061,WA,13476,20148,8234,8509,5550,4344,5528,24834,8883.438371,7138,9040,67715,9244,-2106,-3951,9971,65789,76959,65609,63764,77686
53063,WA,8868,20148,8234,8509,5550,4344,4997,19863,8234.150517,7138,8110,56557,6979,-4371,-7536,7706,60650,63536,52186,49021,64263
53065,WA,7644,20148,8234,8509,5550,4344,4856,18163,8381.715938,7138,8167,53837,6073,-5277,-8970,6800,59285,59910,48560,44867,60637
53067,WA,11316,20148,8234,8509,5550,4344,5279,22099,8558.794444,7138,8818,62273,7885,-3465,-6102,8612,63380,70158,58808,56171,70885
53069,WA,7644,20148,8234,8509,5550,4344,4856,20148,8499.768275,7138,8509,56283,6979,-4371,-7536,7706,59285,63262,51912,48747,63989
53071,WA,8556,20148,8234,8509,5550,4344,4961,19577,9296.621551,7138,8114,57026,6526,-4824,-8253,7253,60302,63552,52202,48773,64279
53073,WA,10620,20148,8234,8509,5550,4344,5199,22297,8175.124348,7138,8378,60951,7885,-3465,-6102,8612,62604,68836,57486,54849,69563
53075,WA,8460,20148,8234,8509,5550,4344,4950,21595,9739.317815,7138,7516,58792,6979,-4371,-7536,7706,60195,65771,54421,51256,66498
53077,WA,8784,20148,8234,8509,5550,4344,4988,19048,8204.637432,7138,8510,56028,6979,-4371,-7536,7706,60557,63007,51657,48492,63734
54001,WV,7632,5369,6898,9859,4528,4284,5978,5369,6527.2591,10250,9859,43921,1788,-7627,-12262,4450,44548,45709,36294,31659,48371
54003,WV,8892,5369,6898,9859,4528,4284,6174,5145,6601.432499,10250,9800,44972,2188,-7228,-11845,4849,46004,47160,37744,33127,49821
54005,WV,6876,5369,6898,9859,4528,4284,5861,5634,6551.983567,10250,9277,42873,1316,-8099,-12676,3978,43675,44189,34774,30197,46851
54007,WV,6876,5369,6898,9859,4528,4284,5861,5369,6576.708033,10250,9859,43215,1316,-8099,-12676,3978,43675,44531,35116,30539,47193
54009,WV,7368,5369,6898,9859,4528,4284,5937,5609,6823.952696,10250,9086,43421,1316,-8099,-12676,3978,44243,44737,35322,30745,47399
54011,WV,7716,5369,6898,9859,4528,4284,5991,5986,6601.432499,10250,9166,44003,1788,-7627,-12262,4450,44645,45791,36376,31741,48453
54013,WV,6876,5369,6898,9859,4528,4284,5861,5369,6428.361235,10250,9859,43066,1316,-8099,-12676,3978,43675,44382,34967,30390,47044
54015,WV,8652,5369,6898,9859,4528,4284,6137,6192,6601.432499,10250,9299,45279,2188,-7228,-11845,4849,45727,47467,38051,33434,50128
54017,WV,7020,5369,6898,9859,4528,4284,5883,5143,6354.187836,10250,9315,42366,891,-8525,-13043,3552,43841,43257,33841,29323,45918
54019,WV,6876,5369,6898,9859,4528,4284,5861,5958,6601.432499,10250,8677,42647,891,-8525,-13043,3552,43675,43538,34122,29604,46199
54021,WV,7032,5369,6898,9859,4528,4284,5885,5369,6626.156966,10250,9859,43420,1316,-8099,-12676,3978,43855,44736,35321,30744,47398
54023,WV,8316,5369,6898,9859,4528,4284,6084,5369,6675.605898,10250,9859,44754,1788,-7627,-12262,4450,45338,46542,37127,32492,49204
54025,WV,7380,5369,6898,9859,4528,4284,5939,5369,6725.054831,10250,9859,43867,1788,-7627,-12262,4450,44257,45655,36240,31605,48317
54027,WV,9648,5369,6898,9859,4528,4284,6291,5081,6601.432499,10250,9781,45646,2188,-7228,-11845,4849,46877,47834,38418,33801,50495
54029,WV,7368,5369,6898,9859,4528,4284,5937,5288,7120.646291,10250,9069,43380,1316,-8099,-12676,3978,44243,44696,35281,30704,47358
54031,WV,7272,5369,6898,9859,4528,4284,5922,5369,6848.677162,10250,9859,43883,1316,-8099,-12676,3978,44132,45199,35784,31207,47861
54033,WV,8952,5369,6898,9859,4528,4284,6183,5399,6255.289971,10250,9287,44427,2188,-7228,-11845,4849,46073,46615,37199,32582,49276
54035,WV,6876,5369,6898,9859,4528,4284,5861,5369,6551.983567,10250,9859,43190,1316,-8099,-12676,3978,43675,44506,35091,30514,47168
54037,WV,10728,5369,6898,9859,4528,4284,6459,5016,6725.054831,10250,11174,48177,3042,-6373,-10594,5704,48125,51219,41804,37583,53881
54039,WV,8652,5369,6898,9859,4528,4284,6137,4309,6626.156966,10250,9229,43350,1316,-8099,-12676,3978,45727,44666,35251,30674,47328
54041,WV,7644,5369,6898,9859,4528,4284,5980,5369,6502.534634,10250,9859,43909,1788,-7627,-12262,4450,44562,45697,36282,31647,48359
54043,WV,8652,5369,6898,9859,4528,4284,6137,6633,7689.309016,10250,9224,46732,2188,-7228,-11845,4849,45727,48920,39504,34887,51581
54045,WV,6876,5369,6898,9859,4528,4284,5861,5160,6453.085702,10250,8424,41447,466,-8949,-13410,3128,43675,41913,32498,28037,44575
54047,WV,6876,5369,6898,9859,4528,4284,5861,5369,6378.912303,10250,9859,43017,1316,-8099,-12676,3978,43675,44333,34918,30341,46995
54049,WV,7788,5369,6898,9859,4528,4284,6003,5675,7244.268623,10250,9408,44649,1788,-7627,-12262,4450,44729,46437,37022,32387,49099
54051,WV,7368,5369,6898,9859,4528,4284,5937,6666,6873.401628,10250,9151,44592,1788,-7627,-12262,4450,44243,46380,36965,32330,49042
54053,WV,6876,5369,6898,9859,4528,4284,5861,6031,6502.534634,10250,8837,42780,1316,-8099,-12676,3978,43675,44096,34681,30104,46758
54055,WV,6876,5369,6898,9859,4528,4284,5861,5518,6601.432499,10250,8466,41996,891,-8525,-13043,3552,43675,42887,33471,28953,45548
54057,WV,7644,5369,6898,9859,4528,4284,5980,5957,6650.881432,10250,8734,43520,1316,-8099,-12676,3978,44562,44836,35421,30844,47498
54059,WV,6876,5369,6898,9859,4528,4284,5861,5369,7392.615421,10250,9859,44031,1316,-8099,-12676,3978,43675,45347,35932,31355,48009
54061,WV,9024,5369,6898,9859,4528,4284,6194,5440,6922.850561,10250,9530,45450,2188,-7228,-11845,4849,46156,47638,38222,33605,50299
54063,WV,6876,5369,6898,9859,4528,4284,5861,5369,6922.850561,10250,9859,43561,1316,-8099,-12676,3978,43675,44877,35462,30885,47539
54065,WV,8892,5369,6898,9859,4528,4284,6174,5369,6823.952696,10250,9859,45478,2188,-7228,-11845,4849,46004,47666,38250,33633,50327
54067,WV,6876,5369,6898,9859,4528,4284,5861,5369,6576.708033,10250,9859,43215,1316,-8099,-12676,3978,43675,44531,35116,30539,47193
54069,WV,7368,5369,6898,9859,4528,4284,5937,6322,7367.890954,10250,9090,44683,1788,-7627,-12262,4450,44243,46471,37056,32421,49133
54071,WV,6876,5369,6898,9859,4528,4284,5861,5369,6823.952696,10250,9859,43462,1316,-8099,-12676,3978,43675,44778,35363,30786,47440
54073,WV,7368,5369,6898,9859,4528,4284,5937,5369,6329.46337,10250,9859,43459,1788,-7627,-12262,4450,44243,45247,35832,31197,47909
54075,WV,6876,5369,6898,9859,4528,4284,5861,5369,6601.432499,10250,9859,43239,1316,-8099,-12676,3978,43675,44555,35140,30563,47217
54077,WV,9024,5369,6898,9859,4528,4284,6194,5763,6725.054831,10250,9579,45625,2188,-7228,-11845,4849,46156,47813,38397,33780,50474
54079,WV,8652,5369,6898,9859,4528,4284,6137,5149,7293.717555,10250,9212,44840,1788,-7627,-12262,4450,45727,46628,37213,32578,49290
54081,WV,7992,5369,6898,9859,4528,4284,6034,5758,6354.187836,10250,8615,43253,1316,-8099,-12676,3978,44964,44569,35154,30577,47231
54083,WV,7632,5369,6898,9859,4528,4284,5978,6098,6626.156966,10250,8739,43629,1316,-8099,-12676,3978,44548,44945,35530,30953,47607
54085,WV,6876,5369,6898,9859,4528,4284,5861,5369,6280.014438,10250,9859,42918,1316,-8099,-12676,3978,43675,44234,34819,30242,46896
54087,WV,6876,5369,6898,9859,4528,4284,5861,5369,6601.432499,10250,9859,43239,1316,-8099,-12676,3978,43675,44555,35140,30563,47217
54089,WV,6924,5369,6898,9859,4528,4284,5868,5369,6502.534634,10250,9859,43189,1316,-8099,-12676,3978,43730,44505,35090,30513,47167
54091,WV,6876,5369,6898,9859,4528,4284,5861,6419,6700.330364,10250,9301,43830,1788,-7627,-12262,4450,43675,45618,36203,31568,48280
54093,WV,6876,5369,6898,9859,4528,4284,5861,5369,6749.779297,10250,9859,43388,1316,-8099,-12676,3978,43675,44704,35289,30712,47366
54095,WV,6876,5369,6898,9859,4528,4284,5861,5369,6576.708033,10250,9859,43215,1316,-8099,-12676,3978,43675,44531,35116,30539,47193
54097,WV,6876,5369,6898,9859,4528,4284,5861,5369,6551.983567,10250,9859,43190,1316,-8099,-12676,3978,43675,44506,35091,30514,47168
54099,WV,7716,5369,6898,9859,4528,4284,5991,6629,6354.187836,10250,9214,44448,1788,-7627,-12262,4450,44645,46236,36821,32186,48898
54101,WV,6876,5369,6898,9859,4528,4284,5861,5369,6626.156966,10250,9859,43264,1316,-8099,-12676,3978,43675,44580,35165,30588,47242
54103,WV,6972,5369,6898,9859,4528,4284,5876,5369,6551.983567,10250,9859,43286,1316,-8099,-12676,3978,43786,44602,35187,30610,47264
54105,WV,7368,5369,6898,9859,4528,4284,5937,5670,6304.738904,10250,9257,43134,1316,-8099,-12676,3978,44243,44450,35035,30458,47112
54107,WV,7368,5369,6898,9859,4528,4284,5937,5033,6181.116572,10250,9230,42346,1316,-8099,-12676,3978,44243,43662,34247,29670,46324
54109,WV,6876,5369,6898,9859,4528,4284,5861,5369,7615.135617,10250,9859,44253,1316,-8099,-12676,3978,43675,45569,36154,31577,48231
55001,WI,7644,5983,7047,9589,5516,4046,7313,5983,6541.958294,10066,9589,43870,4066,-7664,-12299,4413,47138,47936,36206,31571,48283
55003,WI,7644,5983,7047,9589,5516,4046,7313,5983,7097.645871,10066,9589,44426,4066,-7664,-12299,4413,47138,48492,36762,32127,48839
55005,WI,8052,5983,7047,9589,5516,4046,7384,5983,5961.012191,10066,9589,43697,4066,-7664,-12299,4413,47617,47763,36033,31398,48110
55007,WI,7764,5983,7047,9589,5516,4046,7334,5983,7097.645871,10066,9589,44546,4066,-7664,-12299,4413,47279,48612,36882,32247,48959
55009,WI,8172,5983,7047,9589,5516,4046,7405,6919,6567.21682,10066,9557,45327,4452,-7278,-11895,4799,47758,49779,38049,33432,50126
55011,WI,8568,5983,7047,9589,5516,4046,7474,5983,6718.767977,10066,9589,44971,4452,-7278,-11895,4799,48223,49423,37693,33076,49770
55013,WI,7644,5983,7047,9589,5516,4046,7313,5983,6845.060609,10066,9589,44173,4066,-7664,-12299,4413,47138,48239,36509,31874,48586
55015,WI,8040,5983,7047,9589,5516,4046,7382,6296,6289.373032,10066,9901,44639,4452,-7278,-11895,4799,47603,49091,37361,32744,49438
55017,WI,8880,5983,7047,9589,5516,4046,7528,5179,6011.529243,10066,9464,43647,4066,-7664,-12299,4413,48589,47713,35983,31348,48060
55019,WI,7644,5983,7047,9589,5516,4046,7313,5983,6946.094714,10066,9589,44274,4066,-7664,-12299,4413,47138,48340,36610,31975,48687
55021,WI,8736,5983,7047,9589,5516,4046,7503,6050,7148.162923,10066,10048,46094,4452,-7278,-11895,4799,48420,50546,38816,34199,50893
55023,WI,7644,5983,7047,9589,5516,4046,7313,5983,6339.890084,10066,9589,43668,4066,-7664,-12299,4413,47138,47734,36004,31369,48081
55025,WI,10776,5983,7047,9589,5516,4046,7857,5963,7122.904397,10066,10062,48036,5016,-6714,-11067,5363,50814,53052,41322,36969,53399
55027,WI,8856,5983,7047,9589,5516,4046,7524,5339,6440.924189,10066,9560,44308,4066,-7664,-12299,4413,48561,48374,36644,32009,48721
55029,WI,8256,5983,7047,9589,5516,4046,7419,5983,8183.762499,10066,9589,46124,4066,-7664,-12299,4413,47856,50190,38460,33825,50537
55031,WI,8304,5983,7047,9589,5516,4046,7428,5280,7249.197028,10066,9100,44046,3607,-8123,-12700,3954,47913,47653,35923,31346,48000
55033,WI,8040,5983,7047,9589,5516,4046,7382,5394,5986.270717,10066,9484,43015,4066,-7664,-12299,4413,47603,47081,35351,30716,47428
55035,WI,8880,5983,7047,9589,5516,4046,7528,5406,6314.631558,10066,9456,44169,4066,-7664,-12299,4413,48589,48235,36505,31870,48582
55037,WI,7644,5983,7047,9589,5516,4046,7313,5581,6289.373032,10066,9007,42634,3607,-8123,-12700,3954,47138,46241,34511,29934,46588
55039,WI,8148,5983,7047,9589,5516,4046,7401,7144,6617.733873,10066,9543,45565,4452,-7278,-11895,4799,47730,50017,38287,33670,50364
55041,WI,7644,5983,7047,9589,5516,4046,7313,5983,6339.890084,10066,9589,43668,4066,-7664,-12299,4413,47138,47734,36004,31369,48081
55043,WI,7644,5983,7047,9589,5516,4046,7313,6049,6213.597453,10066,9357,43376,4066,-7664,-12299,4413,47138,47442,35712,31077,47789
55045,WI,7920,5983,7047,9589,5516,4046,7361,5654,6264.114505,10066,10053,44003,4066,-7664,-12299,4413,47462,48069,36339,31704,48416
55047,WI,7644,5983,7047,9589,5516,4046,7313,5983,6744.026504,10066,9589,44072,4066,-7664,-12299,4413,47138,48138,36408,31773,48485
55049,WI,9084,5983,7047,9589,5516,4046,7563,5734,7400.748186,10066,10041,46372,4729,-7001,-11486,5076,48828,51101,39371,34886,51448
55051,WI,7644,5983,7047,9589,5516,4046,7313,5983,7122.904397,10066,9589,44451,4066,-7664,-12299,4413,47138,48517,36787,32152,48864
55053,WI,8124,5983,7047,9589,5516,4046,7396,5983,6920.836187,10066,9589,44729,4066,-7664,-12299,4413,47701,48795,37065,32430,49142
55055,WI,9528,5983,7047,9589,5516,4046,7640,5581,6567.21682,10066,9677,45466,4452,-7278,-11895,4799,49349,49918,38188,33571,50265
55057,WI,7824,5983,7047,9589,5516,4046,7344,5983,7577.557869,10066,9589,45086,4066,-7664,-12299,4413,47349,49152,37422,32787,49499
55059,WI,11640,5983,7047,9589,5516,4046,8007,5242,6718.767977,10066,10243,47956,5302,-6428,-10649,5649,51828,53258,41528,37307,53605
55061,WI,8172,5983,7047,9589,5516,4046,7405,5516,7047.128818,10066,9562,44409,4066,-7664,-12299,4413,47758,48475,36745,32110,48822
55063,WI,8388,5983,7047,9589,5516,4046,7442,5986,6365.14861,10066,9551,44402,4452,-7278,-11895,4799,48011,48854,37124,32507,49201
55065,WI,7644,5983,7047,9589,5516,4046,7313,5983,6567.21682,10066,9589,43895,4066,-7664,-12299,4413,47138,47961,36231,31596,48308
55067,WI,7644,5983,7047,9589,5516,4046,7313,5983,6415.665663,10066,9589,43744,4066,-7664,-12299,4413,47138,47810,36080,31445,48157
55069,WI,7644,5983,7047,9589,5516,4046,7313,5477,6946.094714,10066,9165,43344,3607,-8123,-12700,3954,47138,46951,35221,30644,47298
55071,WI,7644,5983,7047,9589,5516,4046,7313,7255,6491.441241,10066,9343,44845,4452,-7278,-11895,4799,47138,49297,37567,32950,49644
55073,WI,7752,5983,7047,9589,5516,4046,7332,5882,6440.924189,10066,9656,43843,4066,-7664,-12299,4413,47265,47909,36179,31544,48256
55075,WI,7644,5983,7047,9589,5516,4046,7313,5606,6011.529243,10066,8729,42102,3607,-8123,-12700,3954,47138,45709,33979,29402,46056
55077,WI,8268,5983,7047,9589,5516,4046,7421,5983,6744.026504,10066,9589,44696,4066,-7664,-12299,4413,47870,48762,37032,32397,49109
55078,WI,8004,5983,7047,9589,5516,4046,7376,6253,6264.114505,10066,9231,43864,4066,-7664,-12299,4413,47561,47930,36200,31565,48277
55079,WI,9744,5983,7047,9589,5516,4046,7678,5647,6567.21682,10066,9517,45587,4729,-7001,-11486,5076,49603,50316,38586,34101,50663
55081,WI,8604,5983,7047,9589,5516,4046,7480,5983,6062.046295,10066,9589,44350,4452,-7278,-11895,4799,48265,48802,37072,32455,49149
55083,WI,7644,5983,7047,9589,5516,4046,7313,5580,6769.28503,10066,9562,43668,3607,-8123,-12700,3954,47138,47275,35545,30968,47622
55085,WI,8376,5983,7047,9589,5516,4046,7440,5983,6314.631558,10066,9589,44375,4452,-7278,-11895,4799,47997,48827,37097,32480,49174
55087,WI,8040,5983,7047,9589,5516,4046,7382,5374,6769.28503,10066,9912,44208,4066,-7664,-12299,4413,47603,48274,36544,31909,48621
55089,WI,9744,5983,7047,9589,5516,4046,7678,5618,6895.577661,10066,9534,45903,4729,-7001,-11486,5076,49603,50632,38902,34417,50979
55091,WI,7644,5983,7047,9589,5516,4046,7313,5983,6617.733873,10066,9589,43946,4066,-7664,-12299,4413,47138,48012,36282,31647,48359
55093,WI,11352,5983,7047,9589,5516,4046,7957,5522,8663.674497,10066,10284,49934,5302,-6428,-10649,5649,51490,55236,43506,39285,55583
55095,WI,9084,5983,7047,9589,5516,4046,7563,5983,7173.42145,10066,9589,45941,4452,-7278,-11895,4799,48828,50393,38663,34046,50740
55097,WI,8316,5983,7047,9589,5516,4046,7430,5601,6744.026504,10066,9441,44213,4066,-7664,-12299,4413,47927,48279,36549,31914,48626
55099,WI,7644,5983,7047,9589,5516,4046,7313,5983,6440.924189,10066,9589,43769,4066,-7664,-12299,4413,47138,47835,36105,31470,48182
55101,WI,8820,5983,7047,9589,5516,4046,7517,7031,6642.992399,10066,9534,46140,4729,-7001,-11486,5076,48518,50869,39139,34654,51216
55103,WI,7728,5983,7047,9589,5516,4046,7328,5983,6870.319135,10066,9589,44282,4066,-7664,-12299,4413,47237,48348,36618,31983,48695
55105,WI,9252,5983,7047,9589,5516,4046,7592,6575,6213.597453,10066,9363,45515,4729,-7001,-11486,5076,49025,50244,38514,34029,50591
55107,WI,7644,5983,7047,9589,5516,4046,7313,5983,6238.855979,10066,9589,43567,4066,-7664,-12299,4413,47138,47633,35903,31268,47980
55109,WI,11352,5983,7047,9589,5516,4046,7957,6344,6693.509451,10066,10285,48787,5589,-6141,-10230,5936,51490,54376,42646,38557,54723
55111,WI,9252,5983,7047,9589,5516,4046,7592,6918,6440.924189,10066,9578,46300,4729,-7001,-11486,5076,49025,51029,39299,34814,51376
55113,WI,7716,5983,7047,9589,5516,4046,7326,5983,6567.21682,10066,9589,43967,4066,-7664,-12299,4413,47223,48033,36303,31668,48380
55115,WI,7644,5983,7047,9589,5516,4046,7313,8294,5910.495138,10066,9219,45179,4729,-7001,-11486,5076,47138,49908,38178,33693,50255
55117,WI,8628,5983,7047,9589,5516,4046,7484,6865,6946.094714,10066,9540,46091,4729,-7001,-11486,5076,48293,50820,39090,34605,51167
55119,WI,7644,5983,7047,9589,5516,4046,7313,5983,6996.611766,10066,9589,44325,4066,-7664,-12299,4413,47138,48391,36661,32026,48738
55121,WI,7644,5983,7047,9589,5516,4046,7313,5983,7097.645871,10066,9589,44426,4066,-7664,-12299,4413,47138,48492,36762,32127,48839
55123,WI,7644,5983,7047,9589,5516,4046,7313,5983,6996.611766,10066,9589,44325,4066,-7664,-12299,4413,47138,48391,36661,32026,48738
55125,WI,8532,5983,7047,9589,5516,4046,7467,5983,7375.489659,10066,9589,45591,4452,-7278,-11895,4799,48180,50043,38313,33696,50390
55127,WI,9432,5983,7047,9589,5516,4046,7624,6370,6946.094714,10066,9635,46495,4729,-7001,-11486,5076,49237,51224,39494,35009,51571
55129,WI,8628,5983,7047,9589,5516,4046,7484,5983,6668.250925,10066,9589,44980,4452,-7278,-11895,4799,48293,49432,37702,33085,49779
55131,WI,9744,5983,7047,9589,5516,4046,7678,6799,6819.802082,10066,9534,47009,5016,-6714,-11067,5363,49603,52025,40295,35942,52372
55133,WI,9744,5983,7047,9589,5516,4046,7678,6797,7097.645871,10066,9532,47282,5016,-6714,-11067,5363,49603,52298,40568,36215,52645
55135,WI,7824,5983,7047,9589,5516,4046,7344,5983,6087.304822,10066,9589,43595,4066,-7664,-12299,4413,47349,47661,35931,31296,48008
55137,WI,7740,5983,7047,9589,5516,4046,7330,5983,7021.870292,10066,9589,44446,4066,-7664,-12299,4413,47251,48512,36782,32147,48859
55139,WI,7836,5983,7047,9589,5516,4046,7346,6068,7047.128818,10066,9352,44415,4066,-7664,-12299,4413,47363,48481,36751,32116,48828
55141,WI,7644,5983,7047,9589,5516,4046,7313,6739,6440.924189,10066,9171,44107,4066,-7664,-12299,4413,47138,48173,36443,31808,48520
56001,WY,8952,9153,8234,8509,5429,4344,4922,9934,9798.343984,12538,8068,53634,-2893,-9516,-13209,2561,49543,50741,44118,40425,56195
56003,WY,7644,9153,8234,8509,5429,4344,4772,9153,8293.176685,12538,8509,50481,-3346,-9969,-13926,2108,48085,47135,40512,36555,52589
56005,WY,10692,9153,8234,8509,5429,4344,5123,10607,8912.951455,12538,9684,56778,-1987,-8610,-11775,3467,51484,54791,48168,45003,60245
56007,WY,8184,9153,8234,8509,5429,4344,4834,9153,9267.108467,12538,8509,51995,-3346,-9969,-13926,2108,48687,48649,42026,38069,54103
56009,WY,7656,9153,8234,8509,5429,4344,4773,9153,8647.333697,12538,8509,50847,-3346,-9969,-13926,2108,48098,47501,40878,36921,52955
56011,WY,7644,9153,8234,8509,5429,4344,4772,9153,8912.951455,12538,8509,51101,-3346,-9969,-13926,2108,48085,47755,41132,37175,53209
56013,WY,8664,9153,8234,8509,5429,4344,4889,7679,9149.05613,12538,8395,50769,-3572,-10195,-14284,1882,49222,47197,40574,36485,52651
56015,WY,7644,9153,8234,8509,5429,4344,4772,9153,8381.715938,12538,8509,50570,-3346,-9969,-13926,2108,48085,47224,40601,36644,52678
56017,WY,7644,9153,8234,8509,5429,4344,4772,9153,9031.003793,12538,8509,51219,-3346,-9969,-13926,2108,48085,47873,41250,37293,53327
56019,WY,7644,9153,8234,8509,5429,4344,4772,9153,8824.412203,12538,8509,51012,-3346,-9969,-13926,2108,48085,47666,41043,37086,53120
56021,WY,9468,9153,8234,8509,5429,4344,4982,8908,8322.68977,12538,8599,52180,-2893,-9516,-13209,2561,50119,49287,42664,38971,54741
56023,WY,9144,9153,8234,8509,5429,4344,4944,9153,7850.480421,12538,8509,51538,-3346,-9969,-13926,2108,49757,48192,41569,37612,53646
56025,WY,9144,9153,8234,8509,5429,4344,4944,7937,8558.794444,12538,8634,51156,-3346,-9969,-13926,2108,49757,47810,41187,37230,53264
56027,WY,7656,9153,8234,8509,5429,4344,4773,9153,8588.307528,12538,8509,50788,-3346,-9969,-13926,2108,48098,47442,40819,36862,52896
56029,WY,7944,9153,8234,8509,5429,4344,4806,9153,8883.438371,12538,8509,51371,-3346,-9969,-13926,2108,48419,48025,41402,37445,53479
56031,WY,7644,9153,8234,8509,5429,4344,4772,9153,8676.846781,12538,8509,50865,-3346,-9969,-13926,2108,48085,47519,40896,36939,52973
56033,WY,9624,9153,8234,8509,5429,4344,5000,8171,9326.134635,12538,8222,52225,-3346,-9969,-13926,2108,50293,48879,42256,38299,54333
56035,WY,11532,9153,8234,8509,5429,4344,5220,9153,9503.213141,12538,8509,55579,-2440,-9063,-12492,3014,52421,53139,46516,43087,58593
56037,WY,10908,9153,8234,8509,5429,4344,5148,9924,9001.490708,12538,9331,56047,-2440,-9063,-12492,3014,51725,53607,46984,43555,59061
56039,WY,11916,9153,8234,8509,5429,4344,5264,11643,11687.18138,12538,9452,61580,-1534,-8157,-11058,3920,52849,60046,53423,50522,65500
56041,WY,7812,9153,8234,8509,5429,4344,4791,9050,8411.229022,12538,8910,51065,-3346,-9969,-13926,2108,48272,47719,41096,37139,53173
56043,WY,7644,9153,8234,8509,5429,4344,4772,9153,8824.412203,12538,8509,51012,-3346,-9969,-13926,2108,48085,47666,41043,37086,53120
56045,WY,7644,9153,8234,8509,5429,4344,4772,9153,8617.820612,12538,8509,50806,-3346,-9969,-13926,2108,48085,47460,40837,36880,52914
