FIPS,State,Housing,ChildCare,Food,Transportation,Medical,Other,Taxes,MIDS ChildCare,MIDS Food,MIDS Medical,MIDS Transportation,MIDS Net,MIDS Taxes All,3x EITC Tax,Basic Income Tax,Mids Taxes Universal,MIT LWC,MIDS LWC,3x EITC,Basic Income,MIDS LWC 2
1001,AL,7164,#N/A,5540,8554,4799,3916,4652,#N/A,6076.240103,6836,8305,32298,3159,2814,-15453,4323,34625,35457,35112,16845,36621
1003,AL,8376,#N/A,5540,8554,4799,3916,4840,#N/A,6274.810041,6836,8359,33761,3385,3040,-15095,4549,36025,37146,36801,18666,38310
1005,AL,5172,#N/A,5540,8554,4799,3916,4343,#N/A,5996.812128,6836,8554,30475,-893,-1238,-19769,271,32324,29582,29237,10706,30746
1007,AL,7524,#N/A,5540,8554,4799,3916,4708,#N/A,6016.669122,6836,8350,32643,3159,2814,-15453,4323,35041,35802,35457,17190,36966
1009,AL,7524,#N/A,5540,8554,4799,3916,4708,#N/A,5639.38624,6836,8352,32267,3159,2814,-15453,4323,35041,35426,35081,16814,36590
1011,AL,5724,#N/A,5540,8554,4799,3916,4428,#N/A,5778.385196,6836,8554,30808,-893,-1238,-19769,271,32961,29915,29570,11039,31079
1013,AL,5172,#N/A,5540,8554,4799,3916,4343,#N/A,5798.24219,6836,8554,30276,-893,-1238,-19769,271,32324,29383,29038,10507,30547
1015,AL,6192,#N/A,5540,8554,4799,3916,4501,#N/A,5996.812128,6836,7747,30687,-893,-1238,-19769,271,33502,29794,29449,10918,30958
1017,AL,5460,#N/A,5540,8554,4799,3916,4387,#N/A,5500.387283,6836,7391,29104,-1120,-1465,-20128,44,32656,27984,27639,8976,29148
1019,AL,5664,#N/A,5540,8554,4799,3916,4419,#N/A,5778.385196,6836,8554,30748,-893,-1238,-19769,271,32892,29855,29510,10979,31019
1021,AL,5388,#N/A,5540,8554,4799,3916,4376,#N/A,5540.101271,6836,8349,30030,-893,-1238,-19769,271,32573,29137,28792,10261,30301
1023,AL,6132,#N/A,5540,8554,4799,3916,4492,#N/A,5679.100227,6836,8554,31117,-667,-1012,-19411,497,33433,30450,30105,11706,31614
1025,AL,5256,#N/A,5540,8554,4799,3916,4356,#N/A,5818.099184,6836,8554,30380,-893,-1238,-19769,271,32421,29487,29142,10611,30651
1027,AL,5088,#N/A,5540,8554,4799,3916,4330,#N/A,5897.527159,6836,8554,30292,-893,-1238,-19769,271,32227,29399,29054,10523,30563
1029,AL,5292,#N/A,5540,8554,4799,3916,4361,#N/A,5738.671209,6836,8554,30337,-893,-1238,-19769,271,32462,29444,29099,10568,30608
1031,AL,5592,#N/A,5540,8554,4799,3916,4408,#N/A,5877.670165,6836,8265,30486,-893,-1238,-19769,271,32809,29593,29248,10717,30757
1033,AL,5976,#N/A,5540,8554,4799,3916,4467,#N/A,5659.243233,6836,7925,30312,-893,-1238,-19769,271,33252,29419,29074,10543,30583
1035,AL,5232,#N/A,5540,8554,4799,3916,4352,#N/A,5877.670165,6836,8554,30416,-893,-1238,-19769,271,32393,29523,29178,10647,30687
1037,AL,5724,#N/A,5540,8554,4799,3916,4428,#N/A,5937.241147,6836,7537,29950,-1120,-1465,-20128,44,32961,28830,28485,9822,29994
1039,AL,5244,#N/A,5540,8554,4799,3916,4354,#N/A,5976.955134,6836,8554,30527,-893,-1238,-19769,271,32407,29634,29289,10758,30798
1041,AL,5100,#N/A,5540,8554,4799,3916,4332,#N/A,5659.243233,6836,8554,30065,-893,-1238,-19769,271,32241,29172,28827,10296,30336
1043,AL,5664,#N/A,5540,8554,4799,3916,4419,#N/A,5301.817345,6836,7741,29459,-1120,-1465,-20128,44,32892,28339,27994,9331,29503
1045,AL,5316,#N/A,5540,8554,4799,3916,4365,#N/A,5401.102314,6836,8203,29672,-1120,-1465,-20128,44,32490,28552,28207,9544,29716
1047,AL,5016,#N/A,5540,8554,4799,3916,4319,#N/A,5778.385196,6836,7122,28668,-1346,-1691,-20486,-182,32144,27322,26977,8182,28486
1049,AL,5460,#N/A,5540,8554,4799,3916,4387,#N/A,5778.385196,6836,8554,30544,-893,-1238,-19769,271,32656,29651,29306,10775,30815
1051,AL,7164,#N/A,5540,8554,4799,3916,4652,#N/A,6036.526116,6836,8310,32263,3159,2814,-15453,4323,34625,35422,35077,16810,36586
1053,AL,5724,#N/A,5540,8554,4799,3916,4428,#N/A,5857.813171,6836,8554,30888,-893,-1238,-19769,271,32961,29995,29650,11119,31159
1055,AL,5496,#N/A,5540,8554,4799,3916,4393,#N/A,5361.388326,6836,7669,29278,-1120,-1465,-20128,44,32698,28158,27813,9150,29322
1057,AL,5724,#N/A,5540,8554,4799,3916,4428,#N/A,5837.956178,6836,8554,30868,-893,-1238,-19769,271,32961,29975,29630,11099,31139
1059,AL,5088,#N/A,5540,8554,4799,3916,4330,#N/A,5401.102314,6836,8554,29795,-1120,-1465,-20128,44,32227,28675,28330,9667,29839
1061,AL,5280,#N/A,5540,8554,4799,3916,4359,#N/A,5798.24219,6836,8097,29928,-1120,-1465,-20128,44,32448,28808,28463,9800,29972
1063,AL,7392,#N/A,5540,8554,4799,3916,4687,#N/A,5996.812128,6836,8554,32695,3159,2814,-15453,4323,34888,35854,35509,17242,37018
1065,AL,7392,#N/A,5540,8554,4799,3916,4687,#N/A,5996.812128,6836,8332,32473,3159,2814,-15453,4323,34888,35632,35287,17020,36796
1067,AL,5280,#N/A,5540,8554,4799,3916,4359,#N/A,5837.956178,6836,8106,29976,-1120,-1465,-20128,44,32448,28856,28511,9848,30020
1069,AL,5280,#N/A,5540,8554,4799,3916,4359,#N/A,5897.527159,6836,8061,29991,-1120,-1465,-20128,44,32448,28871,28526,9863,30035
1071,AL,5724,#N/A,5540,8554,4799,3916,4428,#N/A,5738.671209,6836,7693,29907,-1120,-1465,-20128,44,32961,28787,28442,9779,29951
1073,AL,7524,#N/A,5540,8554,4799,3916,4708,#N/A,5361.388326,6836,8339,31976,-667,-1012,-19411,497,35041,31309,30964,12565,32473
1075,AL,5724,#N/A,5540,8554,4799,3916,4428,#N/A,5679.100227,6836,8554,30709,-893,-1238,-19769,271,32961,29816,29471,10940,30980
1077,AL,5976,#N/A,5540,8554,4799,3916,4467,#N/A,5262.103357,6836,7925,29915,-1120,-1465,-20128,44,33252,28795,28450,9787,29959
1079,AL,6024,#N/A,5540,8554,4799,3916,4475,#N/A,5639.38624,6836,8197,30612,-893,-1238,-19769,271,33308,29719,29374,10843,30883
1081,AL,6420,#N/A,5540,8554,4799,3916,4536,#N/A,6115.954091,6836,8207,31495,-667,-1012,-19411,497,33765,30828,30483,12084,31992
1083,AL,6708,#N/A,5540,8554,4799,3916,4581,#N/A,5877.670165,6836,8542,31880,-667,-1012,-19411,497,34098,31213,30868,12469,32377
1085,AL,7164,#N/A,5540,8554,4799,3916,4652,#N/A,5778.385196,6836,8322,32017,3159,2814,-15453,4323,34625,35176,34831,16564,36340
1087,AL,5016,#N/A,5540,8554,4799,3916,4319,#N/A,6433.665992,6836,8554,30756,-893,-1238,-19769,271,32144,29863,29518,10987,31027
1089,AL,6708,#N/A,5540,8554,4799,3916,4581,#N/A,5381.24532,6836,8537,31378,-667,-1012,-19411,497,34098,30711,30366,11967,31875
1091,AL,5412,#N/A,5540,8554,4799,3916,4380,#N/A,5976.955134,6836,8554,30695,-893,-1238,-19769,271,32601,29802,29457,10926,30966
1093,AL,5568,#N/A,5540,8554,4799,3916,4404,#N/A,5639.38624,6836,8554,30513,-893,-1238,-19769,271,32781,29620,29275,10744,30784
1095,AL,5124,#N/A,5540,8554,4799,3916,4335,#N/A,5599.672252,6836,7877,29353,-1120,-1465,-20128,44,32268,28233,27888,9225,29397
1097,AL,7788,#N/A,5540,8554,4799,3916,4749,#N/A,5917.384153,6836,8185,32642,3159,2814,-15453,4323,35346,35801,35456,17189,36965
1099,AL,5724,#N/A,5540,8554,4799,3916,4428,#N/A,5837.956178,6836,8554,30868,-893,-1238,-19769,271,32961,29975,29630,11099,31139
1101,AL,7164,#N/A,5540,8554,4799,3916,4652,#N/A,5559.958264,6836,8298,31774,-667,-1012,-19411,497,34625,31107,30762,12363,32271
1103,AL,6024,#N/A,5540,8554,4799,3916,4475,#N/A,5341.531333,6836,8166,30284,-893,-1238,-19769,271,33308,29391,29046,10515,30555
1105,AL,5232,#N/A,5540,8554,4799,3916,4352,#N/A,5818.099184,6836,8554,30356,-893,-1238,-19769,271,32393,29463,29118,10587,30627
1107,AL,5016,#N/A,5540,8554,4799,3916,4319,#N/A,5937.241147,6836,8339,30044,-893,-1238,-19769,271,32144,29151,28806,10275,30315
1109,AL,5724,#N/A,5540,8554,4799,3916,4428,#N/A,5996.812128,6836,7520,29993,-1120,-1465,-20128,44,32961,28873,28528,9865,30037
1111,AL,5808,#N/A,5540,8554,4799,3916,4441,#N/A,5540.101271,6836,8554,30654,-893,-1238,-19769,271,33058,29761,29416,10885,30925
1113,AL,7140,#N/A,5540,8554,4799,3916,4648,#N/A,5957.098141,6836,8182,32032,3159,2814,-15453,4323,34597,35191,34846,16579,36355
1115,AL,7524,#N/A,5540,8554,4799,3916,4708,#N/A,5957.098141,6836,8345,32578,3159,2814,-15453,4323,35041,35737,35392,17125,36901
1117,AL,7524,#N/A,5540,8554,4799,3916,4708,#N/A,5937.241147,6836,8346,32559,3159,2814,-15453,4323,35041,35718,35373,17106,36882
1119,AL,5724,#N/A,5540,8554,4799,3916,4428,#N/A,5639.38624,6836,8554,30669,-893,-1238,-19769,271,32961,29776,29431,10900,30940
1121,AL,5016,#N/A,5540,8554,4799,3916,4319,#N/A,5738.671209,6836,7486,28993,-1346,-1691,-20486,-182,32144,27647,27302,8507,28811
1123,AL,5448,#N/A,5540,8554,4799,3916,4386,#N/A,5877.670165,6836,8554,30632,-893,-1238,-19769,271,32643,29739,29394,10863,30903
1125,AL,7392,#N/A,5540,8554,4799,3916,4687,#N/A,6135.811085,6836,8342,32622,3159,2814,-15453,4323,34888,35781,35436,17169,36945
1127,AL,5604,#N/A,5540,8554,4799,3916,4410,#N/A,5679.100227,6836,8347,30382,-893,-1238,-19769,271,32823,29489,29144,10613,30653
1129,AL,5724,#N/A,5540,8554,4799,3916,4428,#N/A,5837.956178,6836,8554,30868,-893,-1238,-19769,271,32961,29975,29630,11099,31139
1131,AL,5016,#N/A,5540,8554,4799,3916,4319,#N/A,5976.955134,6836,8554,30299,-893,-1238,-19769,271,32144,29406,29061,10530,30570
1133,AL,5724,#N/A,5540,8554,4799,3916,4428,#N/A,5718.814215,6836,8554,30749,-893,-1238,-19769,271,32961,29856,29511,10980,31020
2013,AK,7212,#N/A,6612,7382,4854,3971,3460,#N/A,9432.344462,16058,7382,44055,-10648,-4822,-21715,-3523,33491,33407,39233,22340,40532
2016,AK,12732,#N/A,6612,7382,4854,3971,4096,#N/A,12371.06485,16058,7382,52514,-726,5710,-10737,6399,39647,51788,58224,41777,58913
2020,AK,10740,#N/A,6612,7382,4854,3971,3866,#N/A,7512.696469,16058,8271,46553,-10195,-4217,-20998,-3070,37425,36358,42336,25555,43483
2050,AK,10500,#N/A,6612,7382,4854,3971,3838,#N/A,7868.186838,16058,7382,45779,-10421,-4519,-21356,-3296,37157,35358,41260,24423,42483
2060,AK,8964,#N/A,6612,7382,4854,3971,3661,#N/A,7820.788122,16058,7382,44196,-10648,-4822,-21715,-3523,35444,33548,39374,22481,40673
2068,AK,6444,#N/A,6612,7382,4854,3971,3371,#N/A,7773.389406,16058,7382,41628,-11327,-5711,-22790,-4202,32634,30301,35917,18838,37426
2070,AK,10440,#N/A,6612,7382,4854,3971,3831,#N/A,7891.886196,16058,7382,45743,-10421,-4519,-21356,-3296,37090,35322,41224,24387,42447
2090,AK,11760,#N/A,6612,7382,4854,3971,3984,#N/A,8223.677207,16058,7959,47971,-9968,-3914,-20639,-2843,38563,38003,44057,27332,45128
2100,AK,7956,#N/A,6612,7382,4854,3971,3545,#N/A,7536.395827,16058,7382,42903,-11101,-5428,-22432,-3976,34320,31802,37475,20471,38927
2105,AK,6468,#N/A,6612,7382,4854,3971,3374,#N/A,7157.206099,16058,7382,41036,-11327,-5711,-22790,-4202,32661,29709,35325,18246,36834
2110,AK,10800,#N/A,6612,7382,4854,3971,3873,#N/A,7086.108026,16058,8189,46105,-10195,-4217,-20998,-3070,37492,35910,41888,25107,43035
2122,AK,7920,#N/A,6612,7382,4854,3971,3541,#N/A,9645.638684,16058,7382,44977,-10648,-4822,-21715,-3523,34280,34329,40155,23262,41454
2130,AK,8892,#N/A,6612,7382,4854,3971,3653,#N/A,6896.513162,16058,7755,43572,-10874,-5125,-22073,-3749,35364,32698,38447,21499,39823
2150,AK,9816,#N/A,6612,7382,4854,3971,3760,#N/A,7844.48748,16058,7382,45071,-10421,-4519,-21356,-3296,36395,34650,40552,23715,41775
2164,AK,7188,#N/A,6612,7382,4854,3971,3457,#N/A,7820.788122,16058,7382,42420,-11101,-5428,-22432,-3976,33464,31319,36992,19988,38444
2170,AK,9804,#N/A,6612,7382,4854,3971,3758,#N/A,8863.559872,16058,8050,46746,-10195,-4217,-20998,-3070,36381,36551,42529,25748,43676
2180,AK,12060,#N/A,6612,7382,4854,3971,4018,#N/A,9432.344462,16058,7382,48903,-1632,4499,-12171,5493,38897,47271,53402,36732,54396
2185,AK,9468,#N/A,6612,7382,4854,3971,3720,#N/A,8318.474639,16058,7382,45197,-10421,-4519,-21356,-3296,36007,34776,40678,23841,41901
2188,AK,11544,#N/A,6612,7382,4854,3971,3959,#N/A,8816.161156,16058,7382,47771,-9968,-3914,-20639,-2843,38322,37803,43857,27132,44928
2195,AK,7344,#N/A,6612,7382,4854,3971,3475,#N/A,7157.206099,16058,7382,41912,-11327,-5711,-22790,-4202,33638,30585,36201,19122,37710
2198,AK,6432,#N/A,6612,7382,4854,3971,3370,#N/A,7157.206099,16058,7382,41000,-11327,-5711,-22790,-4202,32621,29673,35289,18210,36798
2220,AK,10056,#N/A,6612,7382,4854,3971,3787,#N/A,7512.696469,16058,7382,44980,-10648,-4822,-21715,-3523,36662,34332,40158,23265,41457
2230,AK,11328,#N/A,6612,7382,4854,3971,3934,#N/A,7370.500321,16058,7382,46110,-10195,-4217,-20998,-3070,38081,35915,41893,25112,43040
2240,AK,8388,#N/A,6612,7382,4854,3971,3595,#N/A,7797.088764,16058,7382,43596,-10874,-5125,-22073,-3749,34802,32722,38471,21523,39847
2261,AK,8244,#N/A,6612,7382,4854,3971,3579,#N/A,7797.088764,16058,7382,43452,-10874,-5125,-22073,-3749,34642,32578,38327,21379,39703
2270,AK,7344,#N/A,6612,7382,4854,3971,3475,#N/A,9432.344462,16058,7382,44187,-10648,-4822,-21715,-3523,33638,33539,39365,22472,40664
2275,AK,7524,#N/A,6612,7382,4854,3971,3496,#N/A,7654.892616,16058,7382,42590,-11101,-5428,-22432,-3976,33839,31489,37162,20158,38614
2282,AK,6696,#N/A,6612,7382,4854,3971,3400,#N/A,7939.284912,16058,7382,42046,-11101,-5428,-22432,-3976,32915,30945,36618,19614,38070
2290,AK,7068,#N/A,6612,7382,4854,3971,3443,#N/A,7891.886196,16058,7382,42371,-11101,-5428,-22432,-3976,33330,31270,36943,19939,38395
4001,AZ,5652,#N/A,6612,7382,5020,3971,4124,#N/A,6849.114446,5138,7382,28992,956,-425,-19220,1084,32761,29948,28567,9772,30076
4003,AZ,7944,#N/A,6612,7382,5020,3971,4454,#N/A,6564.722151,5138,6895,30512,1360,-20,-18551,1489,35383,31872,30492,11961,32001
4005,AZ,9792,#N/A,6612,7382,5020,3971,4720,#N/A,6991.310594,5138,7468,33360,4123,2743,-15392,4252,37497,37483,36103,17968,37612
4007,AZ,6444,#N/A,6612,7382,5020,3971,4238,#N/A,6967.611236,5138,6519,29040,1157,-223,-18886,1286,33667,30197,28817,10154,30326
4009,AZ,6504,#N/A,6612,7382,5020,3971,4246,#N/A,6754.317014,5138,7130,29497,1157,-223,-18886,1286,33735,30654,29274,10611,30783
4011,AZ,5652,#N/A,6612,7382,5020,3971,4124,#N/A,6612.120867,5138,7382,28755,956,-425,-19220,1084,32761,29711,28330,9535,29839
4012,AZ,5880,#N/A,6612,7382,5020,3971,4157,#N/A,6872.813804,5138,7382,29244,1157,-223,-18886,1286,33022,30401,29021,10358,30530
4013,AZ,9288,#N/A,6612,7382,5020,3971,4647,#N/A,6754.317014,5138,7403,32554,3921,2541,-15726,4050,36920,36475,35095,16828,36604
4015,AZ,7044,#N/A,6612,7382,5020,3971,4324,#N/A,6801.71573,5138,6378,29333,1157,-223,-18886,1286,34353,30490,29110,10447,30619
4017,AZ,5868,#N/A,6612,7382,5020,3971,4155,#N/A,6730.617656,5138,6675,28383,956,-425,-19220,1084,33008,29339,27958,9163,29467
4019,AZ,7596,#N/A,6612,7382,5020,3971,4404,#N/A,6730.617656,5138,7015,30450,1360,-20,-18551,1489,34985,31810,30430,11899,31939
4021,AZ,9288,#N/A,6612,7382,5020,3971,4647,#N/A,6493.624077,5138,7400,32291,3921,2541,-15726,4050,36920,36212,34832,16565,36341
4023,AZ,6432,#N/A,6612,7382,5020,3971,4236,#N/A,5782.643339,5138,6956,28279,956,-425,-19220,1084,33653,29235,27854,9059,29363
4025,AZ,7440,#N/A,6612,7382,5020,3971,4381,#N/A,6920.21252,5138,6667,30136,1360,-20,-18551,1489,34806,31496,30116,11585,31625
4027,AZ,7380,#N/A,6612,7382,5020,3971,4373,#N/A,5877.44077,5138,6911,29278,1157,-223,-18886,1286,34738,30435,29055,10392,30564
5001,AR,5160,#N/A,5540,8554,4503,3916,3880,#N/A,5599.672252,7340,8554,30570,-4007,-1669,-20200,-160,31553,26563,28901,10370,30410
5003,AR,4980,#N/A,5540,8554,4503,3916,3855,#N/A,5520.244277,7340,8554,30310,-4007,-1669,-20200,-160,31348,26303,28641,10110,30150
5005,AR,5364,#N/A,5540,8554,4503,3916,3908,#N/A,5619.529246,7340,7209,29448,-4244,-1906,-20569,-397,31785,25204,27542,8879,29051
5007,AR,6396,#N/A,5540,8554,4503,3916,4053,#N/A,5381.24532,7340,8468,31502,-3771,-1433,-19832,76,32962,27731,30069,11670,31578
5009,AR,4980,#N/A,5540,8554,4503,3916,3855,#N/A,4706.107531,7340,7560,28502,-4480,-2142,-20937,-633,31348,24022,26360,7565,27869
5011,AR,4980,#N/A,5540,8554,4503,3916,3855,#N/A,5579.815258,7340,8554,30370,-4007,-1669,-20200,-160,31348,26363,28701,10170,30210
5013,AR,4980,#N/A,5540,8554,4503,3916,3855,#N/A,5540.101271,7340,7465,29241,-4244,-1906,-20569,-397,31348,24997,27335,8672,28844
5015,AR,5748,#N/A,5540,8554,4503,3916,3962,#N/A,5182.675382,7340,8554,30741,-4007,-1669,-20200,-160,32223,26734,29072,10541,30581
5017,AR,5004,#N/A,5540,8554,4503,3916,3858,#N/A,5599.672252,7340,8554,30414,-4007,-1669,-20200,-160,31375,26407,28745,10214,30254
5019,AR,5160,#N/A,5540,8554,4503,3916,3880,#N/A,5540.101271,7340,7456,29412,-4244,-1906,-20569,-397,31553,25168,27506,8843,29015
5021,AR,4980,#N/A,5540,8554,4503,3916,3855,#N/A,4845.106488,7340,8554,29635,-4244,-1906,-20569,-397,31348,25391,27729,9066,29238
5023,AR,5460,#N/A,5540,8554,4503,3916,3922,#N/A,5619.529246,7340,8554,30890,-4007,-1669,-20200,-160,31895,26883,29221,10690,30730
5025,AR,5868,#N/A,5540,8554,4503,3916,3979,#N/A,5559.958264,7340,7600,30284,-4007,-1669,-20200,-160,32360,26277,28615,10084,30124
5027,AR,4980,#N/A,5540,8554,4503,3916,3855,#N/A,5778.385196,7340,7521,29536,-4244,-1906,-20569,-397,31348,25292,27630,8967,29139
5029,AR,5496,#N/A,5540,8554,4503,3916,3927,#N/A,5123.104401,7340,8554,30429,-4007,-1669,-20200,-160,31936,26422,28760,10229,30269
5031,AR,5964,#N/A,5540,8554,4503,3916,3993,#N/A,5420.959308,7340,7766,30407,-4007,-1669,-20200,-160,32470,26400,28738,10207,30247
5033,AR,5496,#N/A,5540,8554,4503,3916,3927,#N/A,5361.388326,7340,7835,29948,-4244,-1906,-20569,-397,31936,25704,28042,9379,29551
5035,AR,7896,#N/A,5540,8554,4503,3916,4263,#N/A,5599.672252,7340,8489,33240,300,2638,-15497,4147,34672,33540,35878,17743,37387
5037,AR,5544,#N/A,5540,8554,4503,3916,3934,#N/A,5500.387283,7340,8554,30854,-4007,-1669,-20200,-160,31991,26847,29185,10654,30694
5039,AR,5676,#N/A,5540,8554,4503,3916,3952,#N/A,5559.958264,7340,8554,31046,-3771,-1433,-19832,76,32141,27275,29613,11214,31122
5041,AR,4980,#N/A,5540,8554,4503,3916,3855,#N/A,5520.244277,7340,8554,30310,-4007,-1669,-20200,-160,31348,26303,28641,10110,30150
5043,AR,4980,#N/A,5540,8554,4503,3916,3855,#N/A,5659.243233,7340,8554,30449,-4007,-1669,-20200,-160,31348,26442,28780,10249,30289
5045,AR,7380,#N/A,5540,8554,4503,3916,4191,#N/A,5718.814215,7340,8451,32806,64,2402,-15865,3911,34084,32870,35208,16941,36717
5047,AR,4980,#N/A,5540,8554,4503,3916,3855,#N/A,5123.104401,7340,8554,29913,-4244,-1906,-20569,-397,31348,25669,28007,9344,29516
5049,AR,4980,#N/A,5540,8554,4503,3916,3855,#N/A,5162.818388,7340,8554,29953,-4244,-1906,-20569,-397,31348,25709,28047,9384,29556
5051,AR,6984,#N/A,5540,8554,4503,3916,4136,#N/A,5401.102314,7340,7530,31171,-3771,-1433,-19832,76,33633,27400,29738,11339,31247
5053,AR,5676,#N/A,5540,8554,4503,3916,3952,#N/A,5599.672252,7340,8461,30993,-4007,-1669,-20200,-160,32141,26986,29324,10793,30833
5055,AR,5496,#N/A,5540,8554,4503,3916,3927,#N/A,5559.958264,7340,7719,30031,-4007,-1669,-20200,-160,31936,26024,28362,9831,29871
5057,AR,5508,#N/A,5540,8554,4503,3916,3929,#N/A,5162.818388,7340,8554,30481,-4007,-1669,-20200,-160,31950,26474,28812,10281,30321
5059,AR,5676,#N/A,5540,8554,4503,3916,3952,#N/A,5440.816302,7340,8090,30463,-4007,-1669,-20200,-160,32141,26456,28794,10263,30303
5061,AR,4980,#N/A,5540,8554,4503,3916,3855,#N/A,5301.817345,7340,8554,30092,-4007,-1669,-20200,-160,31348,26085,28423,9892,29932
5063,AR,5052,#N/A,5540,8554,4503,3916,3865,#N/A,5341.531333,7340,7630,29280,-4244,-1906,-20569,-397,31430,25036,27374,8711,28883
5065,AR,4980,#N/A,5540,8554,4503,3916,3855,#N/A,5341.531333,7340,8554,30132,-4007,-1669,-20200,-160,31348,26125,28463,9932,29972
5067,AR,4980,#N/A,5540,8554,4503,3916,3855,#N/A,5480.530289,7340,8554,30271,-4007,-1669,-20200,-160,31348,26264,28602,10071,30111
5069,AR,5868,#N/A,5540,8554,4503,3916,3979,#N/A,5520.244277,7340,7502,30146,-4007,-1669,-20200,-160,32360,26139,28477,9946,29986
5071,AR,5184,#N/A,5540,8554,4503,3916,3883,#N/A,5301.817345,7340,8554,30296,-4007,-1669,-20200,-160,31580,26289,28627,10096,30136
5073,AR,4980,#N/A,5540,8554,4503,3916,3855,#N/A,5599.672252,7340,8554,30390,-4007,-1669,-20200,-160,31348,26383,28721,10190,30230
5075,AR,4980,#N/A,5540,8554,4503,3916,3855,#N/A,5381.24532,7340,8554,30171,-4007,-1669,-20200,-160,31348,26164,28502,9971,30011
5077,AR,5676,#N/A,5540,8554,4503,3916,3952,#N/A,5460.673295,7340,8554,30947,-4007,-1669,-20200,-160,32141,26940,29278,10747,30787
5079,AR,5868,#N/A,5540,8554,4503,3916,3979,#N/A,5520.244277,7340,7572,30216,-4007,-1669,-20200,-160,32360,26209,28547,10016,30056
5081,AR,5496,#N/A,5540,8554,4503,3916,3927,#N/A,5262.103357,7340,8142,30156,-4007,-1669,-20200,-160,31936,26149,28487,9956,29996
5083,AR,4980,#N/A,5540,8554,4503,3916,3855,#N/A,4864.963481,7340,8554,29655,-4244,-1906,-20569,-397,31348,25411,27749,9086,29258
5085,AR,7380,#N/A,5540,8554,4503,3916,4191,#N/A,5659.243233,7340,8459,32754,64,2402,-15865,3911,34084,32818,35156,16889,36665
5087,AR,6396,#N/A,5540,8554,4503,3916,4053,#N/A,5341.531333,7340,8467,31461,-3771,-1433,-19832,76,32962,27690,30028,11629,31537
5089,AR,4980,#N/A,5540,8554,4503,3916,3855,#N/A,5262.103357,7340,8554,30052,-4007,-1669,-20200,-160,31348,26045,28383,9852,29892
5091,AR,6876,#N/A,5540,8554,4503,3916,4120,#N/A,5619.529246,7340,8140,31892,-3771,-1433,-19832,76,33509,28121,30459,12060,31968
5093,AR,4980,#N/A,5540,8554,4503,3916,3855,#N/A,5440.816302,7340,7691,29368,-4244,-1906,-20569,-397,31348,25124,27462,8799,28971
5095,AR,4980,#N/A,5540,8554,4503,3916,3855,#N/A,5361.388326,7340,8554,30151,-4007,-1669,-20200,-160,31348,26144,28482,9951,29991
5097,AR,4980,#N/A,5540,8554,4503,3916,3855,#N/A,5301.817345,7340,8554,30092,-4007,-1669,-20200,-160,31348,26085,28423,9892,29932
5099,AR,4980,#N/A,5540,8554,4503,3916,3855,#N/A,5381.24532,7340,8554,30171,-4007,-1669,-20200,-160,31348,26164,28502,9971,30011
5101,AR,4980,#N/A,5540,8554,4503,3916,3855,#N/A,5281.960351,7340,7622,29140,-4244,-1906,-20569,-397,31348,24896,27234,8571,28743
5103,AR,5220,#N/A,5540,8554,4503,3916,3888,#N/A,5599.672252,7340,7407,29482,-4244,-1906,-20569,-397,31621,25238,27576,8913,29085
5105,AR,7380,#N/A,5540,8554,4503,3916,4191,#N/A,5659.243233,7340,8463,32758,64,2402,-15865,3911,34084,32822,35160,16893,36669
5107,AR,4980,#N/A,5540,8554,4503,3916,3855,#N/A,5500.387283,7340,7101,28837,-4480,-2142,-20937,-633,31348,24357,26695,7900,28204
5109,AR,5148,#N/A,5540,8554,4503,3916,3878,#N/A,5361.388326,7340,8554,30319,-4007,-1669,-20200,-160,31539,26312,28650,10119,30159
5111,AR,5148,#N/A,5540,8554,4503,3916,3878,#N/A,5301.817345,7340,7800,29506,-4244,-1906,-20569,-397,31539,25262,27600,8937,29109
5113,AR,5196,#N/A,5540,8554,4503,3916,3885,#N/A,5301.817345,7340,8554,30308,-4007,-1669,-20200,-160,31594,26301,28639,10108,30148
5115,AR,5280,#N/A,5540,8554,4503,3916,3897,#N/A,5559.958264,7340,7927,30023,-4007,-1669,-20200,-160,31690,26016,28354,9823,29863
5117,AR,5676,#N/A,5540,8554,4503,3916,3952,#N/A,5599.672252,7340,8554,31086,-3771,-1433,-19832,76,32141,27315,29653,11254,31162
5119,AR,7380,#N/A,5540,8554,4503,3916,4191,#N/A,5639.38624,7340,8455,32730,64,2402,-15865,3911,34084,32794,35132,16865,36641
5121,AR,4980,#N/A,5540,8554,4503,3916,3855,#N/A,5341.531333,7340,8554,30132,-4007,-1669,-20200,-160,31348,26125,28463,9932,29972
5123,AR,5676,#N/A,5540,8554,4503,3916,3952,#N/A,5520.244277,7340,7298,29750,-4244,-1906,-20569,-397,32141,25506,27844,9181,29353
5125,AR,7380,#N/A,5540,8554,4503,3916,4191,#N/A,5718.814215,7340,8455,32810,64,2402,-15865,3911,34084,32874,35212,16945,36721
5127,AR,4980,#N/A,5540,8554,4503,3916,3855,#N/A,5202.532376,7340,8554,29993,-4244,-1906,-20569,-397,31348,25749,28087,9424,29596
5129,AR,4980,#N/A,5540,8554,4503,3916,3855,#N/A,5262.103357,7340,8554,30052,-4007,-1669,-20200,-160,31348,26045,28383,9852,29892
5131,AR,5496,#N/A,5540,8554,4503,3916,3927,#N/A,5063.533419,7340,7809,29624,-4244,-1906,-20569,-397,31936,25380,27718,9055,29227
5133,AR,5340,#N/A,5540,8554,4503,3916,3905,#N/A,5281.960351,7340,8554,30432,-4007,-1669,-20200,-160,31758,26425,28763,10232,30272
5135,AR,4980,#N/A,5540,8554,4503,3916,3855,#N/A,5222.38937,7340,8554,30012,-4007,-1669,-20200,-160,31348,26005,28343,9812,29852
5137,AR,4980,#N/A,5540,8554,4503,3916,3855,#N/A,5420.959308,7340,8554,30211,-4007,-1669,-20200,-160,31348,26204,28542,10011,30051
5139,AR,5496,#N/A,5540,8554,4503,3916,3927,#N/A,5559.958264,7340,7606,29918,-4244,-1906,-20569,-397,31936,25674,28012,9349,29521
5141,AR,5676,#N/A,5540,8554,4503,3916,3952,#N/A,5619.529246,7340,8554,31106,-3771,-1433,-19832,76,32141,27335,29673,11274,31182
5143,AR,6396,#N/A,5540,8554,4503,3916,4053,#N/A,5321.674339,7340,8467,31441,-3771,-1433,-19832,76,32962,27670,30008,11609,31517
5145,AR,5184,#N/A,5540,8554,4503,3916,3883,#N/A,5639.38624,7340,8107,30187,-4007,-1669,-20200,-160,31580,26180,28518,9987,30027
5147,AR,4980,#N/A,5540,8554,4503,3916,3855,#N/A,5500.387283,7340,8554,30290,-4007,-1669,-20200,-160,31348,26283,28621,10090,30130
5149,AR,4980,#N/A,5540,8554,4503,3916,3855,#N/A,5142.961395,7340,7950,29329,-4244,-1906,-20569,-397,31348,25085,27423,8760,28932
6001,CA,15060,#N/A,6612,7382,4817,3971,5116,#N/A,8057.781701,5954,8155,41197,5646,4268,-12811,5777,42958,46843,45465,28386,46974
6003,CA,8100,#N/A,6612,7382,4817,3971,4175,#N/A,7607.4939,5954,7382,33014,-1184,2598,-15537,4107,35057,31830,35612,17477,37121
6005,CA,9300,#N/A,6612,7382,4817,3971,4338,#N/A,8768.76244,5954,7382,35376,-191,2991,-14880,4500,36420,35185,38367,20496,39876
6007,CA,7752,#N/A,6612,7382,4817,3971,4128,#N/A,7062.408668,5954,6903,31642,-5149,-768,-19167,741,34662,26493,30874,12475,32383
6009,CA,8832,#N/A,6612,7382,4817,3971,4274,#N/A,8531.76886,5954,7382,34671,-687,2795,-15208,4304,35888,33984,37466,19463,38975
6011,CA,7200,#N/A,6612,7382,4817,3971,4054,#N/A,9479.743178,5954,7382,33987,-1184,2598,-15537,4107,34036,32803,36585,18450,38094
6013,CA,15060,#N/A,6612,7382,4817,3971,5116,#N/A,7844.48748,5954,8093,40922,5399,4021,-13190,5530,42958,46321,44943,27732,46452
6015,CA,7716,#N/A,6612,7382,4817,3971,4123,#N/A,7678.591974,5954,6488,31808,-5149,-768,-19167,741,34621,26659,31040,12641,32549
6017,CA,10248,#N/A,6612,7382,4817,3971,4466,#N/A,9053.154735,5954,7436,36662,306,3188,-14551,4697,37496,36968,39850,22111,41359
6019,CA,7860,#N/A,6612,7382,4817,3971,4143,#N/A,6398.826645,5954,7468,31652,-5149,-768,-19167,741,34785,26503,30884,12485,32393
6021,CA,7308,#N/A,6612,7382,4817,3971,4068,#N/A,6920.21252,5954,7382,31535,-5149,-768,-19167,741,34158,26386,30767,12368,32276
6023,CA,8772,#N/A,6612,7382,4817,3971,4266,#N/A,6991.310594,5954,6954,32642,-1680,2402,-15865,3911,35820,30962,35044,16777,36553
6025,CA,7512,#N/A,6612,7382,4817,3971,4096,#N/A,5995.93756,5954,7361,30794,-5645,-964,-19495,545,34390,25149,29830,11299,31339
6027,CA,9708,#N/A,6612,7382,4817,3971,4393,#N/A,6872.813804,5954,7382,33888,-1184,2598,-15537,4107,36883,32704,36486,18351,37995
6029,CA,7476,#N/A,6612,7382,4817,3971,4091,#N/A,6635.820225,5954,7528,31565,-5149,-768,-19167,741,34349,26416,30797,12398,32306
6031,CA,7884,#N/A,6612,7382,4817,3971,4146,#N/A,6469.924719,5954,7558,31836,-5149,-768,-19167,741,34812,26687,31068,12669,32577
6033,CA,7776,#N/A,6612,7382,4817,3971,4132,#N/A,8247.376565,5954,6238,32186,-1680,2402,-15865,3911,34690,30506,34588,16321,36097
6035,CA,8376,#N/A,6612,7382,4817,3971,4213,#N/A,7986.683628,5954,6695,32983,-1680,2402,-15865,3911,35371,31303,35385,17118,36894
6037,CA,12996,#N/A,6612,7382,4817,3971,4837,#N/A,7299.402247,5954,8189,38410,4959,3581,-13894,5090,40615,43369,41991,24516,43500
6039,CA,6960,#N/A,6612,7382,4817,3971,4021,#N/A,7891.886196,5954,7200,31977,-5149,-768,-19167,741,33763,26828,31209,12810,32718
6041,CA,18612,#N/A,6612,7382,4817,3971,5597,#N/A,8863.559872,5954,8086,45487,6633,5541,-11296,6764,46991,52120,51028,34191,52251
6043,CA,6864,#N/A,6612,7382,4817,3971,4008,#N/A,6683.218941,5954,7382,30854,-5645,-964,-19495,545,33654,25209,29890,11359,31399
6045,CA,8424,#N/A,6612,7382,4817,3971,4219,#N/A,8294.775281,5954,7002,33645,-1184,2598,-15537,4107,35425,32461,36243,18108,37752
6047,CA,7248,#N/A,6612,7382,4817,3971,4060,#N/A,6706.918299,5954,7484,31364,-5149,-768,-19167,741,34090,26215,30596,12197,32105
6049,CA,6444,#N/A,6612,7382,4817,3971,3951,#N/A,6872.813804,5954,7382,30624,-5645,-964,-19495,545,33177,24979,29660,11129,31169
6051,CA,12672,#N/A,6612,7382,4817,3971,4793,#N/A,6778.016372,5954,7382,36757,306,3188,-14551,4697,40247,37063,39945,22206,41454
6053,CA,11760,#N/A,6612,7382,4817,3971,4670,#N/A,7133.506742,5954,7893,36711,306,3188,-14551,4697,39212,37017,39899,22160,41408
6055,CA,12684,#N/A,6612,7382,4817,3971,4795,#N/A,8555.468218,5954,8010,39175,5155,3777,-13566,5286,40261,44330,42952,25609,44461
6057,CA,9480,#N/A,6612,7382,4817,3971,4362,#N/A,9527.141894,5954,7042,35974,-191,2991,-14880,4500,36624,35783,38965,21094,40474
6059,CA,15744,#N/A,6612,7382,4817,3971,5209,#N/A,7394.199679,5954,8153,41216,5646,4268,-12811,5777,43735,46862,45484,28405,46993
6061,CA,10248,#N/A,6612,7382,4817,3971,4466,#N/A,7868.186838,5954,7440,35481,-191,2991,-14880,4500,37496,35290,38472,20601,39981
6063,CA,8280,#N/A,6612,7382,4817,3971,4200,#N/A,7157.206099,5954,7382,32744,-1680,2402,-15865,3911,35262,31064,35146,16879,36655
6065,CA,10584,#N/A,6612,7382,4817,3971,4511,#N/A,6730.617656,5954,7760,34999,-687,2795,-15208,4304,37877,34312,37794,19791,39303
6067,CA,10248,#N/A,6612,7382,4817,3971,4466,#N/A,6920.21252,5954,7448,34542,-687,2795,-15208,4304,37496,33855,37337,19334,38846
6069,CA,10608,#N/A,6612,7382,4817,3971,4514,#N/A,8460.670786,5954,8404,37397,802,3384,-14223,4893,37904,38199,40781,23174,42290
6071,CA,10584,#N/A,6612,7382,4817,3971,4511,#N/A,6564.722151,5954,7768,34842,-687,2795,-15208,4304,37877,34155,37637,19634,39146
6073,CA,12384,#N/A,6612,7382,4817,3971,4755,#N/A,7512.696469,5954,7998,37820,802,3384,-14223,4893,39921,38622,41204,23597,42713
6075,CA,18612,#N/A,6612,7382,4817,3971,5597,#N/A,9290.148315,5954,8374,46202,6899,5883,-10898,7030,46991,53101,52085,35304,53232
6077,CA,8508,#N/A,6612,7382,4817,3971,4230,#N/A,6754.317014,5954,7602,32789,-1680,2402,-15865,3911,35520,31109,35191,16924,36700
6079,CA,11292,#N/A,6612,7382,4817,3971,4607,#N/A,7915.585554,5954,7305,36438,306,3188,-14551,4697,38681,36744,39626,21887,41135
6081,CA,18612,#N/A,6612,7382,4817,3971,5597,#N/A,8199.977849,5954,8115,44852,6385,5217,-11676,6516,46991,51237,50069,33176,51368
6083,CA,12732,#N/A,6612,7382,4817,3971,4802,#N/A,7252.003531,5954,8014,37923,802,3384,-14223,4893,40316,38725,41307,23700,42816
6085,CA,15516,#N/A,6612,7382,4817,3971,5178,#N/A,7939.284912,5954,8611,41992,5646,4268,-12811,5777,43476,47638,46260,29181,47769
6087,CA,14160,#N/A,6612,7382,4817,3971,4995,#N/A,8199.977849,5954,7951,40236,5399,4021,-13190,5530,41937,45635,44257,27046,45766
6089,CA,8976,#N/A,6612,7382,4817,3971,4294,#N/A,6683.218941,5954,6916,32500,-1680,2402,-15865,3911,36052,30820,34902,16635,36411
6091,CA,7668,#N/A,6612,7382,4817,3971,4117,#N/A,7417.899037,5954,7382,32393,-1680,2402,-15865,3911,34567,30713,34795,16528,36304
6093,CA,7416,#N/A,6612,7382,4817,3971,4083,#N/A,7228.304173,5954,7382,31951,-5149,-768,-19167,741,34281,26802,31183,12784,32692
6095,CA,11136,#N/A,6612,7382,4817,3971,4586,#N/A,6943.911878,5954,8016,36020,306,3188,-14551,4697,38504,36326,39208,21469,40717
6097,CA,11472,#N/A,6612,7382,4817,3971,4631,#N/A,8057.781701,5954,7718,37173,802,3384,-14223,4893,38885,37975,40557,22950,42066
6099,CA,8520,#N/A,6612,7382,4817,3971,4232,#N/A,6754.317014,5954,7482,32681,-1680,2402,-15865,3911,35534,31001,35083,16816,36592
6101,CA,7404,#N/A,6612,7382,4817,3971,4081,#N/A,5995.93756,5954,7288,30613,-5645,-964,-19495,545,34267,24968,29649,11118,31158
6103,CA,7452,#N/A,6612,7382,4817,3971,4088,#N/A,7086.108026,5954,6954,31417,-5149,-768,-19167,741,34322,26268,30649,12250,32158
6105,CA,8472,#N/A,6612,7382,4817,3971,4226,#N/A,7062.408668,5954,7382,32841,-1680,2402,-15865,3911,35480,31161,35243,16976,36752
6107,CA,6912,#N/A,6612,7382,4817,3971,4015,#N/A,6446.225361,5954,7550,30833,-5645,-964,-19495,545,33709,25188,29869,11338,31378
6109,CA,8376,#N/A,6612,7382,4817,3971,4213,#N/A,8531.76886,5954,6684,33517,-1184,2598,-15537,4107,35371,32333,36115,17980,37624
6111,CA,13224,#N/A,6612,7382,4817,3971,4868,#N/A,7702.291332,5954,8410,39262,5155,3777,-13566,5286,40874,44417,43039,25696,44548
6113,CA,9804,#N/A,6612,7382,4817,3971,4406,#N/A,7228.304173,5954,7446,34404,-687,2795,-15208,4304,36992,33717,37199,19196,38708
6115,CA,7404,#N/A,6612,7382,4817,3971,4081,#N/A,6256.630498,5954,7291,30877,-5645,-964,-19495,545,34267,25232,29913,11382,31422
8001,CO,8904,#N/A,6612,7382,4561,3971,5076,#N/A,6635.820225,6650,7834,33995,1375,3606,-14529,5115,36506,35370,37601,19466,39110
8003,CO,6444,#N/A,6612,7382,4561,3971,4679,#N/A,7204.604815,6650,7382,31652,-2962,-432,-18831,1077,33649,28690,31220,12821,32729
8005,CO,8904,#N/A,6612,7382,4561,3971,5076,#N/A,7133.506742,6650,7846,34504,1595,3826,-14177,5335,36506,36099,38330,20327,39839
8007,CO,6756,#N/A,6612,7382,4561,3971,4729,#N/A,7133.506742,6650,7382,31893,-2962,-432,-18831,1077,34011,28931,31461,13062,32970
8009,CO,6444,#N/A,6612,7382,4561,3971,4679,#N/A,6161.833066,6650,7382,30609,-3481,-651,-19182,858,33649,27128,29958,11427,31467
8011,CO,5652,#N/A,6612,7382,4561,3971,4551,#N/A,6517.323435,6650,7382,30172,-3481,-651,-19182,858,32729,26691,29521,10990,31030
8013,CO,11424,#N/A,6612,7382,4561,3971,5483,#N/A,8034.082343,6650,7752,37831,2253,4484,-13123,5993,39433,40084,42315,24708,43824
8014,CO,8904,#N/A,6612,7382,4561,3971,5076,#N/A,8365.873355,6650,7824,35715,1814,4045,-13826,5554,36506,37529,39760,21889,41269
8015,CO,6180,#N/A,6612,7382,4561,3971,4636,#N/A,7086.108026,6650,7382,31269,-2962,-432,-18831,1077,33342,28307,30837,12438,32346
8017,CO,5652,#N/A,6612,7382,4561,3971,4551,#N/A,6612.120867,6650,7382,30267,-3481,-651,-19182,858,32729,26786,29616,11085,31125
8019,CO,8904,#N/A,6612,7382,4561,3971,5076,#N/A,7346.800963,6650,7783,34655,1595,3826,-14177,5335,36506,36250,38481,20478,39990
8021,CO,6444,#N/A,6612,7382,4561,3971,4679,#N/A,7228.304173,6650,7382,31675,-2962,-432,-18831,1077,33649,28713,31243,12844,32752
8023,CO,6444,#N/A,6612,7382,4561,3971,4679,#N/A,7323.101605,6650,7382,31770,-2962,-432,-18831,1077,33649,28808,31338,12939,32847
8025,CO,5652,#N/A,6612,7382,4561,3971,4551,#N/A,6896.513162,6650,7382,30552,-3481,-651,-19182,858,32729,27071,29901,11370,31410
8027,CO,5652,#N/A,6612,7382,4561,3971,4551,#N/A,6469.924719,6650,7382,30125,-3481,-651,-19182,858,32729,26644,29474,10943,30983
8029,CO,6744,#N/A,6612,7382,4561,3971,4727,#N/A,7133.506742,6650,7382,31881,-2962,-432,-18831,1077,33997,28919,31449,13050,32958
8031,CO,8904,#N/A,6612,7382,4561,3971,5076,#N/A,7370.500321,6650,7873,34768,1595,3826,-14177,5335,36506,36363,38594,20591,40103
8033,CO,6444,#N/A,6612,7382,4561,3971,4679,#N/A,7749.690048,6650,7382,32197,1156,3387,-14880,4896,33649,33353,35584,17317,37093
8035,CO,8904,#N/A,6612,7382,4561,3971,5076,#N/A,7299.402247,6650,7813,34637,1595,3826,-14177,5335,36506,36232,38463,20460,39972
8037,CO,10596,#N/A,6612,7382,4561,3971,5349,#N/A,7038.70931,6650,8523,36778,2034,4265,-13474,5774,38471,38812,41043,23304,42552
8039,CO,8904,#N/A,6612,7382,4561,3971,5076,#N/A,7583.794542,6650,7787,34896,1595,3826,-14177,5335,36506,36491,38722,20719,40231
8041,CO,7464,#N/A,6612,7382,4561,3971,4843,#N/A,6849.114446,6650,7480,32414,1156,3387,-14880,4896,34833,33570,35801,17534,37310
8043,CO,6624,#N/A,6612,7382,4561,3971,4708,#N/A,6754.317014,6650,6048,30047,-3481,-651,-19182,858,33858,26566,29396,10865,30905
8045,CO,9936,#N/A,6612,7382,4561,3971,5243,#N/A,7583.794542,6650,7884,36025,2034,4265,-13474,5774,37705,38059,40290,22551,41799
8047,CO,8904,#N/A,6612,7382,4561,3971,5076,#N/A,7323.101605,6650,7772,34621,1595,3826,-14177,5335,36506,36216,38447,20444,39956
8049,CO,7896,#N/A,6612,7382,4561,3971,4913,#N/A,7417.899037,6650,7382,33317,1375,3606,-14529,5115,35335,34692,36923,18788,38432
8051,CO,7920,#N/A,6612,7382,4561,3971,4917,#N/A,7370.500321,6650,7382,33294,1375,3606,-14529,5115,35363,34669,36900,18765,38409
8053,CO,7968,#N/A,6612,7382,4561,3971,4925,#N/A,8081.481059,6650,7382,34052,1595,3826,-14177,5335,35419,35647,37878,19875,39387
8055,CO,6180,#N/A,6612,7382,4561,3971,4636,#N/A,6683.218941,6650,7382,30866,-3481,-651,-19182,858,33342,27385,30215,11684,31724
8057,CO,6420,#N/A,6612,7382,4561,3971,4675,#N/A,8081.481059,6650,7382,32504,1156,3387,-14880,4896,33621,33660,35891,17624,37400
8059,CO,8904,#N/A,6612,7382,4561,3971,5076,#N/A,7346.800963,6650,7832,34704,1595,3826,-14177,5335,36506,36299,38530,20527,40039
8061,CO,5892,#N/A,6612,7382,4561,3971,4589,#N/A,6564.722151,6650,7382,30460,-3481,-651,-19182,858,33007,26979,29809,11278,31318
8063,CO,5652,#N/A,6612,7382,4561,3971,4551,#N/A,6588.421509,6650,7382,30243,-3481,-651,-19182,858,32729,26762,29592,11061,31101
8065,CO,8700,#N/A,6612,7382,4561,3971,5043,#N/A,7915.585554,6650,7382,34619,1595,3826,-14177,5335,36269,36214,38445,20442,39954
8067,CO,8892,#N/A,6612,7382,4561,3971,5074,#N/A,8389.572713,6650,7357,35260,1814,4045,-13826,5554,36492,37074,39305,21434,40814
8069,CO,8928,#N/A,6612,7382,4561,3971,5080,#N/A,7417.899037,6650,7416,34383,1595,3826,-14177,5335,36534,35978,38209,20206,39718
8071,CO,6072,#N/A,6612,7382,4561,3971,4619,#N/A,6635.820225,6650,7382,30711,-3481,-651,-19182,858,33217,27230,30060,11529,31569
8073,CO,6468,#N/A,6612,7382,4561,3971,4683,#N/A,7204.604815,6650,7382,31676,-2962,-432,-18831,1077,33677,28714,31244,12845,32753
8075,CO,5700,#N/A,6612,7382,4561,3971,4558,#N/A,6612.120867,6650,7219,30152,-3481,-651,-19182,858,32784,26671,29501,10970,31010
8077,CO,6900,#N/A,6612,7382,4561,3971,4752,#N/A,6943.911878,6650,7154,31619,-2962,-432,-18831,1077,34178,28657,31187,12788,32696
8079,CO,7296,#N/A,6612,7382,4561,3971,4816,#N/A,7891.886196,6650,7382,33191,1375,3606,-14529,5115,34638,34566,36797,18662,38306
8081,CO,6960,#N/A,6612,7382,4561,3971,4762,#N/A,7370.500321,6650,7485,32436,1156,3387,-14880,4896,34248,33592,35823,17556,37332
8083,CO,6444,#N/A,6612,7382,4561,3971,4679,#N/A,7062.408668,6650,7382,31509,-2962,-432,-18831,1077,33649,28547,31077,12678,32586
8085,CO,6744,#N/A,6612,7382,4561,3971,4727,#N/A,7299.402247,6650,6996,31660,-2962,-432,-18831,1077,33997,28698,31228,12829,32737
8087,CO,6072,#N/A,6612,7382,4561,3971,4619,#N/A,6612.120867,6650,7242,30547,-3481,-651,-19182,858,33217,27066,29896,11365,31405
8089,CO,5652,#N/A,6612,7382,4561,3971,4551,#N/A,6446.225361,6650,7382,30101,-3481,-651,-19182,858,32729,26620,29450,10919,30959
8091,CO,8988,#N/A,6612,7382,4561,3971,5090,#N/A,7394.199679,6650,7382,34385,1595,3826,-14177,5335,36604,35980,38211,20208,39720
8093,CO,8904,#N/A,6612,7382,4561,3971,5076,#N/A,7133.506742,6650,7759,34418,1595,3826,-14177,5335,36506,36013,38244,20241,39753
8095,CO,5928,#N/A,6612,7382,4561,3971,4595,#N/A,6872.813804,6650,7382,30804,-3481,-651,-19182,858,33049,27323,30153,11622,31662
8097,CO,11808,#N/A,6612,7382,4561,3971,5545,#N/A,7678.591974,6650,7881,37989,2253,4484,-13123,5993,39879,40242,42473,24866,43982
8099,CO,5652,#N/A,6612,7382,4561,3971,4551,#N/A,6493.624077,6650,7382,30149,-3481,-651,-19182,858,32729,26668,29498,10967,31007
8101,CO,6360,#N/A,6612,7382,4561,3971,4665,#N/A,6398.826645,6650,6907,30287,-3481,-651,-19182,858,33551,26806,29636,11105,31145
8103,CO,6360,#N/A,6612,7382,4561,3971,4665,#N/A,7465.297753,6650,7382,31828,-2962,-432,-18831,1077,33551,28866,31396,12997,32905
8105,CO,6444,#N/A,6612,7382,4561,3971,4679,#N/A,7394.199679,6650,7382,31841,-2962,-432,-18831,1077,33649,28879,31409,13010,32918
8107,CO,10512,#N/A,6612,7382,4561,3971,5336,#N/A,9124.252809,6650,7810,38067,2473,4704,-12771,6213,38374,40540,42771,25296,44280
8109,CO,6444,#N/A,6612,7382,4561,3971,4679,#N/A,7323.101605,6650,7382,31770,-2962,-432,-18831,1077,33649,28808,31338,12939,32847
8111,CO,7464,#N/A,6612,7382,4561,3971,4843,#N/A,7986.683628,6650,7382,33454,1375,3606,-14529,5115,34833,34829,37060,18925,38569
8113,CO,10968,#N/A,6612,7382,4561,3971,5409,#N/A,7252.003531,6650,7382,36223,2034,4265,-13474,5774,38903,38257,40488,22749,41997
8115,CO,6444,#N/A,6612,7382,4561,3971,4679,#N/A,6967.611236,6650,7382,31415,-2962,-432,-18831,1077,33649,28453,30983,12584,32492
8117,CO,11940,#N/A,6612,7382,4561,3971,5566,#N/A,9100.553451,6650,7982,39643,2692,4923,-12420,6432,40032,42335,44566,27223,46075
8119,CO,8268,#N/A,6612,7382,4561,3971,4973,#N/A,7702.291332,6650,7463,34054,1595,3826,-14177,5335,35767,35649,37880,19877,39389
8121,CO,5724,#N/A,6612,7382,4561,3971,4562,#N/A,6920.21252,6650,7382,30647,-3481,-651,-19182,858,32812,27166,29996,11465,31505
8123,CO,6612,#N/A,6612,7382,4561,3971,4706,#N/A,6967.611236,6650,7620,31820,-2962,-432,-18831,1077,33844,28858,31388,12989,32897
8125,CO,5652,#N/A,6612,7382,4561,3971,4551,#N/A,6612.120867,6650,7382,30267,-3481,-651,-19182,858,32729,26786,29616,11085,31125
9001,CT,13197,#N/A,6434,6855,5049,3644,5812,#N/A,7518.001225,7528,7667,39554,401,2832,-14511,4341,40991,39955,42386,25043,43895
9003,CT,11268,#N/A,6434,6855,5049,3644,5493,#N/A,6687.792501,7528,7280,36408,-1663,2213,-15526,3722,38743,34745,38621,20882,40130
9005,CT,9144,#N/A,6434,6855,5049,3644,5142,#N/A,7172.080923,7528,7323,34811,-3276,1800,-16203,3309,36268,31535,36611,18608,38120
9007,CT,11359,#N/A,6434,6855,5049,3644,5508,#N/A,7610.246639,7528,7254,37396,-612,2419,-15188,3928,38849,36784,39815,22208,41324
9009,CT,11238,#N/A,6434,6855,5049,3644,5488,#N/A,6733.915208,7528,7221,36365,-1663,2213,-15526,3722,38708,34702,38578,20839,40087
9011,CT,9491,#N/A,6434,6855,5049,3644,5199,#N/A,7494.939872,7528,7216,35374,-2470,2006,-15865,3515,36672,32904,37380,19509,38889
9013,CT,11268,#N/A,6434,6855,5049,3644,5493,#N/A,7195.142277,7528,7258,36893,-1663,2213,-15526,3722,38743,35230,39106,21367,40615
9015,CT,8400,#N/A,6434,6855,5049,3644,5019,#N/A,6434.117613,7528,7294,33301,-4083,1593,-16542,3102,35401,29218,34894,16759,36403
10001,DE,9216,#N/A,5540,8554,4886,3916,4952,#N/A,5540.101271,8324,8694,35690,3319,1976,-15895,3485,37064,39009,37666,19795,39175
10003,DE,11304,#N/A,5540,8554,4886,3916,5274,#N/A,6056.38311,8324,9041,38641,4016,2672,-14803,4181,39474,42657,41313,23838,42822
10005,DE,7392,#N/A,5540,8554,4886,3916,4670,#N/A,6036.526116,8324,8418,34087,2858,1514,-16621,3023,34958,36945,35601,17466,37110
12001,FL,8208,#N/A,5540,8554,5526,3916,3657,#N/A,6314.524029,6308,8062,32809,3480,2080,-16187,3589,35401,36289,34889,16622,36398
12003,FL,7404,#N/A,5540,8554,5526,3916,3564,#N/A,5500.387283,6308,8535,31664,-29,-1429,-19828,80,34504,31635,30235,11836,31744
12005,FL,8724,#N/A,5540,8554,5526,3916,3716,#N/A,6036.526116,6308,8279,33263,3480,2080,-16187,3589,35976,36743,35343,17076,36852
12007,FL,6444,#N/A,5540,8554,5526,3916,3454,#N/A,5202.532376,6308,8554,30425,-205,-1605,-20136,-96,33434,30220,28820,10289,30329
12009,FL,8352,#N/A,5540,8554,5526,3916,3674,#N/A,5738.671209,6308,8106,32421,3480,2080,-16187,3589,35562,35901,34501,16234,36010
12011,FL,11904,#N/A,5540,8554,5526,3916,4083,#N/A,6195.382066,6308,8601,36924,4186,2786,-14953,4295,39523,41110,39710,21971,41219
12013,FL,6336,#N/A,5540,8554,5526,3916,3441,#N/A,5917.384153,6308,8554,31031,-205,-1605,-20136,-96,33313,30826,29426,10895,30935
12015,FL,8076,#N/A,5540,8554,5526,3916,3642,#N/A,5957.098141,6308,7527,31784,-29,-1429,-19828,80,35254,31755,30355,11956,31864
12017,FL,7032,#N/A,5540,8554,5526,3916,3521,#N/A,6036.526116,6308,7144,30437,-382,-1782,-20445,-273,34089,30055,28655,9992,30164
12019,FL,9336,#N/A,5540,8554,5526,3916,3787,#N/A,5976.955134,6308,8535,34072,3656,2256,-15879,3765,36659,37728,36328,18193,37837
12021,FL,9696,#N/A,5540,8554,5526,3916,3828,#N/A,6155.668079,6308,8377,34453,3656,2256,-15879,3765,37060,38109,36709,18574,38218
12023,FL,7776,#N/A,5540,8554,5526,3916,3607,#N/A,5599.672252,6308,7676,31275,-29,-1429,-19828,80,34919,31246,29846,11447,31355
12027,FL,6624,#N/A,5540,8554,5526,3916,3474,#N/A,5480.530289,6308,7744,30073,-205,-1605,-20136,-96,33634,29868,28468,9937,29977
12029,FL,6444,#N/A,5540,8554,5526,3916,3454,#N/A,5540.101271,6308,8554,30762,-205,-1605,-20136,-96,33434,30557,29157,10626,30666
12031,FL,9336,#N/A,5540,8554,5526,3916,3787,#N/A,5877.670165,6308,8534,33972,3656,2256,-15879,3765,36659,37628,36228,18093,37737
12033,FL,8400,#N/A,5540,8554,5526,3916,3679,#N/A,5718.814215,6308,8282,32625,3480,2080,-16187,3589,35615,36105,34705,16438,36214
12035,FL,9192,#N/A,5540,8554,5526,3916,3770,#N/A,6215.23906,6308,7979,33611,3480,2080,-16187,3589,36498,37091,35691,17424,37200
12037,FL,7116,#N/A,5540,8554,5526,3916,3531,#N/A,5480.530289,6308,8554,31375,-29,-1429,-19828,80,34183,31346,29946,11547,31455
12039,FL,9048,#N/A,5540,8554,5526,3916,3754,#N/A,5440.816302,6308,8245,32957,3656,2256,-15879,3765,36338,36613,35213,17078,36722
12041,FL,8208,#N/A,5540,8554,5526,3916,3657,#N/A,6056.38311,6308,8097,32586,3480,2080,-16187,3589,35401,36066,34666,16399,36175
12043,FL,6912,#N/A,5540,8554,5526,3916,3508,#N/A,6135.811085,6308,8554,31826,-29,-1429,-19828,80,33956,31797,30397,11998,31906
12045,FL,7152,#N/A,5540,8554,5526,3916,3535,#N/A,5996.812128,6308,8288,31661,-29,-1429,-19828,80,34223,31632,30232,11833,31741
12047,FL,6336,#N/A,5540,8554,5526,3916,3441,#N/A,5460.673295,6308,8554,30575,-205,-1605,-20136,-96,33313,30370,28970,10439,30479
12049,FL,6696,#N/A,5540,8554,5526,3916,3483,#N/A,5242.246364,6308,8257,30419,-205,-1605,-20136,-96,33715,30214,28814,10283,30323
12051,FL,6900,#N/A,5540,8554,5526,3916,3506,#N/A,5460.673295,6308,8066,30651,-205,-1605,-20136,-96,33942,30446,29046,10515,30555
12053,FL,9096,#N/A,5540,8554,5526,3916,3759,#N/A,5738.671209,6308,8188,33246,3656,2256,-15879,3765,36391,36902,35502,17367,37011
12055,FL,6624,#N/A,5540,8554,5526,3916,3474,#N/A,5738.671209,6308,7172,29758,-382,-1782,-20445,-273,33634,29376,27976,9313,29485
12057,FL,9096,#N/A,5540,8554,5526,3916,3759,#N/A,5897.527159,6308,8137,33355,3480,2080,-16187,3589,36391,36835,35435,17168,36944
12059,FL,6444,#N/A,5540,8554,5526,3916,3454,#N/A,6235.096054,6308,8554,31457,-205,-1605,-20136,-96,33434,31252,29852,11321,31361
12061,FL,8316,#N/A,5540,8554,5526,3916,3669,#N/A,6294.667035,6308,7781,32616,-29,-1429,-19828,80,35521,32587,31187,12788,32696
12063,FL,6408,#N/A,5540,8554,5526,3916,3450,#N/A,5818.099184,6308,8554,31004,-205,-1605,-20136,-96,33394,30799,29399,10868,30908
12065,FL,9048,#N/A,5540,8554,5526,3916,3754,#N/A,5738.671209,6308,8250,33261,3656,2256,-15879,3765,36338,36917,35517,17382,37026
12067,FL,6336,#N/A,5540,8554,5526,3916,3441,#N/A,5520.244277,6308,8554,30634,-205,-1605,-20136,-96,33313,30429,29029,10498,30538
12069,FL,9900,#N/A,5540,8554,5526,3916,3852,#N/A,5758.528202,6308,8645,34528,3833,2433,-15570,3942,37288,38361,36961,18958,38470
12071,FL,8460,#N/A,5540,8554,5526,3916,3686,#N/A,5937.241147,6308,8122,32743,3480,2080,-16187,3589,35682,36223,34823,16556,36332
12073,FL,9048,#N/A,5540,8554,5526,3916,3754,#N/A,5957.098141,6308,8220,33449,3656,2256,-15879,3765,36338,37105,35705,17570,37214
12075,FL,6312,#N/A,5540,8554,5526,3916,3439,#N/A,5540.101271,6308,8554,30630,-205,-1605,-20136,-96,33287,30425,29025,10494,30534
12077,FL,6336,#N/A,5540,8554,5526,3916,3441,#N/A,5877.670165,6308,8554,30992,-205,-1605,-20136,-96,33313,30787,29387,10856,30896
12079,FL,6540,#N/A,5540,8554,5526,3916,3465,#N/A,5718.814215,6308,8554,31037,-205,-1605,-20136,-96,33541,30832,29432,10901,30941
12081,FL,9480,#N/A,5540,8554,5526,3916,3804,#N/A,6215.23906,6308,7878,33797,3656,2256,-15879,3765,36820,37453,36053,17918,37562
12083,FL,7536,#N/A,5540,8554,5526,3916,3580,#N/A,5559.958264,6308,7439,30759,-205,-1605,-20136,-96,34652,30554,29154,10623,30663
12085,FL,8976,#N/A,5540,8554,5526,3916,3745,#N/A,6830.805868,6308,8017,34048,3480,2080,-16187,3589,36257,37528,36128,17861,37637
12086,FL,10920,#N/A,5540,8554,5526,3916,3969,#N/A,6294.667035,6308,8603,36042,4009,2609,-15262,4118,38425,40051,38651,20780,40160
12087,FL,12120,#N/A,5540,8554,5526,3916,4108,#N/A,7208.08875,6308,8620,38172,4186,2786,-14953,4295,39764,42358,40958,23219,42467
12089,FL,9336,#N/A,5540,8554,5526,3916,3787,#N/A,6374.09501,6308,8535,34470,3656,2256,-15879,3765,36659,38126,36726,18591,38235
12091,FL,8532,#N/A,5540,8554,5526,3916,3694,#N/A,6076.240103,6308,8417,33250,3480,2080,-16187,3589,35762,36730,35330,17063,36839
12093,FL,6732,#N/A,5540,8554,5526,3916,3487,#N/A,5520.244277,6308,7674,30151,-205,-1605,-20136,-96,33755,29946,28546,10015,30055
12095,FL,9900,#N/A,5540,8554,5526,3916,3852,#N/A,5778.385196,6308,8658,34561,3833,2433,-15570,3942,37288,38394,36994,18991,38503
12097,FL,9900,#N/A,5540,8554,5526,3916,3852,#N/A,5480.530289,6308,8651,34256,3833,2433,-15570,3942,37288,38089,36689,18686,38198
12099,FL,11544,#N/A,5540,8554,5526,3916,4041,#N/A,6334.381023,6308,8597,36699,4009,2609,-15262,4118,39121,40708,39308,21437,40817
12101,FL,9096,#N/A,5540,8554,5526,3916,3759,#N/A,5917.384153,6308,8166,33404,3656,2256,-15879,3765,36391,37060,35660,17525,37169
12103,FL,9096,#N/A,5540,8554,5526,3916,3759,#N/A,5996.812128,6308,8113,33430,3480,2080,-16187,3589,36391,36910,35510,17243,37019
12105,FL,7476,#N/A,5540,8554,5526,3916,3573,#N/A,5559.958264,6308,8205,31465,-29,-1429,-19828,80,34585,31436,30036,11637,31545
12107,FL,6336,#N/A,5540,8554,5526,3916,3441,#N/A,5559.958264,6308,7323,29443,-382,-1782,-20445,-273,33313,29061,27661,8998,29170
12109,FL,9336,#N/A,5540,8554,5526,3916,3787,#N/A,6751.377893,6308,8535,34846,3656,2256,-15879,3765,36659,38502,37102,18967,38611
12111,FL,8976,#N/A,5540,8554,5526,3916,3745,#N/A,5897.527159,6308,8040,33137,3480,2080,-16187,3589,36257,36617,35217,16950,36726
12113,FL,8400,#N/A,5540,8554,5526,3916,3679,#N/A,6314.524029,6308,8291,33229,3480,2080,-16187,3589,35615,36709,35309,17042,36818
12115,FL,9480,#N/A,5540,8554,5526,3916,3804,#N/A,6354.238017,6308,7886,33944,3656,2256,-15879,3765,36820,37600,36200,18065,37709
12117,FL,9900,#N/A,5540,8554,5526,3916,3852,#N/A,5798.24219,6308,8654,34576,3833,2433,-15570,3942,37288,38409,37009,19006,38518
12119,FL,7212,#N/A,5540,8554,5526,3916,3542,#N/A,5996.812128,6308,6936,30369,-382,-1782,-20445,-273,34290,29987,28587,9924,30096
12121,FL,5712,#N/A,5540,8554,5526,3916,3369,#N/A,5480.530289,6308,8554,29971,-205,-1605,-20136,-96,32617,29766,28366,9835,29875
12123,FL,6444,#N/A,5540,8554,5526,3916,3454,#N/A,5599.672252,6308,8554,30822,-205,-1605,-20136,-96,33434,30617,29217,10686,30726
12125,FL,5652,#N/A,5540,8554,5526,3916,3363,#N/A,6056.38311,6308,8554,30486,-382,-1782,-20445,-273,32551,30104,28704,10041,30213
12127,FL,8556,#N/A,5540,8554,5526,3916,3697,#N/A,6036.526116,6308,7972,32789,3480,2080,-16187,3589,35789,36269,34869,16602,36378
12129,FL,6732,#N/A,5540,8554,5526,3916,3487,#N/A,5659.243233,6308,8244,30859,-205,-1605,-20136,-96,33755,30654,29254,10723,30763
12131,FL,7848,#N/A,5540,8554,5526,3916,3616,#N/A,6691.806911,6308,8427,33190,3480,2080,-16187,3589,35000,36670,35270,17003,36779
12133,FL,5652,#N/A,5540,8554,5526,3916,3363,#N/A,5460.673295,6308,8554,29891,-382,-1782,-20445,-273,32551,29509,28109,9446,29618
13001,GA,6432,#N/A,5540,8554,4853,3916,3961,#N/A,5242.246364,6140,8554,30284,474,-821,-19352,688,33256,30758,29463,10932,30972
13003,GA,5640,#N/A,5540,8554,4853,3916,3854,#N/A,5123.104401,6140,8554,29373,237,-1058,-19721,451,32357,29610,28315,9652,29824
13005,GA,5940,#N/A,5540,8554,4853,3916,3894,#N/A,5162.818388,6140,8554,29713,474,-821,-19352,688,32697,30187,28892,10361,30401
13007,GA,6972,#N/A,5540,8554,4853,3916,4034,#N/A,5559.958264,6140,7711,30299,474,-821,-19352,688,33869,30773,29478,10947,30987
13009,GA,6708,#N/A,5540,8554,4853,3916,3998,#N/A,5659.243233,6140,7328,29751,237,-1058,-19721,451,33569,29988,28693,10030,30202
13011,GA,7104,#N/A,5540,8554,4853,3916,4052,#N/A,5619.529246,6140,8554,31334,710,-585,-18984,924,34019,32044,30749,12350,32258
13013,GA,9072,#N/A,5540,8554,4853,3916,4318,#N/A,5281.960351,6140,8746,33156,4347,3053,-15082,4562,36253,37503,36209,18074,37718
13015,GA,9072,#N/A,5540,8554,4853,3916,4318,#N/A,5540.101271,6140,8753,33421,4347,3053,-15082,4562,36253,37768,36474,18339,37983
13017,GA,5988,#N/A,5540,8554,4853,3916,3901,#N/A,5361.388326,6140,7333,28738,1,-1294,-20089,215,32752,28739,27444,8649,28953
13019,GA,5640,#N/A,5540,8554,4853,3916,3854,#N/A,5440.816302,6140,8554,29691,237,-1058,-19721,451,32357,29928,28633,9970,30142
13021,GA,7392,#N/A,5540,8554,4853,3916,4091,#N/A,5321.674339,6140,8126,30896,710,-585,-18984,924,34346,31606,30311,11912,31820
13023,GA,5640,#N/A,5540,8554,4853,3916,3854,#N/A,5480.530289,6140,8554,29731,237,-1058,-19721,451,32357,29968,28673,10010,30182
13025,GA,5940,#N/A,5540,8554,4853,3916,3894,#N/A,5698.957221,6140,8190,29885,237,-1058,-19721,451,32697,30122,28827,10164,30336
13027,GA,6948,#N/A,5540,8554,4853,3916,4031,#N/A,5520.244277,6140,7863,30387,474,-821,-19352,688,33842,30861,29566,11035,31075
13029,GA,8700,#N/A,5540,8554,4853,3916,4267,#N/A,6235.096054,6140,8480,33471,4111,2817,-15450,4326,35830,37582,36288,18021,37797
13031,GA,6828,#N/A,5540,8554,4853,3916,4014,#N/A,5738.671209,6140,7721,30344,474,-821,-19352,688,33705,30818,29523,10992,31032
13033,GA,7344,#N/A,5540,8554,4853,3916,4084,#N/A,5202.532376,6140,8339,30942,710,-585,-18984,924,34291,31652,30357,11958,31866
13035,GA,6816,#N/A,5540,8554,4853,3916,4013,#N/A,6930.090837,6140,8744,32546,710,-585,-18984,924,33692,33256,31961,13562,33470
13037,GA,5640,#N/A,5540,8554,4853,3916,3854,#N/A,5559.958264,6140,8554,29810,237,-1058,-19721,451,32357,30047,28752,10089,30261
13039,GA,7212,#N/A,5540,8554,4853,3916,4066,#N/A,5758.528202,6140,8636,31663,710,-585,-18984,924,34141,32373,31078,12679,32587
13043,GA,5640,#N/A,5540,8554,4853,3916,3854,#N/A,5480.530289,6140,8554,29731,237,-1058,-19721,451,32357,29968,28673,10010,30182
13045,GA,9072,#N/A,5540,8554,4853,3916,4318,#N/A,5718.814215,6140,8753,33599,4347,3053,-15082,4562,36253,37946,36652,18517,38161
13047,GA,6552,#N/A,5540,8554,4853,3916,3977,#N/A,5262.103357,6140,8249,30119,474,-821,-19352,688,33392,30593,29298,10767,30807
13049,GA,5700,#N/A,5540,8554,4853,3916,3862,#N/A,6016.669122,6140,8554,30327,237,-1058,-19721,451,32425,30564,29269,10606,30778
13051,GA,8700,#N/A,5540,8554,4853,3916,4267,#N/A,5857.813171,6140,8474,33088,4111,2817,-15450,4326,35830,37199,35905,17638,37414
13053,GA,7140,#N/A,5540,8554,4853,3916,4056,#N/A,5937.241147,6140,8167,31300,474,-821,-19352,688,34059,31774,30479,11948,31988
13055,GA,5640,#N/A,5540,8554,4853,3916,3854,#N/A,5321.674339,6140,7414,28432,1,-1294,-20089,215,32357,28433,27138,8343,28647
13057,GA,9072,#N/A,5540,8554,4853,3916,4318,#N/A,5818.099184,6140,8743,33690,4347,3053,-15082,4562,36253,38037,36743,18608,38252
13059,GA,7080,#N/A,5540,8554,4853,3916,4048,#N/A,5599.672252,6140,8300,31035,474,-821,-19352,688,33991,31509,30214,11683,31723
13061,GA,6276,#N/A,5540,8554,4853,3916,3940,#N/A,5758.528202,6140,8554,30645,474,-821,-19352,688,33079,31119,29824,11293,31333
13063,GA,9072,#N/A,5540,8554,4853,3916,4318,#N/A,4745.821519,6140,8762,32636,4347,3053,-15082,4562,36253,36983,35689,17554,37198
13065,GA,5640,#N/A,5540,8554,4853,3916,3854,#N/A,5440.816302,6140,8554,29691,237,-1058,-19721,451,32357,29928,28633,9970,30142
13067,GA,9072,#N/A,5540,8554,4853,3916,4318,#N/A,5818.099184,6140,8762,33709,4347,3053,-15082,4562,36253,38056,36762,18627,38271
13069,GA,5724,#N/A,5540,8554,4853,3916,3865,#N/A,5222.38937,6140,7690,28692,237,-1058,-19721,451,32452,28929,27634,8971,29143
13071,GA,5688,#N/A,5540,8554,4853,3916,3860,#N/A,5262.103357,6140,7796,28802,237,-1058,-19721,451,32411,29039,27744,9081,29253
13073,GA,7344,#N/A,5540,8554,4853,3916,4084,#N/A,5778.385196,6140,8347,31525,710,-585,-18984,924,34291,32235,30940,12541,32449
13075,GA,6624,#N/A,5540,8554,4853,3916,3987,#N/A,5480.530289,6140,8554,30715,474,-821,-19352,688,33474,31189,29894,11363,31403
13077,GA,9072,#N/A,5540,8554,4853,3916,4318,#N/A,5877.670165,6140,8741,33746,4347,3053,-15082,4562,36253,38093,36799,18664,38308
13079,GA,7392,#N/A,5540,8554,4853,3916,4091,#N/A,5381.24532,6140,8149,30978,710,-585,-18984,924,34346,31688,30393,11994,31902
13081,GA,5856,#N/A,5540,8554,4853,3916,3883,#N/A,5460.673295,6140,7588,28960,237,-1058,-19721,451,32602,29197,27902,9239,29411
13083,GA,6552,#N/A,5540,8554,4853,3916,3977,#N/A,5500.387283,6140,8251,30359,474,-821,-19352,688,33392,30833,29538,11007,31047
13085,GA,9072,#N/A,5540,8554,4853,3916,4318,#N/A,5639.38624,6140,8744,33511,4347,3053,-15082,4562,36253,37858,36564,18429,38073
13087,GA,6624,#N/A,5540,8554,4853,3916,3987,#N/A,5758.528202,6140,7411,29849,237,-1058,-19721,451,33474,30086,28791,10128,30300
13089,GA,9072,#N/A,5540,8554,4853,3916,4318,#N/A,5738.671209,6140,8785,33651,4347,3053,-15082,4562,36253,37998,36704,18569,38213
13091,GA,6432,#N/A,5540,8554,4853,3916,3961,#N/A,5361.388326,6140,8554,30403,474,-821,-19352,688,33256,30877,29582,11051,31091
13093,GA,6432,#N/A,5540,8554,4853,3916,3961,#N/A,5500.387283,6140,8554,30542,474,-821,-19352,688,33256,31016,29721,11190,31230
13095,GA,6972,#N/A,5540,8554,4853,3916,4034,#N/A,5460.673295,6140,7594,30082,474,-821,-19352,688,33869,30556,29261,10730,30770
13097,GA,9072,#N/A,5540,8554,4853,3916,4318,#N/A,5341.531333,6140,8746,33216,4347,3053,-15082,4562,36253,37563,36269,18134,37778
13099,GA,5784,#N/A,5540,8554,4853,3916,3873,#N/A,5738.671209,6140,8554,30133,237,-1058,-19721,451,32520,30370,29075,10412,30584
13101,GA,6948,#N/A,5540,8554,4853,3916,4031,#N/A,5559.958264,6140,7868,30432,474,-821,-19352,688,33842,30906,29611,11080,31120
13103,GA,8700,#N/A,5540,8554,4853,3916,4267,#N/A,5540.101271,6140,8478,32774,4111,2817,-15450,4326,35830,36885,35591,17324,37100
13105,GA,6228,#N/A,5540,8554,4853,3916,3933,#N/A,5540.101271,6140,8554,30378,474,-821,-19352,688,33024,30852,29557,11026,31066
13107,GA,5640,#N/A,5540,8554,4853,3916,3854,#N/A,5083.390413,6140,8554,29333,237,-1058,-19721,451,32357,29570,28275,9612,29784
13109,GA,6192,#N/A,5540,8554,4853,3916,3928,#N/A,5639.38624,6140,8554,30441,474,-821,-19352,688,32983,30915,29620,11089,31129
13111,GA,5640,#N/A,5540,8554,4853,3916,3854,#N/A,5937.241147,6140,8554,30187,237,-1058,-19721,451,32357,30424,29129,10466,30638
13113,GA,9072,#N/A,5540,8554,4853,3916,4318,#N/A,6036.526116,6140,8751,33916,4347,3053,-15082,4562,36253,38263,36969,18834,38478
13115,GA,5976,#N/A,5540,8554,4853,3916,3899,#N/A,5381.24532,6140,8143,29556,237,-1058,-19721,451,32738,29793,28498,9835,30007
13117,GA,9072,#N/A,5540,8554,4853,3916,4318,#N/A,6691.806911,6140,8745,34565,4347,3053,-15082,4562,36253,38912,37618,19483,39127
13119,GA,5640,#N/A,5540,8554,4853,3916,3854,#N/A,5778.385196,6140,8554,30028,237,-1058,-19721,451,32357,30265,28970,10307,30479
13121,GA,9072,#N/A,5540,8554,4853,3916,4318,#N/A,6135.811085,6140,8789,34052,4347,3053,-15082,4562,36253,38399,37105,18970,38614
13123,GA,6372,#N/A,5540,8554,4853,3916,3953,#N/A,5540.101271,6140,8554,30522,474,-821,-19352,688,33188,30996,29701,11170,31210
13125,GA,5640,#N/A,5540,8554,4853,3916,3854,#N/A,5361.388326,6140,8554,29611,237,-1058,-19721,451,32357,29848,28553,9890,30062
13127,GA,5940,#N/A,5540,8554,4853,3916,3894,#N/A,6175.525072,6140,8156,30327,237,-1058,-19721,451,32697,30564,29269,10606,30778
13129,GA,6516,#N/A,5540,8554,4853,3916,3972,#N/A,5460.673295,6140,8408,30440,474,-821,-19352,688,33351,30914,29619,11088,31128
13131,GA,5640,#N/A,5540,8554,4853,3916,3854,#N/A,5321.674339,6140,8554,29572,237,-1058,-19721,451,32357,29809,28514,9851,30023
13133,GA,5796,#N/A,5540,8554,4853,3916,3875,#N/A,5698.957221,6140,8554,30105,237,-1058,-19721,451,32534,30342,29047,10384,30556
13135,GA,9072,#N/A,5540,8554,4853,3916,4318,#N/A,5480.530289,6140,8756,33365,4347,3053,-15082,4562,36253,37712,36418,18283,37927
13137,GA,6432,#N/A,5540,8554,4853,3916,3961,#N/A,5639.38624,6140,7865,29992,237,-1058,-19721,451,33256,30229,28934,10271,30443
13139,GA,7728,#N/A,5540,8554,4853,3916,4136,#N/A,5559.958264,6140,8760,32104,4111,2817,-15450,4326,34727,36215,34921,16654,36430
13141,GA,5640,#N/A,5540,8554,4853,3916,3854,#N/A,5718.814215,6140,7417,28832,1,-1294,-20089,215,32357,28833,27538,8743,29047
13143,GA,5640,#N/A,5540,8554,4853,3916,3854,#N/A,5480.530289,6140,8746,29923,237,-1058,-19721,451,32357,30160,28865,10202,30374
13145,GA,7140,#N/A,5540,8554,4853,3916,4056,#N/A,6096.097097,6140,8202,31495,474,-821,-19352,688,34059,31969,30674,12143,32183
13147,GA,5640,#N/A,5540,8554,4853,3916,3854,#N/A,5480.530289,6140,8554,29731,237,-1058,-19721,451,32357,29968,28673,10010,30182
13149,GA,9072,#N/A,5540,8554,4853,3916,4318,#N/A,5718.814215,6140,8742,33589,4347,3053,-15082,4562,36253,37936,36642,18507,38151
13151,GA,9072,#N/A,5540,8554,4853,3916,4318,#N/A,5361.388326,6140,8748,33238,4347,3053,-15082,4562,36253,37585,36291,18156,37800
13153,GA,7392,#N/A,5540,8554,4853,3916,4091,#N/A,5480.530289,6140,8569,31497,710,-585,-18984,924,34346,32207,30912,12513,32421
13155,GA,5640,#N/A,5540,8554,4853,3916,3854,#N/A,5341.531333,6140,8554,29592,237,-1058,-19721,451,32357,29829,28534,9871,30043
13157,GA,6888,#N/A,5540,8554,4853,3916,4022,#N/A,6195.382066,6140,8625,31764,710,-585,-18984,924,33773,32474,31179,12780,32688
13159,GA,9072,#N/A,5540,8554,4853,3916,4318,#N/A,5361.388326,6140,8737,33226,4347,3053,-15082,4562,36253,37573,36279,18144,37788
13161,GA,6432,#N/A,5540,8554,4853,3916,3961,#N/A,5262.103357,6140,8554,30304,474,-821,-19352,688,33256,30778,29483,10952,30992
13163,GA,6252,#N/A,5540,8554,4853,3916,3936,#N/A,5460.673295,6140,8554,30323,474,-821,-19352,688,33051,30797,29502,10971,31011
13165,GA,5940,#N/A,5540,8554,4853,3916,3894,#N/A,5500.387283,6140,8554,30050,474,-821,-19352,688,32697,30524,29229,10698,30738
13167,GA,5640,#N/A,5540,8554,4853,3916,3854,#N/A,5301.817345,6140,7653,28651,1,-1294,-20089,215,32357,28652,27357,8562,28866
13169,GA,7392,#N/A,5540,8554,4853,3916,4091,#N/A,4706.107531,6140,8166,30320,710,-585,-18984,924,34346,31030,29735,11336,31244
13171,GA,6432,#N/A,5540,8554,4853,3916,3961,#N/A,5480.530289,6140,8747,30715,474,-821,-19352,688,33256,31189,29894,11363,31403
13173,GA,6948,#N/A,5540,8554,4853,3916,4031,#N/A,5480.530289,6140,7850,30335,474,-821,-19352,688,33842,30809,29514,10983,31023
13175,GA,6432,#N/A,5540,8554,4853,3916,3961,#N/A,5480.530289,6140,7609,29577,237,-1058,-19721,451,33256,29814,28519,9856,30028
13177,GA,6972,#N/A,5540,8554,4853,3916,4034,#N/A,5937.241147,6140,7674,30639,474,-821,-19352,688,33869,31113,29818,11287,31327
13179,GA,7176,#N/A,5540,8554,4853,3916,4061,#N/A,5440.816302,6140,8451,31124,710,-585,-18984,924,34100,31834,30539,12140,32048
13181,GA,5640,#N/A,5540,8554,4853,3916,3854,#N/A,5718.814215,6140,8341,29755,237,-1058,-19721,451,32357,29992,28697,10034,30206
13183,GA,6108,#N/A,5540,8554,4853,3916,3917,#N/A,5341.531333,6140,8459,29965,474,-821,-19352,688,32888,30439,29144,10613,30653
13185,GA,6948,#N/A,5540,8554,4853,3916,4031,#N/A,5599.672252,6140,7812,30416,474,-821,-19352,688,33842,30890,29595,11064,31104
13187,GA,6612,#N/A,5540,8554,4853,3916,3985,#N/A,5957.098141,6140,8554,31179,474,-821,-19352,688,33460,31653,30358,11827,31867
13189,GA,7344,#N/A,5540,8554,4853,3916,4084,#N/A,5401.102314,6140,8334,31135,710,-585,-18984,924,34291,31845,30550,12151,32059
13191,GA,5940,#N/A,5540,8554,4853,3916,3894,#N/A,5758.528202,6140,8186,29941,237,-1058,-19721,451,32697,30178,28883,10220,30392
13193,GA,6432,#N/A,5540,8554,4853,3916,3961,#N/A,5500.387283,6140,8554,30542,474,-821,-19352,688,33256,31016,29721,11190,31230
13195,GA,7080,#N/A,5540,8554,4853,3916,4048,#N/A,5818.099184,6140,8317,31271,474,-821,-19352,688,33991,31745,30450,11919,31959
13197,GA,7140,#N/A,5540,8554,4853,3916,4056,#N/A,5321.674339,6140,8177,30695,474,-821,-19352,688,34059,31169,29874,11343,31383
13199,GA,6432,#N/A,5540,8554,4853,3916,3961,#N/A,6056.38311,6140,8741,31286,474,-821,-19352,688,33256,31760,30465,11934,31974
13201,GA,5640,#N/A,5540,8554,4853,3916,3854,#N/A,5639.38624,6140,8554,29889,237,-1058,-19721,451,32357,30126,28831,10168,30340
13205,GA,6108,#N/A,5540,8554,4853,3916,3917,#N/A,5480.530289,6140,8554,30199,474,-821,-19352,688,32888,30673,29378,10847,30887
13207,GA,6588,#N/A,5540,8554,4853,3916,3982,#N/A,5540.101271,6140,8142,30326,474,-821,-19352,688,33433,30800,29505,10974,31014
13209,GA,6432,#N/A,5540,8554,4853,3916,3961,#N/A,5222.38937,6140,7547,29257,237,-1058,-19721,451,33256,29494,28199,9536,29708
13211,GA,7080,#N/A,5540,8554,4853,3916,4048,#N/A,5559.958264,6140,8739,31434,710,-585,-18984,924,33991,32144,30849,12450,32358
13213,GA,5940,#N/A,5540,8554,4853,3916,3894,#N/A,5718.814215,6140,8127,29842,237,-1058,-19721,451,32697,30079,28784,10121,30293
13215,GA,7140,#N/A,5540,8554,4853,3916,4056,#N/A,6135.811085,6140,8150,31481,474,-821,-19352,688,34059,31955,30660,12129,32169
13217,GA,9072,#N/A,5540,8554,4853,3916,4318,#N/A,5281.960351,6140,8746,33156,4347,3053,-15082,4562,36253,37503,36209,18074,37718
13219,GA,7080,#N/A,5540,8554,4853,3916,4048,#N/A,6076.240103,6140,8338,31550,710,-585,-18984,924,33991,32260,30965,12566,32474
13221,GA,7080,#N/A,5540,8554,4853,3916,4048,#N/A,5818.099184,6140,8329,31283,710,-585,-18984,924,33991,31993,30698,12299,32207
13223,GA,9072,#N/A,5540,8554,4853,3916,4318,#N/A,5381.24532,6140,8742,33251,4347,3053,-15082,4562,36253,37598,36304,18169,37813
13225,GA,5688,#N/A,5540,8554,4853,3916,3860,#N/A,5182.675382,6140,8568,29494,237,-1058,-19721,451,32411,29731,28436,9773,29945
13227,GA,9072,#N/A,5540,8554,4853,3916,4318,#N/A,5818.099184,6140,8745,33692,4347,3053,-15082,4562,36253,38039,36745,18610,38254
13229,GA,5736,#N/A,5540,8554,4853,3916,3867,#N/A,5162.818388,6140,7558,28513,1,-1294,-20089,215,32466,28514,27219,8424,28728
13231,GA,9072,#N/A,5540,8554,4853,3916,4318,#N/A,5480.530289,6140,8739,33348,4347,3053,-15082,4562,36253,37695,36401,18266,37910
13233,GA,5952,#N/A,5540,8554,4853,3916,3896,#N/A,5420.959308,6140,7901,29330,237,-1058,-19721,451,32711,29567,28272,9609,29781
13235,GA,5640,#N/A,5540,8554,4853,3916,3854,#N/A,5440.816302,6140,8568,29705,237,-1058,-19721,451,32357,29942,28647,9984,30156
13237,GA,8052,#N/A,5540,8554,4853,3916,4180,#N/A,5500.387283,6140,8554,32162,4111,2817,-15450,4326,35095,36273,34979,16712,36488
13239,GA,6432,#N/A,5540,8554,4853,3916,3961,#N/A,5877.670165,6140,8554,30920,474,-821,-19352,688,33256,31394,30099,11568,31608
13241,GA,7608,#N/A,5540,8554,4853,3916,4120,#N/A,5559.958264,6140,8554,31778,710,-585,-18984,924,34591,32488,31193,12794,32702
13243,GA,5640,#N/A,5540,8554,4853,3916,3854,#N/A,5857.813171,6140,8554,30108,237,-1058,-19721,451,32357,30345,29050,10387,30559
13245,GA,7344,#N/A,5540,8554,4853,3916,4084,#N/A,5381.24532,6140,8337,31118,710,-585,-18984,924,34291,31828,30533,12134,32042
13247,GA,9072,#N/A,5540,8554,4853,3916,4318,#N/A,5262.103357,6140,8747,33137,4347,3053,-15082,4562,36253,37484,36190,18055,37699
13249,GA,5640,#N/A,5540,8554,4853,3916,3854,#N/A,5520.244277,6140,7696,28913,1,-1294,-20089,215,32357,28914,27619,8824,29128
13251,GA,5640,#N/A,5540,8554,4853,3916,3854,#N/A,5500.387283,6140,8554,29750,237,-1058,-19721,451,32357,29987,28692,10029,30201
13253,GA,6432,#N/A,5540,8554,4853,3916,3961,#N/A,5758.528202,6140,8554,30801,474,-821,-19352,688,33256,31275,29980,11449,31489
13255,GA,9072,#N/A,5540,8554,4853,3916,4318,#N/A,5520.244277,6140,8754,33402,4347,3053,-15082,4562,36253,37749,36455,18320,37964
13257,GA,6084,#N/A,5540,8554,4853,3916,3914,#N/A,5579.815258,6140,7805,29525,237,-1058,-19721,451,32861,29762,28467,9804,29976
13259,GA,6432,#N/A,5540,8554,4853,3916,3961,#N/A,5877.670165,6140,8554,30920,474,-821,-19352,688,33256,31394,30099,11568,31608
13261,GA,6312,#N/A,5540,8554,4853,3916,3945,#N/A,5599.672252,6140,7652,29619,237,-1058,-19721,451,33120,29856,28561,9898,30070
13263,GA,6336,#N/A,5540,8554,4853,3916,3948,#N/A,5897.527159,6140,8554,30844,474,-821,-19352,688,33147,31318,30023,11492,31532
13265,GA,7656,#N/A,5540,8554,4853,3916,4126,#N/A,5976.955134,6140,8554,32243,710,-585,-18984,924,34645,32953,31658,13259,33167
13267,GA,6432,#N/A,5540,8554,4853,3916,3961,#N/A,5162.818388,6140,8554,30205,474,-821,-19352,688,33256,30679,29384,10853,30893
13269,GA,5940,#N/A,5540,8554,4853,3916,3894,#N/A,5500.387283,6140,8554,30050,474,-821,-19352,688,32697,30524,29229,10698,30738
13271,GA,5640,#N/A,5540,8554,4853,3916,3854,#N/A,5281.960351,6140,8554,29532,237,-1058,-19721,451,32357,29769,28474,9811,29983
13273,GA,6972,#N/A,5540,8554,4853,3916,4034,#N/A,5559.958264,6140,7682,30270,474,-821,-19352,688,33869,30744,29449,10918,30958
13275,GA,6252,#N/A,5540,8554,4853,3916,3936,#N/A,5798.24219,6140,7441,29547,237,-1058,-19721,451,33051,29784,28489,9826,29998
13277,GA,6108,#N/A,5540,8554,4853,3916,3917,#N/A,5599.672252,6140,7792,29556,237,-1058,-19721,451,32888,29793,28498,9835,30007
13279,GA,5880,#N/A,5540,8554,4853,3916,3886,#N/A,5341.531333,6140,7506,28784,1,-1294,-20089,215,32629,28785,27490,8695,28999
13281,GA,6360,#N/A,5540,8554,4853,3916,3951,#N/A,5798.24219,6140,8554,30768,474,-821,-19352,688,33174,31242,29947,11416,31456
13283,GA,5940,#N/A,5540,8554,4853,3916,3894,#N/A,5321.674339,6140,8554,29872,474,-821,-19352,688,32697,30346,29051,10520,30560
13285,GA,6960,#N/A,5540,8554,4853,3916,4032,#N/A,5857.813171,6140,8210,31084,474,-821,-19352,688,33855,31558,30263,11732,31772
13287,GA,5688,#N/A,5540,8554,4853,3916,3860,#N/A,5420.959308,6140,8554,29719,237,-1058,-19721,451,32411,29956,28661,9998,30170
13289,GA,7392,#N/A,5540,8554,4853,3916,4091,#N/A,5381.24532,6140,8159,30988,710,-585,-18984,924,34346,31698,30403,12004,31912
13291,GA,6408,#N/A,5540,8554,4853,3916,3958,#N/A,5976.955134,6140,8554,30995,474,-821,-19352,688,33229,31469,30174,11643,31683
13293,GA,6432,#N/A,5540,8554,4853,3916,3961,#N/A,5341.531333,6140,7571,29401,237,-1058,-19721,451,33256,29638,28343,9680,29852
13295,GA,6552,#N/A,5540,8554,4853,3916,3977,#N/A,5639.38624,6140,8242,30489,474,-821,-19352,688,33392,30963,29668,11137,31177
13297,GA,9072,#N/A,5540,8554,4853,3916,4318,#N/A,5758.528202,6140,8748,33634,4347,3053,-15082,4562,36253,37981,36687,18552,38196
13299,GA,5676,#N/A,5540,8554,4853,3916,3859,#N/A,5142.961395,6140,7513,28388,1,-1294,-20089,215,32398,28389,27094,8299,28603
13301,GA,6252,#N/A,5540,8554,4853,3916,3936,#N/A,5440.816302,6140,8554,30303,474,-821,-19352,688,33051,30777,29482,10951,30991
13303,GA,6432,#N/A,5540,8554,4853,3916,3961,#N/A,5321.674339,6140,8554,30364,474,-821,-19352,688,33256,30838,29543,11012,31052
13305,GA,5640,#N/A,5540,8554,4853,3916,3854,#N/A,5281.960351,6140,7687,28665,1,-1294,-20089,215,32357,28666,27371,8576,28880
13307,GA,5940,#N/A,5540,8554,4853,3916,3894,#N/A,5540.101271,6140,8554,30090,474,-821,-19352,688,32697,30564,29269,10738,30778
13309,GA,5940,#N/A,5540,8554,4853,3916,3894,#N/A,5341.531333,6140,8554,29892,474,-821,-19352,688,32697,30366,29071,10540,30580
13311,GA,5760,#N/A,5540,8554,4853,3916,3870,#N/A,5639.38624,6140,8554,30009,237,-1058,-19721,451,32493,30246,28951,10288,30460
13313,GA,6864,#N/A,5540,8554,4853,3916,4019,#N/A,5103.247407,6140,8112,30135,474,-821,-19352,688,33746,30609,29314,10783,30823
13315,GA,5640,#N/A,5540,8554,4853,3916,3854,#N/A,5440.816302,6140,8554,29691,237,-1058,-19721,451,32357,29928,28633,9970,30142
13317,GA,5784,#N/A,5540,8554,4853,3916,3873,#N/A,5877.670165,6140,8554,30272,237,-1058,-19721,451,32520,30509,29214,10551,30723
13319,GA,5640,#N/A,5540,8554,4853,3916,3854,#N/A,5401.102314,6140,8554,29651,237,-1058,-19721,451,32357,29888,28593,9930,30102
13321,GA,6972,#N/A,5540,8554,4853,3916,4034,#N/A,5242.246364,6140,7673,29943,474,-821,-19352,688,33869,30417,29122,10591,30631
15001,HI,9360,#N/A,6612,7382,4078,3971,4623,#N/A,7180.905457,6314,7390,34215,300,3796,-14339,5305,36026,34515,38011,19876,39520
15003,HI,16584,#N/A,6612,7382,4078,3971,5686,#N/A,7323.101605,6314,8537,42729,5308,6179,-10825,7631,44313,48037,48908,31904,50360
15005,HI,6108,#N/A,6612,7382,4078,3971,4144,#N/A,7346.800963,6314,8066,31806,-4114,-18,-18417,1491,32295,27692,31788,13389,33297
15007,HI,14160,#N/A,6612,7382,4078,3971,5329,#N/A,6778.016372,6314,8090,39313,4427,5241,-12102,6750,41532,43740,44554,27211,46063
15009,HI,11724,#N/A,6612,7382,4078,3971,4971,#N/A,7797.088764,6314,8152,37958,3704,4518,-13221,6027,38738,41662,42476,24737,43985
16001,ID,6864,#N/A,6612,7382,4314,3971,4406,#N/A,6920.21252,6554,7347,31656,-2428,-1669,-20068,-160,33549,29228,29987,11588,31496
16003,ID,5652,#N/A,6612,7382,4314,3971,4223,#N/A,7631.193258,6554,7382,31190,-2604,-1845,-20376,-336,32154,28586,29345,10814,30854
16005,ID,5724,#N/A,6612,7382,4314,3971,4234,#N/A,6446.225361,6554,7242,29937,-2604,-1845,-20376,-336,32237,27333,28092,9561,29601
16007,ID,5652,#N/A,6612,7382,4314,3971,4223,#N/A,6706.918299,6554,7382,30266,-2604,-1845,-20376,-336,32154,27662,28421,9890,29930
16009,ID,6444,#N/A,6612,7382,4314,3971,4343,#N/A,7015.009952,6554,7382,31366,-2604,-1845,-20376,-336,33066,28762,29521,10990,31030
16011,ID,6384,#N/A,6612,7382,4314,3971,4334,#N/A,6469.924719,6554,7530,30909,-2428,-1669,-20068,-160,32997,28481,29240,10841,30749
16013,ID,8436,#N/A,6612,7382,4314,3971,4644,#N/A,9740.436115,6554,7376,36078,1321,2080,-16187,3589,35359,37399,38158,19891,39667
16015,ID,6864,#N/A,6612,7382,4314,3971,4406,#N/A,6683.218941,6554,7353,31425,-2428,-1669,-20068,-160,33549,28997,29756,11357,31265
16017,ID,6972,#N/A,6612,7382,4314,3971,4423,#N/A,7488.997111,6554,6743,31729,-2604,-1845,-20376,-336,33674,29125,29884,11353,31393
16019,ID,5856,#N/A,6612,7382,4314,3971,4254,#N/A,6280.329855,6554,7589,30250,-2604,-1845,-20376,-336,32389,27646,28405,9874,29914
16021,ID,5652,#N/A,6612,7382,4314,3971,4223,#N/A,7488.997111,6554,7382,31048,-2604,-1845,-20376,-336,32154,28444,29203,10672,30712
16023,ID,5844,#N/A,6612,7382,4314,3971,4252,#N/A,6398.826645,6554,7543,30311,-2604,-1845,-20376,-336,32375,27707,28466,9935,29975
16025,ID,6024,#N/A,6612,7382,4314,3971,4279,#N/A,6469.924719,6554,7377,30396,-2604,-1845,-20376,-336,32582,27792,28551,10020,30060
16027,ID,6864,#N/A,6612,7382,4314,3971,4406,#N/A,6209.231782,6554,7349,30948,-2428,-1669,-20068,-160,33549,28520,29279,10880,30788
16029,ID,6024,#N/A,6612,7382,4314,3971,4279,#N/A,6422.526003,6554,7382,30354,-2604,-1845,-20376,-336,32582,27750,28509,9978,30018
16031,ID,5664,#N/A,6612,7382,4314,3971,4225,#N/A,7015.009952,6554,7317,30521,-2604,-1845,-20376,-336,32168,27917,28676,10145,30185
16033,ID,6024,#N/A,6612,7382,4314,3971,4279,#N/A,6612.120867,6554,7382,30543,-2604,-1845,-20376,-336,32582,27939,28698,10167,30207
16035,ID,6444,#N/A,6612,7382,4314,3971,4343,#N/A,7038.70931,6554,7382,31390,-2604,-1845,-20376,-336,33066,28786,29545,11014,31054
16037,ID,5652,#N/A,6612,7382,4314,3971,4223,#N/A,7512.696469,6554,7382,31072,-2604,-1845,-20376,-336,32154,28468,29227,10696,30736
16039,ID,5652,#N/A,6612,7382,4314,3971,4223,#N/A,6659.519583,6554,7248,30084,-2604,-1845,-20376,-336,32154,27480,28239,9708,29748
16041,ID,5772,#N/A,6612,7382,4314,3971,4241,#N/A,6564.722151,6554,7702,30564,-2604,-1845,-20376,-336,32292,27960,28719,10188,30228
16043,ID,5700,#N/A,6612,7382,4314,3971,4231,#N/A,6849.114446,6554,7171,30245,-2604,-1845,-20376,-336,32210,27641,28400,9869,29909
16045,ID,5664,#N/A,6612,7382,4314,3971,4225,#N/A,6659.519583,6554,7344,30192,-2604,-1845,-20376,-336,32168,27588,28347,9816,29856
16047,ID,5952,#N/A,6612,7382,4314,3971,4269,#N/A,6398.826645,6554,7382,30258,-2604,-1845,-20376,-336,32500,27654,28413,9882,29922
16049,ID,5844,#N/A,6612,7382,4314,3971,4252,#N/A,7228.304173,6554,7382,30979,-2604,-1845,-20376,-336,32375,28375,29134,10603,30643
16051,ID,5856,#N/A,6612,7382,4314,3971,4254,#N/A,7512.696469,6554,7563,31457,-2604,-1845,-20376,-336,32389,28853,29612,11081,31121
16053,ID,5916,#N/A,6612,7382,4314,3971,4263,#N/A,6422.526003,6554,7245,30108,-2604,-1845,-20376,-336,32458,27504,28263,9732,29772
16055,ID,7140,#N/A,6612,7382,4314,3971,4448,#N/A,6920.21252,6554,7128,31713,-2428,-1669,-20068,-160,33867,29285,30044,11645,31553
16057,ID,6132,#N/A,6612,7382,4314,3971,4296,#N/A,6943.911878,6554,6933,30534,-2604,-1845,-20376,-336,32707,27930,28689,10158,30198
16059,ID,6444,#N/A,6612,7382,4314,3971,4343,#N/A,7844.48748,6554,7382,32195,-2604,-1845,-20376,-336,33066,29591,30350,11819,31859
16061,ID,6252,#N/A,6612,7382,4314,3971,4314,#N/A,6943.911878,6554,7382,31103,-2604,-1845,-20376,-336,32845,28499,29258,10727,30767
16063,ID,6444,#N/A,6612,7382,4314,3971,4343,#N/A,6446.225361,6554,7377,30792,-2604,-1845,-20376,-336,33066,28188,28947,10416,30456
16065,ID,6096,#N/A,6612,7382,4314,3971,4290,#N/A,7204.604815,6554,7169,30994,-2604,-1845,-20376,-336,32665,28390,29149,10618,30658
16067,ID,6444,#N/A,6612,7382,4314,3971,4343,#N/A,6327.728571,6554,7317,30614,-2604,-1845,-20376,-336,33066,28010,28769,10238,30278
16069,ID,6120,#N/A,6612,7382,4314,3971,4294,#N/A,8460.670786,6554,6984,32090,-2604,-1845,-20376,-336,32693,29486,30245,11714,31754
16071,ID,6444,#N/A,6612,7382,4314,3971,4343,#N/A,6446.225361,6554,7382,30797,-2604,-1845,-20376,-336,33066,28193,28952,10421,30461
16073,ID,6864,#N/A,6612,7382,4314,3971,4406,#N/A,6730.617656,6554,7349,31469,-2428,-1669,-20068,-160,33549,29041,29800,11401,31309
16075,ID,5796,#N/A,6612,7382,4314,3971,4245,#N/A,7678.591974,6554,6678,30677,-2781,-2022,-20685,-513,32320,27896,28655,9992,30164
16077,ID,5724,#N/A,6612,7382,4314,3971,4234,#N/A,6446.225361,6554,7382,30077,-2604,-1845,-20376,-336,32237,27473,28232,9701,29741
16079,ID,6216,#N/A,6612,7382,4314,3971,4309,#N/A,7015.009952,6554,7382,31138,-2604,-1845,-20376,-336,32804,28534,29293,10762,30802
16081,ID,6984,#N/A,6612,7382,4314,3971,4425,#N/A,6683.218941,6554,8174,32366,1321,2080,-16187,3589,33688,33687,34446,16179,35955
16083,ID,6108,#N/A,6612,7382,4314,3971,4292,#N/A,6351.427929,6554,7238,30222,-2604,-1845,-20376,-336,32679,27618,28377,9846,29886
16085,ID,6960,#N/A,6612,7382,4314,3971,4421,#N/A,6730.617656,6554,7382,31598,-2428,-1669,-20068,-160,33660,29170,29929,11530,31438
16087,ID,5652,#N/A,6612,7382,4314,3971,4223,#N/A,6327.728571,6554,7382,29887,-2604,-1845,-20376,-336,32154,27283,28042,9511,29551
17001,IL,5652,#N/A,5659,8320,4830,3699,4652,#N/A,5010.030649,5148,8009,27518,-4997,301,-18494,1810,32812,22521,27819,9024,29328
17003,IL,6024,#N/A,5659,8320,4830,3699,4713,#N/A,5192.582373,5148,8019,28083,-4997,301,-18494,1810,33245,23086,28384,9589,29893
17005,IL,6096,#N/A,5659,8320,4830,3699,4725,#N/A,5172.298848,5148,8275,28390,-4997,301,-18494,1810,33329,23393,28691,9896,30200
17007,IL,6720,#N/A,5659,8320,4830,3699,4828,#N/A,4746.344826,5148,8189,28502,-4784,514,-18149,2023,34056,23718,29016,10353,30525
17009,IL,6900,#N/A,5659,8320,4830,3699,4858,#N/A,4969.4636,5148,8320,29036,-4784,514,-18149,2023,34266,24252,29550,10887,31059
17011,IL,5988,#N/A,5659,8320,4830,3699,4707,#N/A,5760.52107,5148,8179,28774,-4997,301,-18494,1810,33203,23777,29075,10280,30584
17013,IL,7572,#N/A,5659,8320,4830,3699,4969,#N/A,5456.268197,5148,8278,30154,-4569,729,-17802,2238,35049,25585,30883,12352,32392
17015,IL,5652,#N/A,5659,8320,4830,3699,4652,#N/A,5030.314174,5148,8320,27849,-4997,301,-18494,1810,32812,22852,28150,9355,29659
17017,IL,5772,#N/A,5659,8320,4830,3699,4672,#N/A,5334.567048,5148,8320,28274,-4997,301,-18494,1810,32952,23277,28575,9780,30084
17019,IL,8496,#N/A,5659,8320,4830,3699,5122,#N/A,5577.969346,5148,8005,30926,-4356,942,-17457,2451,36126,26570,31868,13469,33377
17021,IL,5964,#N/A,5659,8320,4830,3699,4703,#N/A,4746.344826,5148,7843,27400,-4997,301,-18494,1810,33175,22403,27701,8906,29210
17023,IL,6180,#N/A,5659,8320,4830,3699,4739,#N/A,5050.597699,5148,8320,28398,-4784,514,-18149,2023,33427,23614,28912,10249,30421
17025,IL,6444,#N/A,5659,8320,4830,3699,4783,#N/A,4949.180075,5148,8320,28560,-4784,514,-18149,2023,33735,23776,29074,10411,30583
17027,IL,7572,#N/A,5659,8320,4830,3699,4969,#N/A,4705.777776,5148,8275,29400,-4569,729,-17802,2238,35049,24831,30129,11598,31638
17029,IL,5916,#N/A,5659,8320,4830,3699,4696,#N/A,5030.314174,5148,7435,27228,-5212,86,-18841,1595,33120,22016,27314,8387,28823
17031,IL,9912,#N/A,5659,8320,4830,3699,5356,#N/A,5375.134097,5148,8983,33117,-1963,3335,-14800,4844,37776,31154,36452,18317,37961
17033,IL,6444,#N/A,5659,8320,4830,3699,4783,#N/A,5233.149423,5148,8320,28844,-4784,514,-18149,2023,33735,24060,29358,10695,30867
17035,IL,6444,#N/A,5659,8320,4830,3699,4783,#N/A,5010.030649,5148,7506,27807,-4997,301,-18494,1810,33735,22810,28108,9313,29617
17037,IL,8112,#N/A,5659,8320,4830,3699,5058,#N/A,5719.954021,5148,8878,31557,-4356,942,-17457,2451,35678,27201,32499,14100,34008
17039,IL,5652,#N/A,5659,8320,4830,3699,4652,#N/A,5395.417622,5148,8829,28723,-4997,301,-18494,1810,32812,23726,29024,10229,30533
17041,IL,6156,#N/A,5659,8320,4830,3699,4735,#N/A,5314.283523,5148,8320,28637,-4997,301,-18494,1810,33399,23640,28938,10143,30447
17043,IL,9912,#N/A,5659,8320,4830,3699,5356,#N/A,5598.252871,5148,8914,33271,-1963,3335,-14800,4844,37776,31308,36606,18471,38115
17045,IL,5688,#N/A,5659,8320,4830,3699,4658,#N/A,5273.716473,5148,8320,28129,-4997,301,-18494,1810,32854,23132,28430,9635,29939
17047,IL,6144,#N/A,5659,8320,4830,3699,4733,#N/A,5496.835247,5148,8320,28808,-4997,301,-18494,1810,33385,23811,29109,10314,30618
17049,IL,5652,#N/A,5659,8320,4830,3699,4652,#N/A,4807.1954,5148,8342,27648,-4997,301,-18494,1810,32812,22651,27949,9154,29458
17051,IL,6240,#N/A,5659,8320,4830,3699,4749,#N/A,4502.942527,5148,8320,27910,-4784,514,-18149,2023,33497,23126,28424,9761,29933
17053,IL,8496,#N/A,5659,8320,4830,3699,5122,#N/A,5435.984672,5148,8044,30823,-4356,942,-17457,2451,36126,26467,31765,13366,33274
17055,IL,5652,#N/A,5659,8320,4830,3699,4652,#N/A,5537.402297,5148,8320,28356,-4997,301,-18494,1810,32812,23359,28657,9862,30166
17057,IL,5988,#N/A,5659,8320,4830,3699,4707,#N/A,4766.628351,5148,7797,27399,-4997,301,-18494,1810,33203,22402,27700,8905,29209
17059,IL,6444,#N/A,5659,8320,4830,3699,4783,#N/A,4969.4636,5148,8320,28580,-4784,514,-18149,2023,33735,23796,29094,10431,30603
17061,IL,6444,#N/A,5659,8320,4830,3699,4783,#N/A,5091.164749,5148,8320,28702,-4784,514,-18149,2023,33735,23918,29216,10553,30725
17063,IL,8100,#N/A,5659,8320,4830,3699,5056,#N/A,5517.118772,5148,8881,31345,-4356,942,-17457,2451,35664,26989,32287,13888,33796
17065,IL,6444,#N/A,5659,8320,4830,3699,4783,#N/A,5030.314174,5148,8320,28641,-4784,514,-18149,2023,33735,23857,29155,10492,30664
17067,IL,6120,#N/A,5659,8320,4830,3699,4729,#N/A,4908.613025,5148,7894,27769,-4997,301,-18494,1810,33357,22772,28070,9275,29579
17069,IL,5652,#N/A,5659,8320,4830,3699,4652,#N/A,4908.613025,5148,8320,27728,-4997,301,-18494,1810,32812,22731,28029,9234,29538
17071,IL,6312,#N/A,5659,8320,4830,3699,4761,#N/A,4888.3295,5148,7853,27901,-4997,301,-18494,1810,33581,22904,28202,9407,29711
17073,IL,6396,#N/A,5659,8320,4830,3699,4775,#N/A,4827.478925,5148,8150,28220,-4784,514,-18149,2023,33679,23436,28734,10071,30243
17075,IL,5796,#N/A,5659,8320,4830,3699,4676,#N/A,5557.685821,5148,8320,28521,-4997,301,-18494,1810,32980,23524,28822,10027,30331
17077,IL,6048,#N/A,5659,8320,4830,3699,4717,#N/A,5334.567048,5148,7415,27645,-5212,86,-18841,1595,33273,22433,27731,8804,29240
17079,IL,6444,#N/A,5659,8320,4830,3699,4783,#N/A,5131.731799,5148,8320,28743,-4784,514,-18149,2023,33735,23959,29257,10594,30766
17081,IL,6072,#N/A,5659,8320,4830,3699,4721,#N/A,4949.180075,5148,7794,27663,-4997,301,-18494,1810,33301,22666,27964,9169,29473
17083,IL,7572,#N/A,5659,8320,4830,3699,4969,#N/A,5557.685821,5148,8276,30253,-4569,729,-17802,2238,35049,25684,30982,12451,32491
17085,IL,6444,#N/A,5659,8320,4830,3699,4783,#N/A,6044.490419,5148,8320,29655,-4784,514,-18149,2023,33735,24871,30169,11506,31678
17087,IL,6444,#N/A,5659,8320,4830,3699,4783,#N/A,5111.448274,5148,8320,28722,-4784,514,-18149,2023,33735,23938,29236,10573,30745
17089,IL,9912,#N/A,5659,8320,4830,3699,5356,#N/A,5253.432948,5148,8889,32901,-1963,3335,-14800,4844,37776,30938,36236,18101,37745
17091,IL,6888,#N/A,5659,8320,4830,3699,4856,#N/A,5435.984672,5148,8201,29372,-4784,514,-18149,2023,34252,24588,29886,11223,31395
17093,IL,9000,#N/A,5659,8320,4830,3699,5205,#N/A,5010.030649,5148,8861,31718,-2177,3121,-15146,4630,36713,29541,34839,16572,36348
17095,IL,5652,#N/A,5659,8320,4830,3699,4652,#N/A,5131.731799,5148,7521,27152,-5212,86,-18841,1595,32812,21940,27238,8311,28747
17097,IL,9912,#N/A,5659,8320,4830,3699,5356,#N/A,5760.52107,5148,8889,33409,-1963,3335,-14800,4844,37776,31446,36744,18609,38253
17099,IL,6804,#N/A,5659,8320,4830,3699,4842,#N/A,5050.597699,5148,8171,28873,-4784,514,-18149,2023,34154,24089,29387,10724,30896
17101,IL,6444,#N/A,5659,8320,4830,3699,4783,#N/A,5456.268197,5148,8320,29067,-4784,514,-18149,2023,33735,24283,29581,10918,31090
17103,IL,5988,#N/A,5659,8320,4830,3699,4707,#N/A,4827.478925,5148,8058,27721,-4997,301,-18494,1810,33203,22724,28022,9227,29531
17105,IL,6132,#N/A,5659,8320,4830,3699,4731,#N/A,4766.628351,5148,7990,27736,-4997,301,-18494,1810,33371,22739,28037,9242,29546
17107,IL,5664,#N/A,5659,8320,4830,3699,4654,#N/A,4786.911875,5148,7449,26746,-5212,86,-18841,1595,32826,21534,26832,7905,28341
17109,IL,6276,#N/A,5659,8320,4830,3699,4755,#N/A,4989.747124,5148,7199,27312,-5212,86,-18841,1595,33539,22100,27398,8471,28907
17111,IL,9912,#N/A,5659,8320,4830,3699,5356,#N/A,5517.118772,5148,8867,33143,-1963,3335,-14800,4844,37776,31180,36478,18343,37987
17113,IL,7884,#N/A,5659,8320,4830,3699,5021,#N/A,5496.835247,5148,8846,31073,-4356,942,-17457,2451,35413,26717,32015,13616,33524
17115,IL,6300,#N/A,5659,8320,4830,3699,4759,#N/A,5050.597699,5148,7885,28083,-4997,301,-18494,1810,33567,23086,28384,9589,29893
17117,IL,5796,#N/A,5659,8320,4830,3699,4676,#N/A,5699.670496,5148,8276,28618,-4997,301,-18494,1810,32980,23621,28919,10124,30428
17119,IL,7572,#N/A,5659,8320,4830,3699,4969,#N/A,5273.716473,5148,8269,29962,-4569,729,-17802,2238,35049,25393,30691,12160,32200
17121,IL,5820,#N/A,5659,8320,4830,3699,4680,#N/A,5415.701147,5148,7769,27852,-4997,301,-18494,1810,33008,22855,28153,9358,29662
17123,IL,6780,#N/A,5659,8320,4830,3699,4838,#N/A,5212.865898,5148,8193,29033,-4784,514,-18149,2023,34126,24249,29547,10884,31056
17125,IL,5652,#N/A,5659,8320,4830,3699,4652,#N/A,5233.149423,5148,8320,28052,-4997,301,-18494,1810,32812,23055,28353,9558,29862
17127,IL,5952,#N/A,5659,8320,4830,3699,4701,#N/A,5050.597699,5148,7832,27682,-4997,301,-18494,1810,33161,22685,27983,9188,29492
17129,IL,7008,#N/A,5659,8320,4830,3699,4876,#N/A,5334.567048,5148,8222,29412,-4784,514,-18149,2023,34392,24628,29926,11263,31435
17131,IL,6396,#N/A,5659,8320,4830,3699,4775,#N/A,5253.432948,5148,8154,28650,-4784,514,-18149,2023,33679,23866,29164,10501,30673
17133,IL,7572,#N/A,5659,8320,4830,3699,4969,#N/A,5922.78927,5148,8274,30615,-4569,729,-17802,2238,35049,26046,31344,12813,32853
17135,IL,6888,#N/A,5659,8320,4830,3699,4856,#N/A,4644.927201,5148,8320,28700,-4784,514,-18149,2023,34252,23916,29214,10551,30723
17137,IL,5772,#N/A,5659,8320,4830,3699,4672,#N/A,4786.911875,5148,7920,27326,-4997,301,-18494,1810,32952,22329,27627,8832,29136
17139,IL,6444,#N/A,5659,8320,4830,3699,4783,#N/A,5091.164749,5148,8320,28702,-4784,514,-18149,2023,33735,23918,29216,10553,30725
17141,IL,6384,#N/A,5659,8320,4830,3699,4773,#N/A,4746.344826,5148,8326,28303,-4784,514,-18149,2023,33665,23519,28817,10154,30326
17143,IL,6780,#N/A,5659,8320,4830,3699,4838,#N/A,5293.999998,5148,8172,29093,-4784,514,-18149,2023,34126,24309,29607,10944,31116
17145,IL,5652,#N/A,5659,8320,4830,3699,4652,#N/A,5415.701147,5148,8320,28235,-4997,301,-18494,1810,32812,23238,28536,9741,30045
17147,IL,8496,#N/A,5659,8320,4830,3699,5122,#N/A,5395.417622,5148,8047,30785,-4356,942,-17457,2451,36126,26429,31727,13328,33236
17149,IL,6444,#N/A,5659,8320,4830,3699,4783,#N/A,4908.613025,5148,8320,28520,-4784,514,-18149,2023,33735,23736,29034,10371,30543
17151,IL,6444,#N/A,5659,8320,4830,3699,4783,#N/A,5010.030649,5148,8320,28621,-4784,514,-18149,2023,33735,23837,29135,10472,30644
17153,IL,6444,#N/A,5659,8320,4830,3699,4783,#N/A,5111.448274,5148,8320,28722,-4784,514,-18149,2023,33735,23938,29236,10573,30745
17155,IL,6612,#N/A,5659,8320,4830,3699,4811,#N/A,5091.164749,5148,8182,28733,-4784,514,-18149,2023,33931,23949,29247,10584,30756
17157,IL,5820,#N/A,5659,8320,4830,3699,4680,#N/A,4563.793102,5148,8320,27551,-4997,301,-18494,1810,33008,22554,27852,9057,29361
17159,IL,5652,#N/A,5659,8320,4830,3699,4652,#N/A,5456.268197,5148,8320,28275,-4997,301,-18494,1810,32812,23278,28576,9781,30085
17161,IL,6396,#N/A,5659,8320,4830,3699,4775,#N/A,5233.149423,5148,8130,28606,-4784,514,-18149,2023,33679,23822,29120,10457,30629
17163,IL,7572,#N/A,5659,8320,4830,3699,4969,#N/A,5293.999998,5148,8267,29980,-4569,729,-17802,2238,35049,25411,30709,12178,32218
17165,IL,5652,#N/A,5659,8320,4830,3699,4652,#N/A,4786.911875,5148,8320,27606,-4997,301,-18494,1810,32812,22609,27907,9112,29416
17167,IL,7008,#N/A,5659,8320,4830,3699,4876,#N/A,5496.835247,5148,8206,29558,-4784,514,-18149,2023,34392,24774,30072,11409,31581
17169,IL,6444,#N/A,5659,8320,4830,3699,4783,#N/A,4969.4636,5148,8320,28580,-4784,514,-18149,2023,33735,23796,29094,10431,30603
17171,IL,5808,#N/A,5659,8320,4830,3699,4678,#N/A,4908.613025,5148,7963,27526,-4997,301,-18494,1810,32994,22529,27827,9032,29336
17173,IL,5652,#N/A,5659,8320,4830,3699,4652,#N/A,5192.582373,5148,8320,28012,-4997,301,-18494,1810,32812,23015,28313,9518,29822
17175,IL,6780,#N/A,5659,8320,4830,3699,4838,#N/A,5192.582373,5148,8198,29017,-4784,514,-18149,2023,34126,24233,29531,10868,31040
17177,IL,5796,#N/A,5659,8320,4830,3699,4676,#N/A,5091.164749,5148,7844,27578,-4997,301,-18494,1810,32980,22581,27879,9084,29388
17179,IL,6780,#N/A,5659,8320,4830,3699,4838,#N/A,5293.999998,5148,8180,29101,-4784,514,-18149,2023,34126,24317,29615,10952,31124
17181,IL,5652,#N/A,5659,8320,4830,3699,4652,#N/A,5192.582373,5148,8320,28012,-4997,301,-18494,1810,32812,23015,28313,9518,29822
17183,IL,6816,#N/A,5659,8320,4830,3699,4844,#N/A,4766.628351,5148,7830,28259,-4784,514,-18149,2023,34168,23475,28773,10110,30282
17185,IL,5784,#N/A,5659,8320,4830,3699,4674,#N/A,5496.835247,5148,8320,28448,-4997,301,-18494,1810,32966,23451,28749,9954,30258
17187,IL,6228,#N/A,5659,8320,4830,3699,4747,#N/A,5030.314174,5148,8320,28425,-4784,514,-18149,2023,33483,23641,28939,10276,30448
17189,IL,5964,#N/A,5659,8320,4830,3699,4703,#N/A,5111.448274,5148,8320,28242,-4997,301,-18494,1810,33175,23245,28543,9748,30052
17191,IL,6444,#N/A,5659,8320,4830,3699,4783,#N/A,5233.149423,5148,8320,28844,-4784,514,-18149,2023,33735,24060,29358,10695,30867
17193,IL,6444,#N/A,5659,8320,4830,3699,4783,#N/A,5253.432948,5148,8320,28864,-4784,514,-18149,2023,33735,24080,29378,10715,30887
17195,IL,6420,#N/A,5659,8320,4830,3699,4779,#N/A,5010.030649,5148,8052,28329,-4997,301,-18494,1810,33707,23332,28630,9835,30139
17197,IL,9912,#N/A,5659,8320,4830,3699,5356,#N/A,5456.268197,5148,8877,33093,-1963,3335,-14800,4844,37776,31130,36428,18293,37937
17199,IL,5760,#N/A,5659,8320,4830,3699,4670,#N/A,5010.030649,5148,7433,27050,-5212,86,-18841,1595,32938,21838,27136,8209,28645
17201,IL,6720,#N/A,5659,8320,4830,3699,4828,#N/A,5091.164749,5148,8187,28845,-4784,514,-18149,2023,34056,24061,29359,10696,30868
17203,IL,6780,#N/A,5659,8320,4830,3699,4838,#N/A,5780.804595,5148,8191,29599,-4784,514,-18149,2023,34126,24815,30113,11450,31622
18001,IN,5940,#N/A,5659,8320,4564,3699,4205,#N/A,5253.432948,7260,8256,30408,-4761,-1499,-20030,10,32387,25647,28909,10378,30418
18003,IN,6240,#N/A,5659,8320,4564,3699,4249,#N/A,5212.865898,7260,8199,30610,-4552,-1290,-19689,219,32731,26058,29320,10921,30829
18005,IN,7980,#N/A,5659,8320,4564,3699,4509,#N/A,5111.448274,7260,8376,32427,-743,2519,-15748,4028,34731,31684,34946,16679,36455
18007,IN,7416,#N/A,5659,8320,4564,3699,4425,#N/A,5131.731799,7260,8030,31537,-743,2519,-15748,4028,34083,30794,34056,15789,35565
18009,IN,5556,#N/A,5659,8320,4564,3699,4147,#N/A,4949.180075,7260,8320,29784,-4761,-1499,-20030,10,31945,25023,28285,9754,29794
18011,IN,7500,#N/A,5659,8320,4564,3699,4437,#N/A,5192.582373,7260,8308,31959,-743,2519,-15748,4028,34179,31216,34478,16211,35987
18013,IN,7500,#N/A,5659,8320,4564,3699,4437,#N/A,5233.149423,7260,8308,32000,-743,2519,-15748,4028,34179,31257,34519,16252,36028
18015,IN,6336,#N/A,5659,8320,4564,3699,4264,#N/A,5537.402297,7260,8025,30858,-4761,-1499,-20030,10,32842,26097,29359,10828,30868
18017,IN,5556,#N/A,5659,8320,4564,3699,4147,#N/A,4584.076626,7260,7985,29085,-4761,-1499,-20030,10,31945,24324,27586,9055,29095
18019,IN,6804,#N/A,5659,8320,4564,3699,4334,#N/A,5050.597699,7260,8165,30979,-4552,-1290,-19689,219,33380,26427,29689,11290,31198
18021,IN,6480,#N/A,5659,8320,4564,3699,4285,#N/A,4421.808427,7260,7897,29757,-4761,-1499,-20030,10,33007,24996,28258,9727,29767
18023,IN,5928,#N/A,5659,8320,4564,3699,4203,#N/A,4482.659002,7260,8371,29740,-4761,-1499,-20030,10,32373,24979,28241,9710,29750
18025,IN,5556,#N/A,5659,8320,4564,3699,4147,#N/A,5293.999998,7260,8320,30129,-4761,-1499,-20030,10,31945,25368,28630,10099,30139
18027,IN,5556,#N/A,5659,8320,4564,3699,4147,#N/A,5517.118772,7260,8331,30364,-4761,-1499,-20030,10,31945,25603,28865,10334,30374
18029,IN,6648,#N/A,5659,8320,4564,3699,4310,#N/A,4827.478925,7260,8339,30773,-4552,-1290,-19689,219,33200,26221,29483,11084,30992
18031,IN,6060,#N/A,5659,8320,4564,3699,4223,#N/A,4584.076626,7260,8185,29788,-4761,-1499,-20030,10,32525,25027,28289,9758,29798
18033,IN,5772,#N/A,5659,8320,4564,3699,4180,#N/A,5375.134097,7260,8149,30255,-4761,-1499,-20030,10,32194,25494,28756,10225,30265
18035,IN,6216,#N/A,5659,8320,4564,3699,4246,#N/A,4989.747124,7260,7380,29545,-4761,-1499,-20030,10,32704,24784,28046,9515,29555
18037,IN,5664,#N/A,5659,8320,4564,3699,4163,#N/A,5577.969346,7260,8372,30573,-4761,-1499,-20030,10,32069,25812,29074,10543,30583
18039,IN,6828,#N/A,5659,8320,4564,3699,4337,#N/A,4847.76245,7260,8327,30961,-4552,-1290,-19689,219,33407,26409,29671,11272,31180
18041,IN,5772,#N/A,5659,8320,4564,3699,4180,#N/A,5131.731799,7260,7322,29185,-4971,-1709,-20372,-200,32194,24214,27476,8813,28985
18043,IN,6804,#N/A,5659,8320,4564,3699,4334,#N/A,5233.149423,7260,8166,31163,-4552,-1290,-19689,219,33380,26611,29873,11474,31382
18045,IN,6336,#N/A,5659,8320,4564,3699,4264,#N/A,5192.582373,7260,8320,30808,-4552,-1290,-19689,219,32842,26256,29518,11119,31027
18047,IN,6648,#N/A,5659,8320,4564,3699,4310,#N/A,5517.118772,7260,8320,31444,-4552,-1290,-19689,219,33200,26892,30154,11755,31663
18049,IN,6276,#N/A,5659,8320,4564,3699,4255,#N/A,5334.567048,7260,8320,30890,-4552,-1290,-19689,219,32773,26338,29600,11201,31109
18051,IN,5688,#N/A,5659,8320,4564,3699,4167,#N/A,5557.685821,7260,8320,30525,-4761,-1499,-20030,10,32097,25764,29026,10495,30535
18053,IN,5568,#N/A,5659,8320,4564,3699,4149,#N/A,4868.045975,7260,7350,28745,-4971,-1709,-20372,-200,31959,23774,27036,8373,28545
18055,IN,5556,#N/A,5659,8320,4564,3699,4147,#N/A,5354.850573,7260,8320,30190,-4761,-1499,-20030,10,31945,25429,28691,10160,30200
18057,IN,7500,#N/A,5659,8320,4564,3699,4437,#N/A,6227.042143,7260,8308,32994,-743,2519,-15748,4028,34179,32251,35513,17246,37022
18059,IN,7500,#N/A,5659,8320,4564,3699,4437,#N/A,5070.881224,7260,8308,31838,-743,2519,-15748,4028,34179,31095,34357,16090,35866
18061,IN,6804,#N/A,5659,8320,4564,3699,4334,#N/A,5192.582373,7260,8176,31132,-4552,-1290,-19689,219,33380,26580,29842,11443,31351
18063,IN,7500,#N/A,5659,8320,4564,3699,4437,#N/A,5354.850573,7260,8307,32121,-743,2519,-15748,4028,34179,31378,34640,16373,36149
18065,IN,5604,#N/A,5659,8320,4564,3699,4155,#N/A,4685.494251,7260,7724,28972,-4971,-1709,-20372,-200,32001,24001,27263,8600,28772
18067,IN,5880,#N/A,5659,8320,4564,3699,4196,#N/A,4989.747124,7260,7716,29545,-4761,-1499,-20030,10,32318,24784,28046,9515,29555
18069,IN,5808,#N/A,5659,8320,4564,3699,4185,#N/A,4665.210726,7260,8128,29560,-4761,-1499,-20030,10,32235,24799,28061,9530,29570
18071,IN,6048,#N/A,5659,8320,4564,3699,4221,#N/A,4563.793102,7260,8109,29680,-4761,-1499,-20030,10,32511,24919,28181,9650,29690
18073,IN,6132,#N/A,5659,8320,4564,3699,4233,#N/A,5517.118772,7260,8856,31464,-4552,-1290,-19689,219,32607,26912,30174,11775,31683
18075,IN,5796,#N/A,5659,8320,4564,3699,4183,#N/A,5091.164749,7260,8320,30166,-4761,-1499,-20030,10,32221,25405,28667,10136,30176
18077,IN,5820,#N/A,5659,8320,4564,3699,4187,#N/A,4665.210726,7260,7836,29280,-4761,-1499,-20030,10,32249,24519,27781,9250,29290
18079,IN,6072,#N/A,5659,8320,4564,3699,4224,#N/A,5212.865898,7260,8031,30275,-4761,-1499,-20030,10,32538,25514,28776,10245,30285
18081,IN,7500,#N/A,5659,8320,4564,3699,4437,#N/A,5293.999998,7260,8308,32061,-743,2519,-15748,4028,34179,31318,34580,16313,36089
18083,IN,5688,#N/A,5659,8320,4564,3699,4167,#N/A,5517.118772,7260,7861,30025,-4761,-1499,-20030,10,32097,25264,28526,9995,30035
18085,IN,6048,#N/A,5659,8320,4564,3699,4221,#N/A,4908.613025,7260,8281,30197,-4761,-1499,-20030,10,32511,25436,28698,10167,30207
18087,IN,5868,#N/A,5659,8320,4564,3699,4194,#N/A,5517.118772,7260,8320,30664,-4761,-1499,-20030,10,32304,25903,29165,10634,30674
18089,IN,7740,#N/A,5659,8320,4564,3699,4473,#N/A,5050.597699,7260,8884,32634,-534,2728,-15407,4237,34455,32100,35362,17227,36871
18091,IN,6372,#N/A,5659,8320,4564,3699,4269,#N/A,4928.89655,7260,7896,30156,-4761,-1499,-20030,10,32883,25395,28657,10126,30166
18093,IN,5952,#N/A,5659,8320,4564,3699,4206,#N/A,4604.360151,7260,7829,29344,-4761,-1499,-20030,10,32400,24583,27845,9314,29354
18095,IN,6000,#N/A,5659,8320,4564,3699,4214,#N/A,5091.164749,7260,8306,30356,-4761,-1499,-20030,10,32456,25595,28857,10326,30366
18097,IN,7500,#N/A,5659,8320,4564,3699,4437,#N/A,5192.582373,7260,8307,31958,-743,2519,-15748,4028,34179,31215,34477,16210,35986
18099,IN,6000,#N/A,5659,8320,4564,3699,4214,#N/A,4665.210726,7260,8157,29781,-4761,-1499,-20030,10,32456,25020,28282,9751,29791
18101,IN,6336,#N/A,5659,8320,4564,3699,4264,#N/A,5111.448274,7260,8320,30726,-4552,-1290,-19689,219,32842,26174,29436,11037,30945
18103,IN,6336,#N/A,5659,8320,4564,3699,4264,#N/A,4523.226052,7260,7928,29746,-4761,-1499,-20030,10,32842,24985,28247,9716,29756
18105,IN,7488,#N/A,5659,8320,4564,3699,4436,#N/A,5679.386971,7260,7772,31898,-4552,-1290,-19689,219,34166,27346,30608,12209,32117
18107,IN,6156,#N/A,5659,8320,4564,3699,4237,#N/A,5375.134097,7260,8093,30583,-4761,-1499,-20030,10,32635,25822,29084,10553,30593
18109,IN,7500,#N/A,5659,8320,4564,3699,4437,#N/A,5435.984672,7260,8307,32202,-743,2519,-15748,4028,34179,31459,34721,16454,36230
18111,IN,7740,#N/A,5659,8320,4564,3699,4473,#N/A,5111.448274,7260,8845,32655,-534,2728,-15407,4237,34455,32121,35383,17248,36892
18113,IN,5820,#N/A,5659,8320,4564,3699,4187,#N/A,5273.716473,7260,8184,30237,-4761,-1499,-20030,10,32249,25476,28738,10207,30247
18115,IN,6648,#N/A,5659,8320,4564,3699,4310,#N/A,5435.984672,7260,8340,31383,-4552,-1290,-19689,219,33200,26831,30093,11694,31602
18117,IN,5556,#N/A,5659,8320,4564,3699,4147,#N/A,5050.597699,7260,8320,29886,-4761,-1499,-20030,10,31945,25125,28387,9856,29896
18119,IN,5844,#N/A,5659,8320,4564,3699,4190,#N/A,5740.237546,7260,7811,30354,-4761,-1499,-20030,10,32276,25593,28855,10324,30364
18121,IN,5556,#N/A,5659,8320,4564,3699,4147,#N/A,4949.180075,7260,8320,29784,-4761,-1499,-20030,10,31945,25023,28285,9754,29794
18123,IN,5652,#N/A,5659,8320,4564,3699,4162,#N/A,5293.999998,7260,8320,30225,-4761,-1499,-20030,10,32056,25464,28726,10195,30235
18125,IN,6336,#N/A,5659,8320,4564,3699,4264,#N/A,5375.134097,7260,8371,31042,-4552,-1290,-19689,219,32842,26490,29752,11353,31261
18127,IN,7740,#N/A,5659,8320,4564,3699,4473,#N/A,5415.701147,7260,8862,32976,-534,2728,-15407,4237,34455,32442,35704,17569,37213
18129,IN,6864,#N/A,5659,8320,4564,3699,4343,#N/A,5760.52107,7260,8101,31684,-4552,-1290,-19689,219,33449,27132,30394,11995,31903
18131,IN,5580,#N/A,5659,8320,4564,3699,4151,#N/A,4827.478925,7260,8320,29686,-4761,-1499,-20030,10,31973,24925,28187,9656,29696
18133,IN,6168,#N/A,5659,8320,4564,3699,4239,#N/A,4644.927201,7260,8307,30079,-4552,-1290,-19689,219,32649,25527,28789,10390,30298
18135,IN,5784,#N/A,5659,8320,4564,3699,4181,#N/A,4340.674328,7260,8320,29404,-4761,-1499,-20030,10,32207,24643,27905,9374,29414
18137,IN,5592,#N/A,5659,8320,4564,3699,4153,#N/A,5699.670496,7260,8320,30571,-4761,-1499,-20030,10,31987,25810,29072,10541,30581
18139,IN,5556,#N/A,5659,8320,4564,3699,4147,#N/A,5030.314174,7260,8320,29865,-4761,-1499,-20030,10,31945,25104,28366,9835,29875
18141,IN,6696,#N/A,5659,8320,4564,3699,4317,#N/A,5131.731799,7260,8005,30791,-4552,-1290,-19689,219,33255,26239,29501,11102,31010
18143,IN,5724,#N/A,5659,8320,4564,3699,4172,#N/A,5395.417622,7260,8168,30246,-4761,-1499,-20030,10,32138,25485,28747,10216,30256
18145,IN,7500,#N/A,5659,8320,4564,3699,4437,#N/A,4746.344826,7260,8307,31512,-743,2519,-15748,4028,34179,30769,34031,15764,35540
18147,IN,5556,#N/A,5659,8320,4564,3699,4147,#N/A,5598.252871,7260,8320,30433,-4761,-1499,-20030,10,31945,25672,28934,10403,30443
18149,IN,6444,#N/A,5659,8320,4564,3699,4280,#N/A,5699.670496,7260,8320,31423,-4552,-1290,-19689,219,32966,26871,30133,11734,31642
18151,IN,6012,#N/A,5659,8320,4564,3699,4215,#N/A,4786.911875,7260,8106,29864,-4761,-1499,-20030,10,32469,25103,28365,9834,29874
18153,IN,6336,#N/A,5659,8320,4564,3699,4264,#N/A,5618.536396,7260,7905,30818,-4761,-1499,-20030,10,32842,26057,29319,10788,30828
18155,IN,5556,#N/A,5659,8320,4564,3699,4147,#N/A,5192.582373,7260,8320,30028,-4761,-1499,-20030,10,31945,25267,28529,9998,30038
18157,IN,7416,#N/A,5659,8320,4564,3699,4425,#N/A,5253.432948,7260,8003,31631,-743,2519,-15748,4028,34083,30888,34150,15883,35659
18159,IN,5880,#N/A,5659,8320,4564,3699,4196,#N/A,5557.685821,7260,8320,30717,-4761,-1499,-20030,10,32318,25956,29218,10687,30727
18161,IN,6336,#N/A,5659,8320,4564,3699,4264,#N/A,5375.134097,7260,8339,31010,-4552,-1290,-19689,219,32842,26458,29720,11321,31229
18163,IN,6864,#N/A,5659,8320,4564,3699,4343,#N/A,5253.432948,7260,8081,31157,-4552,-1290,-19689,219,33449,26605,29867,11468,31376
18165,IN,6480,#N/A,5659,8320,4564,3699,4285,#N/A,4908.613025,7260,7906,30254,-4552,-1290,-19689,219,33007,25702,28964,10565,30473
18167,IN,6480,#N/A,5659,8320,4564,3699,4285,#N/A,5050.597699,7260,7862,30351,-4761,-1499,-20030,10,33007,25590,28852,10321,30361
18169,IN,5556,#N/A,5659,8320,4564,3699,4147,#N/A,5273.716473,7260,7899,29688,-4761,-1499,-20030,10,31945,24927,28189,9658,29698
18171,IN,6336,#N/A,5659,8320,4564,3699,4264,#N/A,5192.582373,7260,8320,30808,-4552,-1290,-19689,219,32842,26256,29518,11119,31027
18173,IN,6864,#N/A,5659,8320,4564,3699,4343,#N/A,5821.371645,7260,8100,31745,-4552,-1290,-19689,219,33449,27193,30455,12056,31964
18175,IN,6096,#N/A,5659,8320,4564,3699,4228,#N/A,6003.923369,7260,8173,31232,-4761,-1499,-20030,10,32566,26471,29733,11202,31242
18177,IN,6000,#N/A,5659,8320,4564,3699,4214,#N/A,4868.045975,7260,7334,29162,-4971,-1709,-20372,-200,32456,24191,27453,8790,28962
18179,IN,6240,#N/A,5659,8320,4564,3699,4249,#N/A,5192.582373,7260,8200,30591,-4552,-1290,-19689,219,32731,26039,29301,10902,30810
18181,IN,6336,#N/A,5659,8320,4564,3699,4264,#N/A,5212.865898,7260,8320,30828,-4552,-1290,-19689,219,32842,26276,29538,11139,31047
18183,IN,6240,#N/A,5659,8320,4564,3699,4249,#N/A,4665.210726,7260,8203,30067,-4552,-1290,-19689,219,32731,25515,28777,10378,30286
19001,IA,5496,#N/A,5659,8320,4609,3699,5201,#N/A,5496.835247,6972,8320,29984,-8732,-924,-19455,585,32984,21252,29060,10529,30569
19003,IA,5532,#N/A,5659,8320,4609,3699,5208,#N/A,5172.298848,6972,8320,29695,-8732,-924,-19455,585,33027,20963,28771,10240,30280
19005,IA,5856,#N/A,5659,8320,4609,3699,5268,#N/A,5091.164749,6972,8320,29938,-8732,-924,-19455,585,33411,21206,29014,10483,30523
19007,IA,5136,#N/A,5659,8320,4609,3699,5133,#N/A,4685.494251,6972,8320,28812,-8974,-1166,-19829,343,32556,19838,27646,8983,29155
19009,IA,5592,#N/A,5659,8320,4609,3699,5219,#N/A,5334.567048,6972,8320,29918,-8732,-924,-19455,585,33098,21186,28994,10463,30503
19011,IA,5628,#N/A,5659,8320,4609,3699,5226,#N/A,5354.850573,6972,8388,30041,-8732,-924,-19455,585,33141,21309,29117,10586,30626
19013,IA,6876,#N/A,5659,8320,4609,3699,5459,#N/A,5212.865898,6972,8157,30917,-8491,-683,-19082,826,34622,22426,30234,11835,31743
19015,IA,5568,#N/A,5659,8320,4609,3699,5214,#N/A,5273.716473,6972,8206,29719,-8732,-924,-19455,585,33069,20987,28795,10264,30304
19017,IA,5760,#N/A,5659,8320,4609,3699,5250,#N/A,5456.268197,6972,8164,30052,-8732,-924,-19455,585,33297,21320,29128,10597,30637
19019,IA,5220,#N/A,5659,8320,4609,3699,5149,#N/A,5456.268197,6972,8320,29667,-8974,-1166,-19829,343,32656,20693,28501,9838,30010
19021,IA,5760,#N/A,5659,8320,4609,3699,5250,#N/A,5172.298848,6972,8238,29841,-8732,-924,-19455,585,33297,21109,28917,10386,30426
19023,IA,5856,#N/A,5659,8320,4609,3699,5268,#N/A,5233.149423,6972,8320,30080,-8732,-924,-19455,585,33411,21348,29156,10625,30665
19025,IA,5316,#N/A,5659,8320,4609,3699,5167,#N/A,5091.164749,6972,8320,29398,-8974,-1166,-19829,343,32770,20424,28232,9569,29741
19027,IA,5532,#N/A,5659,8320,4609,3699,5208,#N/A,5517.118772,6972,8320,30040,-8732,-924,-19455,585,33027,21308,29116,10585,30625
19029,IA,5688,#N/A,5659,8320,4609,3699,5237,#N/A,5131.731799,6972,8320,29811,-8732,-924,-19455,585,33212,21079,28887,10356,30396
19031,IA,5628,#N/A,5659,8320,4609,3699,5226,#N/A,5375.134097,6972,8320,29994,-8732,-924,-19455,585,33141,21262,29070,10539,30579
19033,IA,5904,#N/A,5659,8320,4609,3699,5277,#N/A,5212.865898,6972,7857,29645,-8732,-924,-19455,585,33468,20913,28721,10190,30230
19035,IA,5208,#N/A,5659,8320,4609,3699,5147,#N/A,5293.999998,6972,8320,29493,-8974,-1166,-19829,343,32642,20519,28327,9664,29836
19037,IA,5640,#N/A,5659,8320,4609,3699,5228,#N/A,5273.716473,6972,8320,29905,-8732,-924,-19455,585,33155,21173,28981,10450,30490
19039,IA,5688,#N/A,5659,8320,4609,3699,5237,#N/A,5415.701147,6972,8320,30095,-8732,-924,-19455,585,33212,21363,29171,10640,30680
19041,IA,5136,#N/A,5659,8320,4609,3699,5133,#N/A,5375.134097,6972,8046,29228,-8974,-1166,-19829,343,32556,20254,28062,9399,29571
19043,IA,5856,#N/A,5659,8320,4609,3699,5268,#N/A,5233.149423,6972,8320,30080,-8732,-924,-19455,585,33411,21348,29156,10625,30665
19045,IA,5988,#N/A,5659,8320,4609,3699,5293,#N/A,5010.030649,6972,8106,29775,-8732,-924,-19455,585,33568,21043,28851,10320,30360
19047,IA,5856,#N/A,5659,8320,4609,3699,5268,#N/A,5253.432948,6972,8320,30100,-8732,-924,-19455,585,33411,21368,29176,10645,30685
19049,IA,7572,#N/A,5659,8320,4609,3699,5589,#N/A,5618.536396,6972,8815,32677,-4651,3157,-15110,4666,35448,28026,35834,17567,37343
19051,IA,5988,#N/A,5659,8320,4609,3699,5293,#N/A,4847.76245,6972,7912,29419,-8732,-924,-19455,585,33568,20687,28495,9964,30004
19053,IA,5448,#N/A,5659,8320,4609,3699,5192,#N/A,5030.314174,6972,8320,29469,-8732,-924,-19455,585,32927,20737,28545,10014,30054
19055,IA,5688,#N/A,5659,8320,4609,3699,5237,#N/A,5293.999998,6972,8320,29973,-8732,-924,-19455,585,33212,21241,29049,10518,30558
19057,IA,6048,#N/A,5659,8320,4609,3699,5304,#N/A,5070.881224,6972,7783,29573,-8732,-924,-19455,585,33639,20841,28649,10118,30158
19059,IA,5340,#N/A,5659,8320,4609,3699,5172,#N/A,5395.417622,6972,7971,29378,-8974,-1166,-19829,343,32799,20404,28212,9549,29721
19061,IA,6708,#N/A,5659,8320,4609,3699,5428,#N/A,5456.268197,6972,8282,31118,-8491,-683,-19082,826,34423,22627,30435,12036,31944
19063,IA,5868,#N/A,5659,8320,4609,3699,5270,#N/A,5638.819921,6972,8320,30498,-8732,-924,-19455,585,33425,21766,29574,11043,31083
19065,IA,5844,#N/A,5659,8320,4609,3699,5266,#N/A,5334.567048,6972,8320,30170,-8732,-924,-19455,585,33397,21438,29246,10715,30755
19067,IA,5376,#N/A,5659,8320,4609,3699,5178,#N/A,5253.432948,6972,8320,29620,-8732,-924,-19455,585,32841,20888,28696,10165,30205
19069,IA,5136,#N/A,5659,8320,4609,3699,5133,#N/A,5233.149423,6972,8320,29360,-8974,-1166,-19829,343,32556,20386,28194,9531,29703
19071,IA,5640,#N/A,5659,8320,4609,3699,5228,#N/A,5354.850573,6972,8320,29986,-8732,-924,-19455,585,33155,21254,29062,10531,30571
19073,IA,5232,#N/A,5659,8320,4609,3699,5151,#N/A,5395.417622,6972,8320,29618,-8974,-1166,-19829,343,32670,20644,28452,9789,29961
19075,IA,6876,#N/A,5659,8320,4609,3699,5459,#N/A,5172.298848,6972,8171,30890,-8491,-683,-19082,826,34622,22399,30207,11808,31716
19077,IA,7572,#N/A,5659,8320,4609,3699,5589,#N/A,5415.701147,6972,8796,32454,-4651,3157,-15110,4666,35448,27803,35611,17344,37120
19079,IA,5784,#N/A,5659,8320,4609,3699,5255,#N/A,5253.432948,6972,8320,30028,-8732,-924,-19455,585,33326,21296,29104,10573,30613
19081,IA,5136,#N/A,5659,8320,4609,3699,5133,#N/A,5273.716473,6972,8320,29401,-8974,-1166,-19829,343,32556,20427,28235,9572,29744
19083,IA,5352,#N/A,5659,8320,4609,3699,5174,#N/A,5233.149423,6972,8320,29576,-8732,-924,-19455,585,32813,20844,28652,10121,30161
19085,IA,7548,#N/A,5659,8320,4609,3699,5585,#N/A,5456.268197,6972,8511,32186,-4651,3157,-15110,4666,35420,27535,35343,17076,36852
19087,IA,5784,#N/A,5659,8320,4609,3699,5255,#N/A,4584.076626,6972,8320,29359,-8732,-924,-19455,585,33326,20627,28435,9904,29944
19089,IA,5136,#N/A,5659,8320,4609,3699,5133,#N/A,5172.298848,6972,8320,29299,-8974,-1166,-19829,343,32556,20325,28133,9470,29642
19091,IA,5136,#N/A,5659,8320,4609,3699,5133,#N/A,5091.164749,6972,8320,29218,-8974,-1166,-19829,343,32556,20244,28052,9389,29561
19093,IA,5268,#N/A,5659,8320,4609,3699,5158,#N/A,5314.283523,6972,8320,29573,-8974,-1166,-19829,343,32713,20599,28407,9744,29916
19095,IA,5472,#N/A,5659,8320,4609,3699,5196,#N/A,5517.118772,6972,8320,29980,-8732,-924,-19455,585,32955,21248,29056,10525,30565
19097,IA,5856,#N/A,5659,8320,4609,3699,5268,#N/A,5314.283523,6972,8320,30161,-8732,-924,-19455,585,33411,21429,29237,10706,30746
19099,IA,6012,#N/A,5659,8320,4609,3699,5297,#N/A,5577.969346,6972,8007,30268,-8732,-924,-19455,585,33596,21536,29344,10813,30853
19101,IA,5724,#N/A,5659,8320,4609,3699,5244,#N/A,4868.045975,6972,7815,29078,-8974,-1166,-19829,343,33255,20104,27912,9249,29421
19103,IA,8016,#N/A,5659,8320,4609,3699,5673,#N/A,5699.670496,6972,8331,32718,-4651,3157,-15110,4666,35976,28067,35875,17608,37384
19105,IA,5136,#N/A,5659,8320,4609,3699,5133,#N/A,5435.984672,6972,8390,29633,-8974,-1166,-19829,343,32556,20659,28467,9804,29976
19107,IA,5280,#N/A,5659,8320,4609,3699,5160,#N/A,5415.701147,6972,8320,29687,-8974,-1166,-19829,343,32727,20713,28521,9858,30030
19109,IA,5136,#N/A,5659,8320,4609,3699,5133,#N/A,5557.685821,6972,8320,29685,-8974,-1166,-19829,343,32556,20711,28519,9856,30028
19111,IA,5220,#N/A,5659,8320,4609,3699,5149,#N/A,4523.226052,6972,7862,28277,-8974,-1166,-19829,343,32656,19303,27111,8448,28620
19113,IA,5808,#N/A,5659,8320,4609,3699,5259,#N/A,5435.984672,6972,8391,30306,-8732,-924,-19455,585,33354,21574,29382,10851,30891
19115,IA,5544,#N/A,5659,8320,4609,3699,5210,#N/A,5375.134097,6972,8320,29910,-8732,-924,-19455,585,33041,21178,28986,10455,30495
19117,IA,5136,#N/A,5659,8320,4609,3699,5133,#N/A,5070.881224,6972,8320,29198,-8974,-1166,-19829,343,32556,20224,28032,9369,29541
19119,IA,5796,#N/A,5659,8320,4609,3699,5257,#N/A,5435.984672,6972,8320,30223,-8732,-924,-19455,585,33340,21491,29299,10768,30808
19121,IA,7572,#N/A,5659,8320,4609,3699,5589,#N/A,5415.701147,6972,8802,32461,-4651,3157,-15110,4666,35448,27810,35618,17351,37127
19123,IA,5448,#N/A,5659,8320,4609,3699,5192,#N/A,5314.283523,6972,8064,29497,-8974,-1166,-19829,343,32927,20523,28331,9668,29840
19125,IA,6924,#N/A,5659,8320,4609,3699,5468,#N/A,5496.835247,6972,8320,31412,-8491,-683,-19082,826,34679,22921,30729,12330,32238
19127,IA,6096,#N/A,5659,8320,4609,3699,5313,#N/A,4908.613025,6972,8285,29961,-8732,-924,-19455,585,33696,21229,29037,10506,30546
19129,IA,7548,#N/A,5659,8320,4609,3699,5585,#N/A,5456.268197,6972,8511,32187,-4651,3157,-15110,4666,35420,27536,35344,17077,36853
19131,IA,5856,#N/A,5659,8320,4609,3699,5268,#N/A,5233.149423,6972,8320,30080,-8732,-924,-19455,585,33411,21348,29156,10625,30665
19133,IA,5136,#N/A,5659,8320,4609,3699,5133,#N/A,5314.283523,6972,8320,29441,-8974,-1166,-19829,343,32556,20467,28275,9612,29784
19135,IA,5256,#N/A,5659,8320,4609,3699,5156,#N/A,4928.89655,6972,8320,29176,-8974,-1166,-19829,343,32699,20202,28010,9347,29519
19137,IA,5136,#N/A,5659,8320,4609,3699,5133,#N/A,5152.015324,6972,8320,29279,-8974,-1166,-19829,343,32556,20305,28113,9450,29622
19139,IA,6324,#N/A,5659,8320,4609,3699,5356,#N/A,4908.613025,6972,8345,30249,-8732,-924,-19455,585,33967,21517,29325,10794,30834
19141,IA,5652,#N/A,5659,8320,4609,3699,5230,#N/A,5293.999998,6972,8320,29937,-8732,-924,-19455,585,33169,21205,29013,10482,30522
19143,IA,6012,#N/A,5659,8320,4609,3699,5297,#N/A,5334.567048,6972,8320,30338,-8732,-924,-19455,585,33596,21606,29414,10883,30923
19145,IA,5424,#N/A,5659,8320,4609,3699,5187,#N/A,5354.850573,6972,8320,29770,-8732,-924,-19455,585,32898,21038,28846,10315,30355
19147,IA,5832,#N/A,5659,8320,4609,3699,5264,#N/A,5476.551722,6972,8320,30300,-8732,-924,-19455,585,33383,21568,29376,10845,30885
19149,IA,5952,#N/A,5659,8320,4609,3699,5286,#N/A,5293.999998,6972,8361,30278,-8732,-924,-19455,585,33525,21546,29354,10823,30863
19151,IA,5388,#N/A,5659,8320,4609,3699,5181,#N/A,5131.731799,6972,8320,29511,-8732,-924,-19455,585,32856,20779,28587,10056,30096
19153,IA,7572,#N/A,5659,8320,4609,3699,5589,#N/A,5375.134097,6972,8835,32453,-4651,3157,-15110,4666,35448,27802,35610,17343,37119
19155,IA,7548,#N/A,5659,8320,4609,3699,5585,#N/A,5111.448274,6972,8521,31851,-4651,3157,-15110,4666,35420,27200,35008,16741,36517
19157,IA,6192,#N/A,5659,8320,4609,3699,5331,#N/A,5111.448274,6972,8320,30294,-8732,-924,-19455,585,33810,21562,29370,10839,30879
19159,IA,5628,#N/A,5659,8320,4609,3699,5226,#N/A,5030.314174,6972,8320,29649,-8732,-924,-19455,585,33141,20917,28725,10194,30234
19161,IA,5208,#N/A,5659,8320,4609,3699,5147,#N/A,5253.432948,6972,8320,29452,-8974,-1166,-19829,343,32642,20478,28286,9623,29795
19163,IA,6396,#N/A,5659,8320,4609,3699,5369,#N/A,5415.701147,6972,8129,30612,-8732,-924,-19455,585,34052,21880,29688,11157,31197
19165,IA,5364,#N/A,5659,8320,4609,3699,5176,#N/A,5172.298848,6972,8320,29527,-8732,-924,-19455,585,32827,20795,28603,10072,30112
19167,IA,5484,#N/A,5659,8320,4609,3699,5199,#N/A,5152.015324,6972,8320,29627,-8732,-924,-19455,585,32970,20895,28703,10172,30212
19169,IA,6900,#N/A,5659,8320,4609,3699,5464,#N/A,5476.551722,6972,8232,31280,-8491,-683,-19082,826,34651,22789,30597,12198,32106
19171,IA,5292,#N/A,5659,8320,4609,3699,5163,#N/A,5192.582373,6972,8320,29476,-8974,-1166,-19829,343,32742,20502,28310,9647,29819
19173,IA,5856,#N/A,5659,8320,4609,3699,5268,#N/A,5212.865898,6972,8320,30060,-8732,-924,-19455,585,33411,21328,29136,10605,30645
19175,IA,5184,#N/A,5659,8320,4609,3699,5142,#N/A,5131.731799,6972,8320,29307,-8974,-1166,-19829,343,32613,20333,28141,9478,29650
19177,IA,5856,#N/A,5659,8320,4609,3699,5268,#N/A,4746.344826,6972,8320,29593,-8732,-924,-19455,585,33411,20861,28669,10138,30178
19179,IA,5940,#N/A,5659,8320,4609,3699,5284,#N/A,4786.911875,6972,7857,29255,-8732,-924,-19455,585,33511,20523,28331,9800,29840
19181,IA,7572,#N/A,5659,8320,4609,3699,5589,#N/A,5537.402297,6972,8804,32584,-4651,3157,-15110,4666,35448,27933,35741,17474,37250
19183,IA,6144,#N/A,5659,8320,4609,3699,5322,#N/A,5233.149423,6972,8333,30382,-8732,-924,-19455,585,33753,21650,29458,10927,30967
19185,IA,5136,#N/A,5659,8320,4609,3699,5133,#N/A,4685.494251,6972,8320,28812,-8974,-1166,-19829,343,32556,19838,27646,8983,29155
19187,IA,5628,#N/A,5659,8320,4609,3699,5226,#N/A,4908.613025,6972,7704,28912,-8974,-1166,-19829,343,33141,19938,27746,9083,29255
19189,IA,5520,#N/A,5659,8320,4609,3699,5205,#N/A,5395.417622,6972,8320,29906,-8732,-924,-19455,585,33012,21174,28982,10451,30491
19191,IA,5136,#N/A,5659,8320,4609,3699,5133,#N/A,5618.536396,6972,8320,29746,-8974,-1166,-19829,343,32556,20772,28580,9917,30089
19193,IA,6492,#N/A,5659,8320,4609,3699,5387,#N/A,5375.134097,6972,8372,30910,-8491,-683,-19082,826,34166,22419,30227,11828,31736
19195,IA,5856,#N/A,5659,8320,4609,3699,5268,#N/A,5233.149423,6972,7913,29673,-8732,-924,-19455,585,33411,20941,28749,10218,30258
19197,IA,5472,#N/A,5659,8320,4609,3699,5196,#N/A,5152.015324,6972,8320,29615,-8732,-924,-19455,585,32955,20883,28691,10160,30200
20001,KS,6300,#N/A,5659,8320,4661,3699,4674,#N/A,5760.52107,5580,8320,29660,-3118,-387,-19050,1122,33313,26542,29273,10610,30782
20003,KS,5604,#N/A,5659,8320,4661,3699,4560,#N/A,5983.639844,5580,8320,29187,-3321,-590,-19385,919,32503,25866,28597,9802,30106
20005,KS,5580,#N/A,5659,8320,4661,3699,4556,#N/A,5740.237546,5580,7967,28566,-3321,-590,-19385,919,32475,25245,27976,9181,29485
20007,KS,5520,#N/A,5659,8320,4661,3699,4547,#N/A,5983.639844,5580,8320,29103,-3321,-590,-19385,919,32406,25782,28513,9718,30022
20009,KS,6288,#N/A,5659,8320,4661,3699,4672,#N/A,5638.819921,5580,8023,29229,-3118,-387,-19050,1122,33299,26111,28842,10179,30351
20011,KS,5616,#N/A,5659,8320,4661,3699,4562,#N/A,5435.984672,5580,8320,28651,-3321,-590,-19385,919,32517,25330,28061,9266,29570
20013,KS,5520,#N/A,5659,8320,4661,3699,4547,#N/A,5293.999998,5580,8320,28413,-3321,-590,-19385,919,32406,25092,27823,9028,29332
20015,KS,6672,#N/A,5659,8320,4661,3699,4735,#N/A,6044.490419,5580,8284,30280,-3118,-387,-19050,1122,33746,27162,29893,11230,31402
20017,KS,5568,#N/A,5659,8320,4661,3699,4554,#N/A,5496.835247,5580,8320,28664,-3321,-590,-19385,919,32461,25343,28074,9279,29583
20019,KS,6300,#N/A,5659,8320,4661,3699,4674,#N/A,5679.386971,5580,8320,29578,-3118,-387,-19050,1122,33313,26460,29191,10528,30700
20021,KS,5520,#N/A,5659,8320,4661,3699,4547,#N/A,5902.505745,5580,8320,29022,-3321,-590,-19385,919,32406,25701,28432,9637,29941
20023,KS,5520,#N/A,5659,8320,4661,3699,4547,#N/A,6105.340994,5580,8320,29224,-3321,-590,-19385,919,32406,25903,28634,9839,30143
20025,KS,6156,#N/A,5659,8320,4661,3699,4650,#N/A,5537.402297,5580,8320,29292,-3118,-387,-19050,1122,33145,26174,28905,10242,30414
20027,KS,6372,#N/A,5659,8320,4661,3699,4686,#N/A,5537.402297,5580,8320,29508,-3118,-387,-19050,1122,33397,26390,29121,10458,30630
20029,KS,5700,#N/A,5659,8320,4661,3699,4576,#N/A,5659.103446,5580,8320,28958,-3321,-590,-19385,919,32615,25637,28368,9573,29877
20031,KS,5520,#N/A,5659,8320,4661,3699,4547,#N/A,5293.999998,5580,8320,28413,-3321,-590,-19385,919,32406,25092,27823,9028,29332
20033,KS,6300,#N/A,5659,8320,4661,3699,4674,#N/A,5943.072795,5580,8320,29842,-3118,-387,-19050,1122,33313,26724,29455,10792,30964
20035,KS,5868,#N/A,5659,8320,4661,3699,4603,#N/A,5679.386971,5580,7883,28709,-3321,-590,-19385,919,32810,25388,28119,9324,29628
20037,KS,6216,#N/A,5659,8320,4661,3699,4660,#N/A,5030.314174,5580,7541,28067,-3321,-590,-19385,919,33215,24746,27477,8682,28986
20039,KS,5544,#N/A,5659,8320,4661,3699,4550,#N/A,5882.22222,5580,8320,29025,-3321,-590,-19385,919,32433,25704,28435,9640,29944
20041,KS,5700,#N/A,5659,8320,4661,3699,4576,#N/A,5659.103446,5580,8320,28958,-3321,-590,-19385,919,32615,25637,28368,9573,29877
20043,KS,6684,#N/A,5659,8320,4661,3699,4736,#N/A,5334.567048,5580,8129,29427,-3118,-387,-19050,1122,33759,26309,29040,10377,30549
20045,KS,7212,#N/A,5659,8320,4661,3699,4823,#N/A,6247.325668,5580,8246,30984,-2914,-183,-18714,1326,34374,28070,30801,12270,32310
20047,KS,5520,#N/A,5659,8320,4661,3699,4547,#N/A,5638.819921,5580,8320,28758,-3321,-590,-19385,919,32406,25437,28168,9373,29677
20049,KS,6300,#N/A,5659,8320,4661,3699,4674,#N/A,5922.78927,5580,8320,29822,-3118,-387,-19050,1122,33313,26704,29435,10772,30944
20051,KS,5568,#N/A,5659,8320,4661,3699,4554,#N/A,5902.505745,5580,8132,28881,-3321,-590,-19385,919,32461,25560,28291,9496,29800
20053,KS,5808,#N/A,5659,8320,4661,3699,4594,#N/A,5334.567048,5580,8320,28742,-3118,-387,-19050,1122,32741,25624,28355,9692,29864
20055,KS,6168,#N/A,5659,8320,4661,3699,4652,#N/A,5293.999998,5580,8692,29433,-3118,-387,-19050,1122,33159,26315,29046,10383,30555
20057,KS,6336,#N/A,5659,8320,4661,3699,4680,#N/A,5618.536396,5580,8817,30050,-2914,-183,-18714,1326,33355,27136,29867,11336,31376
20059,KS,6948,#N/A,5659,8320,4661,3699,4780,#N/A,5801.08812,5580,8234,30263,-2914,-183,-18714,1326,34067,27349,30080,11549,31589
20061,KS,7176,#N/A,5659,8320,4661,3699,4817,#N/A,5557.685821,5580,8452,30465,-2914,-183,-18714,1326,34332,27551,30282,11751,31791
20063,KS,6300,#N/A,5659,8320,4661,3699,4674,#N/A,5983.639844,5580,8320,29883,-3118,-387,-19050,1122,33313,26765,29496,10833,31005
20065,KS,6300,#N/A,5659,8320,4661,3699,4674,#N/A,5902.505745,5580,8320,29802,-3118,-387,-19050,1122,33313,26684,29415,10752,30924
20067,KS,5544,#N/A,5659,8320,4661,3699,4550,#N/A,5354.850573,5580,8320,28498,-3321,-590,-19385,919,32433,25177,27908,9113,29417
20069,KS,6096,#N/A,5659,8320,4661,3699,4641,#N/A,5395.417622,5580,8320,29090,-3118,-387,-19050,1122,33076,25972,28703,10040,30212
20071,KS,5544,#N/A,5659,8320,4661,3699,4550,#N/A,6003.923369,5580,8320,29147,-3321,-590,-19385,919,32433,25826,28557,9762,30066
20073,KS,5868,#N/A,5659,8320,4661,3699,4603,#N/A,5557.685821,5580,8320,29025,-3118,-387,-19050,1122,32810,25907,28638,9975,30147
20075,KS,6060,#N/A,5659,8320,4661,3699,4635,#N/A,5415.701147,5580,8320,29075,-3118,-387,-19050,1122,33034,25957,28688,10025,30197
20077,KS,5652,#N/A,5659,8320,4661,3699,4568,#N/A,5577.969346,5580,8320,28829,-3321,-590,-19385,919,32559,25508,28239,9444,29748
20079,KS,6672,#N/A,5659,8320,4661,3699,4735,#N/A,5882.22222,5580,8281,30115,-3118,-387,-19050,1122,33746,26997,29728,11065,31237
20081,KS,5796,#N/A,5659,8320,4661,3699,4592,#N/A,5375.134097,5580,8320,28770,-3118,-387,-19050,1122,32727,25652,28383,9720,29892
20083,KS,5520,#N/A,5659,8320,4661,3699,4547,#N/A,5395.417622,5580,8320,28514,-3321,-590,-19385,919,32406,25193,27924,9129,29433
20085,KS,6444,#N/A,5659,8320,4661,3699,4697,#N/A,5618.536396,5580,8139,29481,-3118,-387,-19050,1122,33480,26363,29094,10431,30603
20087,KS,6444,#N/A,5659,8320,4661,3699,4697,#N/A,5821.371645,5580,8142,29686,-3118,-387,-19050,1122,33480,26568,29299,10636,30808
20089,KS,6300,#N/A,5659,8320,4661,3699,4674,#N/A,5618.536396,5580,8320,29518,-3118,-387,-19050,1122,33313,26400,29131,10468,30640
20091,KS,8244,#N/A,5659,8320,4661,3699,4991,#N/A,5902.505745,5580,8402,31828,-2711,20,-18379,1529,35574,29117,31848,13449,33357
20093,KS,5544,#N/A,5659,8320,4661,3699,4550,#N/A,5253.432948,5580,8647,28723,-3118,-387,-19050,1122,32433,25605,28336,9673,29845
20095,KS,6300,#N/A,5659,8320,4661,3699,4674,#N/A,5577.969346,5580,8285,29442,-3118,-387,-19050,1122,33313,26324,29055,10392,30564
20097,KS,6300,#N/A,5659,8320,4661,3699,4674,#N/A,5638.819921,5580,8320,29538,-3118,-387,-19050,1122,33313,26420,29151,10488,30660
20099,KS,5520,#N/A,5659,8320,4661,3699,4547,#N/A,5922.78927,5580,7841,28562,-3321,-590,-19385,919,32406,25241,27972,9177,29481
20101,KS,5988,#N/A,5659,8320,4661,3699,4623,#N/A,5293.999998,5580,8320,28881,-3118,-387,-19050,1122,32950,25763,28494,9831,30003
20103,KS,8244,#N/A,5659,8320,4661,3699,4991,#N/A,5517.118772,5580,8405,31445,-2711,20,-18379,1529,35574,28734,31465,13066,32974
20105,KS,6096,#N/A,5659,8320,4661,3699,4641,#N/A,5212.865898,5580,8320,28908,-3118,-387,-19050,1122,33076,25790,28521,9858,30030
20107,KS,8244,#N/A,5659,8320,4661,3699,4991,#N/A,5679.386971,5580,8397,31600,-2711,20,-18379,1529,35574,28889,31620,13221,33129
20109,KS,5520,#N/A,5659,8320,4661,3699,4547,#N/A,5861.938695,5580,8320,28981,-3321,-590,-19385,919,32406,25660,28391,9596,29900
20111,KS,5616,#N/A,5659,8320,4661,3699,4562,#N/A,5030.314174,5580,7715,27640,-3321,-590,-19385,919,32517,24319,27050,8255,28559
20113,KS,5832,#N/A,5659,8320,4661,3699,4597,#N/A,5963.356319,5580,8321,29395,-3118,-387,-19050,1122,32768,26277,29008,10345,30517
20115,KS,5520,#N/A,5659,8320,4661,3699,4547,#N/A,5557.685821,5580,8320,28677,-3321,-590,-19385,919,32406,25356,28087,9292,29596
20117,KS,5820,#N/A,5659,8320,4661,3699,4595,#N/A,5801.08812,5580,8320,29220,-3118,-387,-19050,1122,32754,26102,28833,10170,30342
20119,KS,5520,#N/A,5659,8320,4661,3699,4547,#N/A,5435.984672,5580,8320,28555,-3321,-590,-19385,919,32406,25234,27965,9170,29474
20121,KS,8244,#N/A,5659,8320,4661,3699,4991,#N/A,6287.892718,5580,8400,32211,-2711,20,-18379,1529,35574,29500,32231,13832,33740
20123,KS,6300,#N/A,5659,8320,4661,3699,4674,#N/A,5598.252871,5580,8320,29497,-3118,-387,-19050,1122,33313,26379,29110,10447,30619
20125,KS,6000,#N/A,5659,8320,4661,3699,4625,#N/A,5922.78927,5580,7524,28726,-3321,-590,-19385,919,32964,25405,28136,9341,29645
20127,KS,6024,#N/A,5659,8320,4661,3699,4629,#N/A,5577.969346,5580,8320,29201,-3118,-387,-19050,1122,32992,26083,28814,10151,30323
20129,KS,5772,#N/A,5659,8320,4661,3699,4588,#N/A,5618.536396,5580,8320,28990,-3118,-387,-19050,1122,32699,25872,28603,9940,30112
20131,KS,5820,#N/A,5659,8320,4661,3699,4595,#N/A,5314.283523,5580,8320,28733,-3118,-387,-19050,1122,32754,25615,28346,9683,29855
20133,KS,5520,#N/A,5659,8320,4661,3699,4547,#N/A,5517.118772,5580,8320,28636,-3321,-590,-19385,919,32406,25315,28046,9251,29555
20135,KS,6300,#N/A,5659,8320,4661,3699,4674,#N/A,5496.835247,5580,8320,29396,-3118,-387,-19050,1122,33313,26278,29009,10346,30518
20137,KS,6300,#N/A,5659,8320,4661,3699,4674,#N/A,5861.938695,5580,8320,29761,-3118,-387,-19050,1122,33313,26643,29374,10711,30883
20139,KS,6444,#N/A,5659,8320,4661,3699,4697,#N/A,5598.252871,5580,8135,29456,-3118,-387,-19050,1122,33480,26338,29069,10406,30578
20141,KS,6300,#N/A,5659,8320,4661,3699,4674,#N/A,5902.505745,5580,8320,29802,-3118,-387,-19050,1122,33313,26684,29415,10752,30924
20143,KS,6168,#N/A,5659,8320,4661,3699,4652,#N/A,5253.432948,5580,8219,28919,-3118,-387,-19050,1122,33159,25801,28532,9869,30041
20145,KS,5724,#N/A,5659,8320,4661,3699,4580,#N/A,5760.52107,5580,8320,29084,-3321,-590,-19385,919,32643,25763,28494,9699,30003
20147,KS,5796,#N/A,5659,8320,4661,3699,4592,#N/A,5983.639844,5580,8320,29379,-3118,-387,-19050,1122,32727,26261,28992,10329,30501
20149,KS,7176,#N/A,5659,8320,4661,3699,4817,#N/A,5010.030649,5580,8233,29698,-2914,-183,-18714,1326,34332,26784,29515,10984,31024
20151,KS,5724,#N/A,5659,8320,4661,3699,4580,#N/A,5395.417622,5580,8320,28718,-3321,-590,-19385,919,32643,25397,28128,9333,29637
20153,KS,5520,#N/A,5659,8320,4661,3699,4547,#N/A,5882.22222,5580,8320,29001,-3321,-590,-19385,919,32406,25680,28411,9616,29920
20155,KS,5928,#N/A,5659,8320,4661,3699,4613,#N/A,5273.716473,5580,7872,28352,-3321,-590,-19385,919,32880,25031,27762,8967,29271
20157,KS,5520,#N/A,5659,8320,4661,3699,4547,#N/A,5719.954021,5580,8320,28839,-3321,-590,-19385,919,32406,25518,28249,9454,29758
20159,KS,5676,#N/A,5659,8320,4661,3699,4572,#N/A,5415.701147,5580,8320,28691,-3321,-590,-19385,919,32587,25370,28101,9306,29610
20161,KS,7176,#N/A,5659,8320,4661,3699,4817,#N/A,6470.444442,5580,8216,31141,-2914,-183,-18714,1326,34332,28227,30958,12427,32467
20163,KS,6228,#N/A,5659,8320,4661,3699,4662,#N/A,5821.371645,5580,8320,29648,-3118,-387,-19050,1122,33229,26530,29261,10598,30770
20165,KS,6300,#N/A,5659,8320,4661,3699,4674,#N/A,5719.954021,5580,8320,29619,-3118,-387,-19050,1122,33313,26501,29232,10569,30741
20167,KS,6096,#N/A,5659,8320,4661,3699,4641,#N/A,5821.371645,5580,8320,29516,-3118,-387,-19050,1122,33076,26398,29129,10466,30638
20169,KS,6348,#N/A,5659,8320,4661,3699,4682,#N/A,5212.865898,5580,8214,29053,-3118,-387,-19050,1122,33369,25935,28666,10003,30175
20171,KS,5544,#N/A,5659,8320,4661,3699,4550,#N/A,5354.850573,5580,8320,28498,-3321,-590,-19385,919,32433,25177,27908,9113,29417
20173,KS,6672,#N/A,5659,8320,4661,3699,4735,#N/A,5598.252871,5580,8285,29834,-3118,-387,-19050,1122,33746,26716,29447,10784,30956
20175,KS,7128,#N/A,5659,8320,4661,3699,4809,#N/A,5659.103446,5580,8707,30773,-2914,-183,-18714,1326,34276,27859,30590,12059,32099
20177,KS,6444,#N/A,5659,8320,4661,3699,4697,#N/A,5435.984672,5580,8099,29258,-3118,-387,-19050,1122,33480,26140,28871,10208,30380
20179,KS,5520,#N/A,5659,8320,4661,3699,4547,#N/A,5922.78927,5580,8320,29042,-3321,-590,-19385,919,32406,25721,28452,9657,29961
20181,KS,5544,#N/A,5659,8320,4661,3699,4550,#N/A,6125.624519,5580,8320,29269,-3321,-590,-19385,919,32433,25948,28679,9884,30188
20183,KS,5952,#N/A,5659,8320,4661,3699,4617,#N/A,5760.52107,5580,8320,29312,-3118,-387,-19050,1122,32908,26194,28925,10262,30434
20185,KS,5676,#N/A,5659,8320,4661,3699,4572,#N/A,5435.984672,5580,8320,28711,-3321,-590,-19385,919,32587,25390,28121,9326,29630
20187,KS,5544,#N/A,5659,8320,4661,3699,4550,#N/A,5435.984672,5580,8320,28579,-3321,-590,-19385,919,32433,25258,27989,9194,29498
20189,KS,7056,#N/A,5659,8320,4661,3699,4797,#N/A,5618.536396,5580,8320,30274,-2914,-183,-18714,1326,34192,27360,30091,11560,31600
20191,KS,5940,#N/A,5659,8320,4661,3699,4615,#N/A,5760.52107,5580,8283,29262,-3118,-387,-19050,1122,32894,26144,28875,10212,30384
20193,KS,6300,#N/A,5659,8320,4661,3699,4674,#N/A,5841.65517,5580,8320,29741,-3118,-387,-19050,1122,33313,26623,29354,10691,30863
20195,KS,5796,#N/A,5659,8320,4661,3699,4592,#N/A,5922.78927,5580,8320,29318,-3118,-387,-19050,1122,32727,26200,28931,10268,30440
20197,KS,6444,#N/A,5659,8320,4661,3699,4697,#N/A,5517.118772,5580,8145,29385,-3118,-387,-19050,1122,33480,26267,28998,10335,30507
20199,KS,5544,#N/A,5659,8320,4661,3699,4550,#N/A,5983.639844,5580,8320,29127,-3321,-590,-19385,919,32433,25806,28537,9742,30046
20201,KS,5520,#N/A,5659,8320,4661,3699,4547,#N/A,6145.908043,5580,8320,29265,-3321,-590,-19385,919,32406,25944,28675,9880,30184
20203,KS,6228,#N/A,5659,8320,4661,3699,4662,#N/A,5354.850573,5580,8320,29182,-3118,-387,-19050,1122,33229,26064,28795,10132,30304
20205,KS,5520,#N/A,5659,8320,4661,3699,4547,#N/A,5801.08812,5580,8320,28920,-3321,-590,-19385,919,32406,25599,28330,9535,29839
20207,KS,5520,#N/A,5659,8320,4661,3699,4547,#N/A,5233.149423,5580,8320,28352,-3321,-590,-19385,919,32406,25031,27762,8967,29271
20209,KS,8244,#N/A,5659,8320,4661,3699,4991,#N/A,5395.417622,5580,8402,31320,-2711,20,-18379,1529,35574,28609,31340,12941,32849
21001,KY,5016,#N/A,5540,8554,4350,3916,3975,#N/A,5063.533419,5564,8554,28114,-1286,82,-18713,1591,31351,26828,28196,9401,29705
21003,KY,5724,#N/A,5540,8554,4350,3916,4078,#N/A,5480.530289,5564,8186,28870,-1286,82,-18713,1591,32162,27584,28952,10157,30461
21005,KY,6408,#N/A,5540,8554,4350,3916,4177,#N/A,5162.818388,5564,8196,29247,-1052,316,-18347,1825,32945,28195,29563,10900,31072
21007,KY,5016,#N/A,5540,8554,4350,3916,3975,#N/A,4904.677469,5564,8094,27494,-1286,82,-18713,1591,31351,26208,27576,8781,29085
21009,KY,5016,#N/A,5540,8554,4350,3916,3975,#N/A,5222.38937,5564,7714,27433,-1521,-153,-19080,1356,31351,25912,27280,8353,28789
21011,KY,5700,#N/A,5540,8554,4350,3916,4074,#N/A,5242.246364,5564,7573,27995,-1286,82,-18713,1591,32134,26709,28077,9282,29586
21013,KY,5436,#N/A,5540,8554,4350,3916,4036,#N/A,5162.818388,5564,6960,27039,-1521,-153,-19080,1356,31832,25518,26886,7959,28395
21015,KY,6648,#N/A,5540,8554,4350,3916,4212,#N/A,5361.388326,5564,8571,30061,-817,551,-17980,2060,33220,29244,30612,12081,32121
21017,KY,6576,#N/A,5540,8554,4350,3916,4202,#N/A,5301.817345,5564,8390,29748,-1052,316,-18347,1825,33138,28696,30064,11401,31573
21019,KY,6276,#N/A,5540,8554,4350,3916,4158,#N/A,4904.677469,5564,7979,28640,-1052,316,-18347,1825,32794,27588,28956,10293,30465
21021,KY,5676,#N/A,5540,8554,4350,3916,4071,#N/A,4725.964525,5564,7522,27404,-1286,82,-18713,1591,32107,26118,27486,8691,28995
21023,KY,6648,#N/A,5540,8554,4350,3916,4212,#N/A,5262.103357,5564,8574,29964,-817,551,-17980,2060,33220,29147,30515,11984,32024
21025,KY,5724,#N/A,5540,8554,4350,3916,4078,#N/A,5281.960351,5564,8554,29040,-1052,316,-18347,1825,32162,27988,29356,10693,30865
21027,KY,5520,#N/A,5540,8554,4350,3916,4048,#N/A,5420.959308,5564,8554,28975,-1052,316,-18347,1825,31928,27923,29291,10628,30800
21029,KY,6804,#N/A,5540,8554,4350,3916,4235,#N/A,5460.673295,5564,8406,30151,-817,551,-17980,2060,33399,29334,30702,12171,32211
21031,KY,5724,#N/A,5540,8554,4350,3916,4078,#N/A,5083.390413,5564,8192,28479,-1286,82,-18713,1591,32162,27193,28561,9766,30070
21033,KY,5712,#N/A,5540,8554,4350,3916,4076,#N/A,5142.961395,5564,8554,28889,-1052,316,-18347,1825,32148,27837,29205,10542,30714
21035,KY,6348,#N/A,5540,8554,4350,3916,4168,#N/A,5420.959308,5564,7676,28925,-1052,316,-18347,1825,32876,27873,29241,10578,30750
21037,KY,6648,#N/A,5540,8554,4350,3916,4212,#N/A,5738.671209,5564,8572,30438,-817,551,-17980,2060,33220,29621,30989,12458,32498
21039,KY,6144,#N/A,5540,8554,4350,3916,4139,#N/A,4964.24845,5564,8554,29142,-1052,316,-18347,1825,32643,28090,29458,10795,30967
21041,KY,6540,#N/A,5540,8554,4350,3916,4196,#N/A,4706.107531,5564,8554,29280,-817,551,-17980,2060,33096,28463,29831,11300,31340
21043,KY,5724,#N/A,5540,8554,4350,3916,4078,#N/A,5996.812128,5564,8554,29755,-1052,316,-18347,1825,32162,28703,30071,11408,31580
21045,KY,5016,#N/A,5540,8554,4350,3916,3975,#N/A,4864.963481,5564,8554,27915,-1286,82,-18713,1591,31351,26629,27997,9202,29506
21047,KY,7056,#N/A,5540,8554,4350,3916,4271,#N/A,4984.105444,5564,8409,29929,-817,551,-17980,2060,33687,29112,30480,11949,31989
21049,KY,6576,#N/A,5540,8554,4350,3916,4202,#N/A,5301.817345,5564,8381,29739,-1052,316,-18347,1825,33138,28687,30055,11392,31564
21051,KY,5724,#N/A,5540,8554,4350,3916,4078,#N/A,5281.960351,5564,8554,29040,-1052,316,-18347,1825,32162,27988,29356,10693,30865
21053,KY,5376,#N/A,5540,8554,4350,3916,4027,#N/A,5063.533419,5564,8554,28474,-1286,82,-18713,1591,31763,27188,28556,9761,30065
21055,KY,5724,#N/A,5540,8554,4350,3916,4078,#N/A,5341.531333,5564,8554,29100,-1052,316,-18347,1825,32162,28048,29416,10753,30925
21057,KY,5460,#N/A,5540,8554,4350,3916,4040,#N/A,5162.818388,5564,8554,28657,-1052,316,-18347,1825,31860,27605,28973,10310,30482
21059,KY,5556,#N/A,5540,8554,4350,3916,4053,#N/A,5162.818388,5564,8267,28466,-1286,82,-18713,1591,31969,27180,28548,9753,30057
21061,KY,6012,#N/A,5540,8554,4350,3916,4120,#N/A,5083.390413,5564,8189,28764,-1052,316,-18347,1825,32492,27712,29080,10417,30589
21063,KY,5376,#N/A,5540,8554,4350,3916,4027,#N/A,5222.38937,5564,8554,28632,-1286,82,-18713,1591,31763,27346,28714,9919,30223
21065,KY,5304,#N/A,5540,8554,4350,3916,4017,#N/A,5262.103357,5564,8554,28600,-1286,82,-18713,1591,31681,27314,28682,9887,30191
21067,KY,6576,#N/A,5540,8554,4350,3916,4202,#N/A,5281.960351,5564,8370,29708,-1052,316,-18347,1825,33138,28656,30024,11361,31533
21069,KY,5724,#N/A,5540,8554,4350,3916,4078,#N/A,5162.818388,5564,8554,28921,-1052,316,-18347,1825,32162,27869,29237,10574,30746
21071,KY,5652,#N/A,5540,8554,4350,3916,4067,#N/A,5599.672252,5564,8554,29286,-1052,316,-18347,1825,32079,28234,29602,10939,31111
21073,KY,6516,#N/A,5540,8554,4350,3916,4193,#N/A,5440.816302,5564,8165,29602,-1052,316,-18347,1825,33069,28550,29918,11255,31427
21075,KY,5724,#N/A,5540,8554,4350,3916,4078,#N/A,5003.962438,5564,7605,27813,-1286,82,-18713,1591,32162,26527,27895,9100,29404
21077,KY,6648,#N/A,5540,8554,4350,3916,4212,#N/A,5321.674339,5564,8573,30023,-817,551,-17980,2060,33220,29206,30574,12043,32083
21079,KY,5784,#N/A,5540,8554,4350,3916,4087,#N/A,5103.247407,5564,8554,28921,-1052,316,-18347,1825,32231,27869,29237,10574,30746
21081,KY,6084,#N/A,5540,8554,4350,3916,4130,#N/A,5123.104401,5564,8573,29260,-1052,316,-18347,1825,32574,28208,29576,10913,31085
21083,KY,5220,#N/A,5540,8554,4350,3916,4005,#N/A,5162.818388,5564,7725,27588,-1521,-153,-19080,1356,31585,26067,27435,8508,28944
21085,KY,5196,#N/A,5540,8554,4350,3916,4001,#N/A,4904.677469,5564,8554,28135,-1286,82,-18713,1591,31557,26849,28217,9422,29726
21087,KY,5724,#N/A,5540,8554,4350,3916,4078,#N/A,5043.676426,5564,8554,28802,-1052,316,-18347,1825,32162,27750,29118,10455,30627
21089,KY,6276,#N/A,5540,8554,4350,3916,4158,#N/A,5698.957221,5564,7964,29419,-1052,316,-18347,1825,32794,28367,29735,11072,31244
21091,KY,5556,#N/A,5540,8554,4350,3916,4053,#N/A,5242.246364,5564,8272,28550,-1286,82,-18713,1591,31969,27264,28632,9837,30141
21093,KY,5316,#N/A,5540,8554,4350,3916,4019,#N/A,4944.391457,5564,8411,28151,-1286,82,-18713,1591,31695,26865,28233,9438,29742
21095,KY,5724,#N/A,5540,8554,4350,3916,4078,#N/A,5262.103357,5564,8554,29020,-1052,316,-18347,1825,32162,27968,29336,10673,30845
21097,KY,5316,#N/A,5540,8554,4350,3916,4019,#N/A,5301.817345,5564,8554,28652,-1286,82,-18713,1591,31695,27366,28734,9939,30243
21099,KY,5016,#N/A,5540,8554,4350,3916,3975,#N/A,4964.24845,5564,8554,28014,-1286,82,-18713,1591,31351,26728,28096,9301,29605
21101,KY,6864,#N/A,5540,8554,4350,3916,4243,#N/A,5381.24532,5564,8330,30056,-817,551,-17980,2060,33467,29239,30607,12076,32116
21103,KY,6804,#N/A,5540,8554,4350,3916,4235,#N/A,5162.818388,5564,8408,29854,-817,551,-17980,2060,33399,29037,30405,11874,31914
21105,KY,5376,#N/A,5540,8554,4350,3916,4027,#N/A,5281.960351,5564,8554,28692,-1286,82,-18713,1591,31763,27406,28774,9979,30283
21107,KY,5376,#N/A,5540,8554,4350,3916,4027,#N/A,5401.102314,5564,8061,28318,-1286,82,-18713,1591,31763,27032,28400,9605,29909
21109,KY,6396,#N/A,5540,8554,4350,3916,4175,#N/A,5043.676426,5564,8554,29474,-1052,316,-18347,1825,32931,28422,29790,11127,31299
21111,KY,6804,#N/A,5540,8554,4350,3916,4235,#N/A,5341.531333,5564,8381,30006,-817,551,-17980,2060,33399,29189,30557,12026,32066
21113,KY,6576,#N/A,5540,8554,4350,3916,4202,#N/A,5281.960351,5564,8385,29723,-1052,316,-18347,1825,33138,28671,30039,11376,31548
21115,KY,5016,#N/A,5540,8554,4350,3916,3975,#N/A,5281.960351,5564,8554,28332,-1286,82,-18713,1591,31351,27046,28414,9619,29923
21117,KY,6648,#N/A,5540,8554,4350,3916,4212,#N/A,5281.960351,5564,8573,29982,-817,551,-17980,2060,33220,29165,30533,12002,32042
21119,KY,5016,#N/A,5540,8554,4350,3916,3975,#N/A,5321.674339,5564,8554,28372,-1286,82,-18713,1591,31351,27086,28454,9659,29963
21121,KY,5016,#N/A,5540,8554,4350,3916,3975,#N/A,5103.247407,5564,7338,26937,-1521,-153,-19080,1356,31351,25416,26784,7857,28293
21123,KY,5316,#N/A,5540,8554,4350,3916,4019,#N/A,4984.105444,5564,8422,28203,-1286,82,-18713,1591,31695,26917,28285,9490,29794
21125,KY,5916,#N/A,5540,8554,4350,3916,4106,#N/A,4805.3925,5564,7342,27543,-1286,82,-18713,1591,32382,26257,27625,8830,29134
21127,KY,5220,#N/A,5540,8554,4350,3916,4005,#N/A,5103.247407,5564,8554,28357,-1286,82,-18713,1591,31585,27071,28439,9644,29948
21129,KY,5724,#N/A,5540,8554,4350,3916,4078,#N/A,4984.105444,5564,8554,28742,-1052,316,-18347,1825,32162,27690,29058,10395,30567
21131,KY,5112,#N/A,5540,8554,4350,3916,3989,#N/A,5202.532376,5564,8554,28349,-1286,82,-18713,1591,31461,27063,28431,9636,29940
21133,KY,5532,#N/A,5540,8554,4350,3916,4050,#N/A,5242.246364,5564,8554,28808,-1052,316,-18347,1825,31942,27756,29124,10461,30633
21135,KY,5016,#N/A,5540,8554,4350,3916,3975,#N/A,5023.819432,5564,8554,28074,-1286,82,-18713,1591,31351,26788,28156,9361,29665
21137,KY,5016,#N/A,5540,8554,4350,3916,3975,#N/A,4964.24845,5564,7568,27028,-1521,-153,-19080,1356,31351,25507,26875,7948,28384
21139,KY,5724,#N/A,5540,8554,4350,3916,4078,#N/A,4984.105444,5564,8088,28277,-1286,82,-18713,1591,32162,26991,28359,9564,29868
21141,KY,5520,#N/A,5540,8554,4350,3916,4048,#N/A,5003.962438,5564,8554,28558,-1052,316,-18347,1825,31928,27506,28874,10211,30383
21143,KY,5016,#N/A,5540,8554,4350,3916,3975,#N/A,5381.24532,5564,8554,28431,-1286,82,-18713,1591,31351,27145,28513,9718,30022
21145,KY,5796,#N/A,5540,8554,4350,3916,4088,#N/A,4884.820475,5564,8029,28190,-1286,82,-18713,1591,32244,26904,28272,9477,29781
21147,KY,5724,#N/A,5540,8554,4350,3916,4078,#N/A,4944.391457,5564,8554,28702,-1052,316,-18347,1825,32162,27650,29018,10355,30527
21149,KY,5556,#N/A,5540,8554,4350,3916,4053,#N/A,5202.532376,5564,8277,28515,-1286,82,-18713,1591,31969,27229,28597,9802,30106
21151,KY,5568,#N/A,5540,8554,4350,3916,4055,#N/A,5281.960351,5564,8101,28431,-1286,82,-18713,1591,31983,27145,28513,9718,30022
21153,KY,5016,#N/A,5540,8554,4350,3916,3975,#N/A,5301.817345,5564,8554,28352,-1286,82,-18713,1591,31351,27066,28434,9639,29943
21155,KY,5244,#N/A,5540,8554,4350,3916,4008,#N/A,4944.391457,5564,8554,28222,-1286,82,-18713,1591,31612,26936,28304,9509,29813
21157,KY,5520,#N/A,5540,8554,4350,3916,4048,#N/A,5381.24532,5564,8554,28935,-1052,316,-18347,1825,31928,27883,29251,10588,30760
21159,KY,5724,#N/A,5540,8554,4350,3916,4078,#N/A,5262.103357,5564,8554,29020,-1052,316,-18347,1825,32162,27968,29336,10673,30845
21161,KY,5112,#N/A,5540,8554,4350,3916,3989,#N/A,5103.247407,5564,8182,27877,-1286,82,-18713,1591,31461,26591,27959,9164,29468
21163,KY,5640,#N/A,5540,8554,4350,3916,4066,#N/A,5162.818388,5564,8418,28701,-1052,316,-18347,1825,32066,27649,29017,10354,30526
21165,KY,5724,#N/A,5540,8554,4350,3916,4078,#N/A,5202.532376,5564,7593,27999,-1286,82,-18713,1591,32162,26713,28081,9286,29590
21167,KY,5436,#N/A,5540,8554,4350,3916,4036,#N/A,5123.104401,5564,8554,28593,-1052,316,-18347,1825,31832,27541,28909,10246,30418
21169,KY,5352,#N/A,5540,8554,4350,3916,4024,#N/A,5123.104401,5564,7750,27705,-1286,82,-18713,1591,31736,26419,27787,8992,29296
21171,KY,5052,#N/A,5540,8554,4350,3916,3980,#N/A,5242.246364,5564,8554,28328,-1286,82,-18713,1591,31392,27042,28410,9615,29919
21173,KY,5856,#N/A,5540,8554,4350,3916,4097,#N/A,5182.675382,5564,7532,28051,-1286,82,-18713,1591,32313,26765,28133,9338,29642
21175,KY,5376,#N/A,5540,8554,4350,3916,4027,#N/A,5182.675382,5564,8554,28593,-1286,82,-18713,1591,31763,27307,28675,9880,30184
21177,KY,5232,#N/A,5540,8554,4350,3916,4006,#N/A,5142.961395,5564,8554,28409,-1286,82,-18713,1591,31598,27123,28491,9696,30000
21179,KY,5820,#N/A,5540,8554,4350,3916,4092,#N/A,5341.531333,5564,8294,28936,-1052,316,-18347,1825,32272,27884,29252,10589,30761
21181,KY,5016,#N/A,5540,8554,4350,3916,3975,#N/A,5202.532376,5564,8554,28253,-1286,82,-18713,1591,31351,26967,28335,9540,29844
21183,KY,5088,#N/A,5540,8554,4350,3916,3986,#N/A,5023.819432,5564,8554,28146,-1286,82,-18713,1591,31434,26860,28228,9433,29737
21185,KY,6804,#N/A,5540,8554,4350,3916,4235,#N/A,5500.387283,5564,8412,30196,-817,551,-17980,2060,33399,29379,30747,12216,32256
21187,KY,5388,#N/A,5540,8554,4350,3916,4029,#N/A,5381.24532,5564,8554,28803,-1286,82,-18713,1591,31777,27517,28885,10090,30394
21189,KY,5376,#N/A,5540,8554,4350,3916,4027,#N/A,5262.103357,5564,8554,28672,-1286,82,-18713,1591,31763,27386,28754,9959,30263
21191,KY,6648,#N/A,5540,8554,4350,3916,4212,#N/A,5381.24532,5564,8573,30082,-817,551,-17980,2060,33220,29265,30633,12102,32142
21193,KY,5724,#N/A,5540,8554,4350,3916,4078,#N/A,5361.388326,5564,8554,29119,-1052,316,-18347,1825,32162,28067,29435,10772,30944
21195,KY,6300,#N/A,5540,8554,4350,3916,4161,#N/A,5301.817345,5564,8554,29636,-1052,316,-18347,1825,32821,28584,29952,11289,31461
21197,KY,5016,#N/A,5540,8554,4350,3916,3975,#N/A,5222.38937,5564,8554,28272,-1286,82,-18713,1591,31351,26986,28354,9559,29863
21199,KY,5364,#N/A,5540,8554,4350,3916,4026,#N/A,4765.678512,5564,7467,27076,-1521,-153,-19080,1356,31750,25555,26923,7996,28432
21201,KY,6612,#N/A,5540,8554,4350,3916,4207,#N/A,5103.247407,5564,8554,29749,-817,551,-17980,2060,33179,28932,30300,11769,31809
21203,KY,5172,#N/A,5540,8554,4350,3916,3998,#N/A,4904.677469,5564,8141,27698,-1286,82,-18713,1591,31530,26412,27780,8985,29289
21205,KY,5616,#N/A,5540,8554,4350,3916,4062,#N/A,5262.103357,5564,8554,28912,-1052,316,-18347,1825,32038,27860,29228,10565,30737
21207,KY,5016,#N/A,5540,8554,4350,3916,3975,#N/A,4884.820475,5564,8554,27935,-1286,82,-18713,1591,31351,26649,28017,9222,29526
21209,KY,6576,#N/A,5540,8554,4350,3916,4202,#N/A,5520.244277,5564,8384,29960,-1052,316,-18347,1825,33138,28908,30276,11613,31785
21211,KY,6120,#N/A,5540,8554,4350,3916,4135,#N/A,5341.531333,5564,8401,29342,-1052,316,-18347,1825,32615,28290,29658,10995,31167
21213,KY,5664,#N/A,5540,8554,4350,3916,4069,#N/A,5242.246364,5564,8554,28940,-1052,316,-18347,1825,32093,27888,29256,10593,30765
21215,KY,6804,#N/A,5540,8554,4350,3916,4235,#N/A,5341.531333,5564,8409,30035,-817,551,-17980,2060,33399,29218,30586,12055,32095
21217,KY,5376,#N/A,5540,8554,4350,3916,4027,#N/A,4984.105444,5564,7558,27398,-1521,-153,-19080,1356,31763,25877,27245,8318,28754
21219,KY,5892,#N/A,5540,8554,4350,3916,4102,#N/A,5103.247407,5564,8554,29029,-1052,316,-18347,1825,32354,27977,29345,10682,30854
21221,KY,7056,#N/A,5540,8554,4350,3916,4271,#N/A,5202.532376,5564,8416,30155,-817,551,-17980,2060,33687,29338,30706,12175,32215
21223,KY,6804,#N/A,5540,8554,4350,3916,4235,#N/A,4964.24845,5564,8406,29654,-817,551,-17980,2060,33399,28837,30205,11674,31714
21225,KY,5544,#N/A,5540,8554,4350,3916,4052,#N/A,5123.104401,5564,8554,28701,-1052,316,-18347,1825,31956,27649,29017,10354,30526
21227,KY,6012,#N/A,5540,8554,4350,3916,4120,#N/A,5083.390413,5564,8144,28719,-1052,316,-18347,1825,32492,27667,29035,10372,30544
21229,KY,5724,#N/A,5540,8554,4350,3916,4078,#N/A,4984.105444,5564,8554,28742,-1052,316,-18347,1825,32162,27690,29058,10395,30567
21231,KY,5268,#N/A,5540,8554,4350,3916,4012,#N/A,5003.962438,5564,8554,28306,-1286,82,-18713,1591,31640,27020,28388,9593,29897
21233,KY,6864,#N/A,5540,8554,4350,3916,4243,#N/A,5361.388326,5564,8554,30259,-817,551,-17980,2060,33467,29442,30810,12279,32319
21235,KY,5292,#N/A,5540,8554,4350,3916,4015,#N/A,5262.103357,5564,7354,27388,-1521,-153,-19080,1356,31667,25867,27235,8308,28744
21237,KY,5772,#N/A,5540,8554,4350,3916,4085,#N/A,5023.819432,5564,8554,28830,-1052,316,-18347,1825,32217,27778,29146,10483,30655
21239,KY,6576,#N/A,5540,8554,4350,3916,4202,#N/A,5818.099184,5564,8392,30266,-1052,316,-18347,1825,33138,29214,30582,11919,32091
22001,LA,5940,#N/A,5540,8554,4839,3916,4468,#N/A,5619.529246,7796,8452,31724,-1227,-2477,-20876,-968,33257,30497,29247,10848,30756
22003,LA,6408,#N/A,5540,8554,4839,3916,4541,#N/A,5321.674339,7796,8554,31996,2568,1319,-16948,2828,33798,34564,33315,15048,34824
22005,LA,8040,#N/A,5540,8554,4839,3916,4794,#N/A,5917.384153,7796,8609,34279,2764,1515,-16620,3024,35683,37043,35794,17659,37303
22007,LA,6636,#N/A,5540,8554,4839,3916,4576,#N/A,5758.528202,7796,8554,32661,2568,1319,-16948,2828,34061,35229,33980,15713,35489
22009,LA,5904,#N/A,5540,8554,4839,3916,4463,#N/A,5262.103357,7796,8554,31432,-1227,-2477,-20876,-968,33216,30205,28955,10556,30464
22011,LA,6684,#N/A,5540,8554,4839,3916,4584,#N/A,5321.674339,7796,8327,32045,2568,1319,-16948,2828,34117,34613,33364,15097,34873
22013,LA,6444,#N/A,5540,8554,4839,3916,4546,#N/A,5540.101271,7796,8554,32250,2568,1319,-16948,2828,33839,34818,33569,15302,35078
22015,LA,7308,#N/A,5540,8554,4839,3916,4680,#N/A,5659.243233,7796,8270,32949,2568,1319,-16948,2828,34837,35517,34268,16001,35777
22017,LA,7308,#N/A,5540,8554,4839,3916,4680,#N/A,5559.958264,7796,8263,32843,2568,1319,-16948,2828,34837,35411,34162,15895,35671
22019,LA,6936,#N/A,5540,8554,4839,3916,4623,#N/A,5321.674339,7796,8289,32259,2568,1319,-16948,2828,34408,34827,33578,15311,35087
22021,LA,6444,#N/A,5540,8554,4839,3916,4546,#N/A,5301.817345,7796,8554,32012,2568,1319,-16948,2828,33839,34580,33331,15064,34840
22023,LA,6936,#N/A,5540,8554,4839,3916,4623,#N/A,5103.247407,7796,8306,32058,2568,1319,-16948,2828,34408,34626,33377,15110,34886
22025,LA,6384,#N/A,5540,8554,4839,3916,4537,#N/A,5281.960351,7796,8554,31932,2568,1319,-16948,2828,33770,34500,33251,14984,34760
22027,LA,6444,#N/A,5540,8554,4839,3916,4546,#N/A,5500.387283,7796,8554,32210,2568,1319,-16948,2828,33839,34778,33529,15262,35038
22029,LA,5652,#N/A,5540,8554,4839,3916,4423,#N/A,5520.244277,7796,7158,30043,-1423,-2673,-21204,-1164,32924,28620,27370,8839,28879
22031,LA,7308,#N/A,5540,8554,4839,3916,4680,#N/A,5401.102314,7796,8275,32696,2568,1319,-16948,2828,34837,35264,34015,15748,35524
22033,LA,8040,#N/A,5540,8554,4839,3916,4794,#N/A,5778.385196,7796,8617,34147,2764,1515,-16620,3024,35683,36911,35662,17527,37171
22035,LA,6012,#N/A,5540,8554,4839,3916,4479,#N/A,5361.388326,7796,8554,31639,-1227,-2477,-20876,-968,33340,30412,29162,10763,30671
22037,LA,8040,#N/A,5540,8554,4839,3916,4794,#N/A,5897.527159,7796,8604,34254,2764,1515,-16620,3024,35683,37018,35769,17634,37278
22039,LA,5652,#N/A,5540,8554,4839,3916,4423,#N/A,5341.531333,7796,8554,31260,-1227,-2477,-20876,-968,32924,30033,28783,10384,30292
22041,LA,5652,#N/A,5540,8554,4839,3916,4423,#N/A,5103.247407,7796,8554,31021,-1227,-2477,-20876,-968,32924,29794,28544,10145,30053
22043,LA,6468,#N/A,5540,8554,4839,3916,4550,#N/A,5639.38624,7796,8164,31983,-1227,-2477,-20876,-968,33867,30756,29506,11107,31015
22045,LA,6276,#N/A,5540,8554,4839,3916,4520,#N/A,5361.388326,7796,8446,31796,-1227,-2477,-20876,-968,33645,30569,29319,10920,30828
22047,LA,5652,#N/A,5540,8554,4839,3916,4423,#N/A,5778.385196,7796,8607,31749,-1227,-2477,-20876,-968,32924,30522,29272,10873,30781
22049,LA,6096,#N/A,5540,8554,4839,3916,4492,#N/A,5381.24532,7796,8554,31743,-1227,-2477,-20876,-968,33437,30516,29266,10867,30775
22051,LA,9180,#N/A,5540,8554,4839,3916,4971,#N/A,5837.956178,7796,8367,35097,2961,1712,-16291,3221,37000,38058,36809,18806,38318
22053,LA,6444,#N/A,5540,8554,4839,3916,4546,#N/A,5460.673295,7796,8554,32171,2568,1319,-16948,2828,33839,34739,33490,15223,34999
22055,LA,8004,#N/A,5540,8554,4839,3916,4788,#N/A,5917.384153,7796,8461,34094,2764,1515,-16620,3024,35641,36858,35609,17474,37118
22057,LA,6852,#N/A,5540,8554,4839,3916,4610,#N/A,5758.528202,7796,8608,32931,2568,1319,-16948,2828,34311,35499,34250,15983,35759
22059,LA,5760,#N/A,5540,8554,4839,3916,4440,#N/A,5142.961395,7796,8554,31169,-1227,-2477,-20876,-968,33049,29942,28692,10293,30201
22061,LA,7404,#N/A,5540,8554,4839,3916,4695,#N/A,5619.529246,7796,7736,32471,2568,1319,-16948,2828,34948,35039,33790,15523,35299
22063,LA,8040,#N/A,5540,8554,4839,3916,4794,#N/A,5420.959308,7796,8608,33781,2764,1515,-16620,3024,35683,36545,35296,17161,36805
22065,LA,5844,#N/A,5540,8554,4839,3916,4453,#N/A,5321.674339,7796,8554,31432,-1227,-2477,-20876,-968,33146,30205,28955,10556,30464
22067,LA,6204,#N/A,5540,8554,4839,3916,4509,#N/A,5123.104401,7796,7307,30346,-1423,-2673,-21204,-1164,33562,28923,27673,9142,29182
22069,LA,7356,#N/A,5540,8554,4839,3916,4688,#N/A,5639.38624,7796,7619,32326,2568,1319,-16948,2828,34893,34894,33645,15378,35154
22071,LA,9180,#N/A,5540,8554,4839,3916,4971,#N/A,6393.952004,7796,8343,35629,2961,1712,-16291,3221,37000,38590,37341,19338,38850
22073,LA,6300,#N/A,5540,8554,4839,3916,4524,#N/A,5361.388326,7796,7779,31153,-1227,-2477,-20876,-968,33673,29926,28676,10277,30185
22075,LA,9180,#N/A,5540,8554,4839,3916,4971,#N/A,5103.247407,7796,8382,34378,2961,1712,-16291,3221,37000,37339,36090,18087,37599
22077,LA,8040,#N/A,5540,8554,4839,3916,4794,#N/A,5818.099184,7796,8605,34175,2764,1515,-16620,3024,35683,36939,35690,17555,37199
22079,LA,6468,#N/A,5540,8554,4839,3916,4550,#N/A,5083.390413,7796,8129,31392,-1227,-2477,-20876,-968,33867,30165,28915,10516,30424
22081,LA,6444,#N/A,5540,8554,4839,3916,4546,#N/A,5559.958264,7796,8554,32270,2568,1319,-16948,2828,33839,34838,33589,15322,35098
22083,LA,5652,#N/A,5540,8554,4839,3916,4423,#N/A,5281.960351,7796,8554,31200,-1227,-2477,-20876,-968,32924,29973,28723,10324,30232
22085,LA,6264,#N/A,5540,8554,4839,3916,4518,#N/A,5500.387283,7796,8554,32030,2568,1319,-16948,2828,33631,34598,33349,15082,34858
22087,LA,9180,#N/A,5540,8554,4839,3916,4971,#N/A,5599.672252,7796,8383,34874,2961,1712,-16291,3221,37000,37835,36586,18583,38095
22089,LA,9180,#N/A,5540,8554,4839,3916,4971,#N/A,6115.954091,7796,8378,35386,2961,1712,-16291,3221,37000,38347,37098,19095,38607
22091,LA,8040,#N/A,5540,8554,4839,3916,4794,#N/A,5698.957221,7796,8604,34055,2764,1515,-16620,3024,35683,36819,35570,17435,37079
22093,LA,6444,#N/A,5540,8554,4839,3916,4546,#N/A,6096.097097,7796,8378,32631,2568,1319,-16948,2828,33839,35199,33950,15683,35459
22095,LA,9180,#N/A,5540,8554,4839,3916,4971,#N/A,5758.528202,7796,8369,35020,2961,1712,-16291,3221,37000,37981,36732,18729,38241
22097,LA,5652,#N/A,5540,8554,4839,3916,4423,#N/A,5301.817345,7796,7655,30321,-1423,-2673,-21204,-1164,32924,28898,27648,9117,29157
22099,LA,8004,#N/A,5540,8554,4839,3916,4788,#N/A,5738.671209,7796,8458,33912,2764,1515,-16620,3024,35641,36676,35427,17292,36936
22101,LA,6264,#N/A,5540,8554,4839,3916,4518,#N/A,5659.243233,7796,8149,31784,-1227,-2477,-20876,-968,33631,30557,29307,10908,30816
22103,LA,9180,#N/A,5540,8554,4839,3916,4971,#N/A,6036.526116,7796,8372,35301,2961,1712,-16291,3221,37000,38262,37013,19010,38522
22105,LA,8316,#N/A,5540,8554,4839,3916,4837,#N/A,5778.385196,7796,8247,34054,2764,1515,-16620,3024,36002,36818,35569,17434,37078
22107,LA,5652,#N/A,5540,8554,4839,3916,4423,#N/A,5341.531333,7796,8554,31260,-1227,-2477,-20876,-968,32924,30033,28783,10384,30292
22109,LA,6852,#N/A,5540,8554,4839,3916,4610,#N/A,5341.531333,7796,8613,32519,2568,1319,-16948,2828,34311,35087,33838,15571,35347
22111,LA,6300,#N/A,5540,8554,4839,3916,4524,#N/A,5420.959308,7796,7843,31276,-1227,-2477,-20876,-968,33673,30049,28799,10400,30308
22113,LA,6648,#N/A,5540,8554,4839,3916,4578,#N/A,5420.959308,7796,8453,32234,2568,1319,-16948,2828,34075,34802,33553,15286,35062
22115,LA,8112,#N/A,5540,8554,4839,3916,4805,#N/A,5202.532376,7796,8539,33565,2764,1515,-16620,3024,35766,36329,35080,16945,36589
22117,LA,5832,#N/A,5540,8554,4839,3916,4451,#N/A,5679.100227,7796,7330,30554,-1423,-2673,-21204,-1164,33132,29131,27881,9350,29390
22119,LA,6180,#N/A,5540,8554,4839,3916,4505,#N/A,5460.673295,7796,8257,31610,-1227,-2477,-20876,-968,33534,30383,29133,10734,30642
22121,LA,8040,#N/A,5540,8554,4839,3916,4794,#N/A,5877.670165,7796,8611,34240,2764,1515,-16620,3024,35683,37004,35755,17620,37264
22123,LA,5652,#N/A,5540,8554,4839,3916,4423,#N/A,5222.38937,7796,8554,31140,-1227,-2477,-20876,-968,32924,29913,28663,10264,30172
22125,LA,8040,#N/A,5540,8554,4839,3916,4794,#N/A,5659.243233,7796,8604,34015,2764,1515,-16620,3024,35683,36779,35530,17395,37039
22127,LA,6444,#N/A,5540,8554,4839,3916,4546,#N/A,5242.246364,7796,8554,31952,2568,1319,-16948,2828,33839,34520,33271,15004,34780
23001,ME,6900,#N/A,6434,6855,5195,3644,5652,#N/A,7241.264984,6808,6544,31138,-1280,-2085,-20616,-576,34680,29858,29053,10522,30562
23003,ME,6360,#N/A,6434,6855,5195,3644,5547,#N/A,6803.099268,6808,6855,30470,-1280,-2085,-20616,-576,34035,29190,28385,9854,29894
23005,ME,9511,#N/A,6434,6855,5195,3644,6160,#N/A,7702.492053,6808,6833,34498,2887,2082,-16053,3591,37799,37385,36580,18445,38089
23007,ME,6708,#N/A,6434,6855,5195,3644,5614,#N/A,7356.571751,6808,6855,31372,-1280,-2085,-20616,-576,34450,30092,29287,10756,30796
23009,ME,7752,#N/A,6434,6855,5195,3644,5818,#N/A,7840.860173,6808,6855,32900,-1104,-1909,-20308,-400,35698,31796,30991,12592,32500
23011,ME,7248,#N/A,6434,6855,5195,3644,5719,#N/A,7149.01957,6808,6506,31355,-1280,-2085,-20616,-576,35095,30075,29270,10739,30779
23013,ME,8604,#N/A,6434,6855,5195,3644,5983,#N/A,8232.903182,6808,6855,34144,2691,1886,-16381,3395,36715,36835,36030,17763,37539
23015,ME,8736,#N/A,6434,6855,5195,3644,6009,#N/A,8555.76213,6808,6855,34599,2691,1886,-16381,3395,36873,37290,36485,18218,37994
23017,ME,6648,#N/A,6434,6855,5195,3644,5603,#N/A,7079.83551,6808,6855,31035,-1280,-2085,-20616,-576,34379,29755,28950,10419,30459
23019,ME,7679,#N/A,6434,6855,5195,3644,5803,#N/A,7033.712803,6808,6517,31682,-1104,-1909,-20308,-400,35610,30578,29773,11374,31282
23021,ME,6576,#N/A,6434,6855,5195,3644,5589,#N/A,7425.755811,6808,6855,31309,-1280,-2085,-20616,-576,34293,30029,29224,10693,30733
23023,ME,8724,#N/A,6434,6855,5195,3644,6007,#N/A,8463.516717,6808,6840,34479,2691,1886,-16381,3395,36859,37170,36365,18098,37874
23025,ME,7116,#N/A,6434,6855,5195,3644,5694,#N/A,6733.915208,6808,6855,31157,-1280,-2085,-20616,-576,34938,29877,29072,10541,30581
23027,ME,7452,#N/A,6434,6855,5195,3644,5759,#N/A,8048.412354,6808,6855,32807,-1104,-1909,-20308,-400,35339,31703,30898,12499,32407
23029,ME,6684,#N/A,6434,6855,5195,3644,5610,#N/A,7218.20363,6808,6855,31209,-1280,-2085,-20616,-576,34422,29929,29124,10593,30633
23031,ME,8762,#N/A,6434,6855,5195,3644,6014,#N/A,7679.430699,6808,6839,33732,2691,1886,-16381,3395,36904,36423,35618,17351,37127
24001,MD,6444,#N/A,5540,8554,4996,3916,4276,#N/A,5818.099184,6020,7507,29705,-3048,-663,-19326,846,33726,26657,29042,10379,30551
24003,MD,12012,#N/A,5540,8554,4996,3916,5085,#N/A,5897.527159,6020,9234,37079,-1938,3950,-13789,5459,40103,35141,41029,23290,42538
24005,MD,12012,#N/A,5540,8554,4996,3916,5085,#N/A,5758.528202,6020,9277,36984,-1938,3950,-13789,5459,40103,35046,40934,23195,42443
24009,MD,14868,#N/A,5540,8554,4996,3916,5499,#N/A,6751.377893,6020,9679,41234,-995,4893,-12318,6402,43373,40239,46127,28916,47636
24011,MD,7908,#N/A,5540,8554,4996,3916,4489,#N/A,5619.529246,6020,8554,32018,-8209,-215,-18614,1294,35403,23809,31803,13404,33312
24013,MD,12012,#N/A,5540,8554,4996,3916,5085,#N/A,6413.808998,6020,9224,37586,-1938,3950,-13789,5459,40103,35648,41536,23797,43045
24015,MD,11304,#N/A,5540,8554,4996,3916,4982,#N/A,5500.387283,6020,9008,35748,-3069,3726,-14145,5235,39292,32679,39474,21603,40983
24017,MD,14868,#N/A,5540,8554,4996,3916,5499,#N/A,5857.813171,6020,9724,40386,-995,4893,-12318,6402,43373,39391,45279,28068,46788
24019,MD,8268,#N/A,5540,8554,4996,3916,4541,#N/A,5420.959308,6020,8147,31772,-8209,-215,-18614,1294,35815,23563,31557,13158,33066
24021,MD,14868,#N/A,5540,8554,4996,3916,5499,#N/A,5837.956178,6020,9770,40412,-995,4893,-12318,6402,43373,39417,45305,28094,46814
24023,MD,6912,#N/A,5540,8554,4996,3916,4344,#N/A,5440.816302,6020,8554,30843,-8838,-438,-18969,1071,34262,22005,30405,11874,31914
24025,MD,12012,#N/A,5540,8554,4996,3916,5085,#N/A,5957.098141,6020,9219,37124,-1938,3950,-13789,5459,40103,35186,41074,23335,42583
24027,MD,12012,#N/A,5540,8554,4996,3916,5085,#N/A,6612.378936,6020,9243,37804,-1938,3950,-13789,5459,40103,35866,41754,24015,43263
24028,MD,15684,#N/A,5540,8554,4996,3916,5618,#N/A,5540,6020,8554,39714,-1267,4622,-12721,6131,44308,38447,44336,26993,45845
24029,MD,8376,#N/A,5540,8554,4996,3916,4557,#N/A,6274.810041,6020,8554,33141,-4641,3054,-15213,4563,35939,28500,36195,17928,37704
24031,MD,14868,#N/A,5540,8554,4996,3916,5499,#N/A,6711.663905,6020,9966,41482,-995,4893,-12318,6402,43373,40487,46375,29164,47884
24033,MD,14868,#N/A,5540,8554,4996,3916,5499,#N/A,5679.100227,6020,9936,40419,-995,4893,-12318,6402,43373,39424,45312,28101,46821
24035,MD,12012,#N/A,5540,8554,4996,3916,5085,#N/A,7247.802738,6020,9179,38375,-1938,3950,-13789,5459,40103,36437,42325,24586,43834
24037,MD,12312,#N/A,5540,8554,4996,3916,5128,#N/A,5877.670165,6020,9672,37798,-1715,4174,-13433,5683,40446,36083,41972,24365,43481
24039,MD,7044,#N/A,5540,8554,4996,3916,4363,#N/A,5341.531333,6020,8413,30735,-8838,-438,-18969,1071,34413,21897,30297,11766,31806
24041,MD,9768,#N/A,5540,8554,4996,3916,4759,#N/A,6592.521942,6020,8658,34955,-4117,3278,-14857,4787,37533,30838,38233,20098,39742
24043,MD,8976,#N/A,5540,8554,4996,3916,4644,#N/A,5500.387283,6020,8499,32912,-4641,3054,-15213,4563,36626,28271,35966,17699,37475
24045,MD,7764,#N/A,5540,8554,4996,3916,4468,#N/A,5480.530289,6020,8404,31585,-8209,-215,-18614,1294,35238,23376,31370,12971,32879
24047,MD,8028,#N/A,5540,8554,4996,3916,4506,#N/A,6195.382066,6020,8412,32571,-8209,-215,-18614,1294,35540,24362,32356,13957,33865
24510,MD,12012,#N/A,5540,8554,4996,3916,5085,#N/A,6155.668079,6020,9411,37515,-1938,3950,-13789,5459,40103,35577,41465,23726,42974
25001,MA,10524,#N/A,6434,6855,5141,3644,5450,#N/A,8255.964536,6664,6812,35900,1940,4115,-13888,5624,38048,37840,40015,22012,41524
25003,MA,8136,#N/A,6434,6855,5141,3644,5051,#N/A,7886.98288,6664,6481,32812,-4144,-168,-18567,1341,35261,28668,32644,14245,34153
25005,MA,9139,#N/A,6434,6855,5141,3644,5219,#N/A,6895.344682,6664,6858,33200,284,3659,-14608,5168,36432,33484,36859,18592,38368
25007,MA,11568,#N/A,6434,6855,5141,3644,5625,#N/A,7448.817165,6664,7420,36745,2791,4342,-13529,5851,39267,39536,41087,23216,42596
25009,MA,12543,#N/A,6434,6855,5141,3644,5788,#N/A,7195.142277,6664,7458,37504,3319,4571,-13168,6080,40405,40823,42075,24336,43584
25011,MA,9030,#N/A,6434,6855,5141,3644,5201,#N/A,7379.633104,6664,6718,33435,284,3659,-14608,5168,36305,33719,37094,18827,38603
25013,MA,9132,#N/A,6434,6855,5141,3644,5218,#N/A,6595.547087,6664,6693,32729,284,3659,-14608,5168,36424,33013,36388,18121,37897
25015,MA,9132,#N/A,6434,6855,5141,3644,5218,#N/A,7587.185285,6664,6706,33734,284,3659,-14608,5168,36424,34018,37393,19126,38902
25017,MA,13343,#N/A,6434,6855,5141,3644,5922,#N/A,7448.817165,6664,7483,38583,4375,4798,-12809,6307,41339,42958,43381,25774,44890
25019,MA,15960,#N/A,6434,6855,5141,3644,6359,#N/A,7333.510398,6664,6855,40457,4831,5254,-12089,6763,44393,45288,45711,28368,47220
25021,MA,13946,#N/A,6434,6855,5141,3644,6023,#N/A,7241.264984,6664,7466,38961,4604,5027,-12448,6536,42043,43565,43988,26513,45497
25023,MA,12313,#N/A,6434,6855,5141,3644,5750,#N/A,7679.430699,6664,7415,37715,3319,4571,-13168,6080,40137,41034,42286,24547,43795
25025,MA,13968,#N/A,6434,6855,5141,3644,6026,#N/A,7886.98288,6664,7656,39819,4604,5027,-12448,6536,42068,44423,44846,27371,46355
25027,MA,8997,#N/A,6434,6855,5141,3644,5195,#N/A,7010.651449,6664,7300,33616,1111,3886,-14249,5395,36266,34727,37502,19367,39011
26001,MI,5652,#N/A,5659,8320,4428,3699,4377,#N/A,5415.701147,5748,8320,28835,-1762,49,-18614,1558,32135,27073,28884,10221,30393
26003,MI,5652,#N/A,5659,8320,4428,3699,4377,#N/A,5719.954021,5748,8320,29139,-1762,49,-18614,1558,32135,27377,29188,10525,30697
26005,MI,6840,#N/A,5659,8320,4428,3699,4565,#N/A,5496.835247,5748,8288,30072,-1542,268,-18263,1777,33511,28530,30340,11809,31849
26007,MI,6192,#N/A,5659,8320,4428,3699,4462,#N/A,5476.551722,5748,7219,28335,-1980,-170,-18965,1339,32760,26355,28165,9370,29674
26009,MI,5868,#N/A,5659,8320,4428,3699,4411,#N/A,6145.908043,5748,8320,29781,-1762,49,-18614,1558,32385,28019,29830,11167,31339
26011,MI,6252,#N/A,5659,8320,4428,3699,4472,#N/A,5253.432948,5748,8320,29272,-1762,49,-18614,1558,32830,27510,29321,10658,30830
26013,MI,5652,#N/A,5659,8320,4428,3699,4377,#N/A,5801.08812,5748,8320,29220,-1762,49,-18614,1558,32135,27458,29269,10606,30778
26015,MI,6036,#N/A,5659,8320,4428,3699,4438,#N/A,5314.283523,5748,8349,29147,-1762,49,-18614,1558,32580,27385,29196,10533,30705
26017,MI,6168,#N/A,5659,8320,4428,3699,4459,#N/A,5091.164749,5748,7871,28577,-1762,49,-18614,1558,32733,26815,28626,9963,30135
26019,MI,6924,#N/A,5659,8320,4428,3699,4578,#N/A,5679.386971,5748,8061,30112,-1542,268,-18263,1777,33608,28570,30380,11849,31889
26021,MI,6384,#N/A,5659,8320,4428,3699,4493,#N/A,5172.298848,5748,7910,28914,-1762,49,-18614,1558,32983,27152,28963,10300,30472
26023,MI,6252,#N/A,5659,8320,4428,3699,4472,#N/A,4705.777776,5748,7855,28260,-1762,49,-18614,1558,32830,26498,28309,9646,29818
26025,MI,6564,#N/A,5659,8320,4428,3699,4521,#N/A,5152.015324,5748,7834,28997,-1762,49,-18614,1558,33191,27235,29046,10383,30555
26027,MI,5832,#N/A,5659,8320,4428,3699,4406,#N/A,5618.536396,5748,8030,28927,-1980,-170,-18965,1339,32344,26947,28757,9962,30266
26029,MI,6816,#N/A,5659,8320,4428,3699,4561,#N/A,6206.758618,5748,8320,30790,-1542,268,-18263,1777,33483,29248,31058,12527,32567
26031,MI,6312,#N/A,5659,8320,4428,3699,4481,#N/A,5415.701147,5748,8320,29495,-1762,49,-18614,1558,32899,27733,29544,10881,31053
26033,MI,5856,#N/A,5659,8320,4428,3699,4410,#N/A,5557.685821,5748,7582,28442,-1980,-170,-18965,1339,32372,26462,28272,9477,29781
26035,MI,5652,#N/A,5659,8320,4428,3699,4377,#N/A,4847.76245,5748,8320,28267,-1762,49,-18614,1558,32135,26505,28316,9653,29825
26037,MI,7344,#N/A,5659,8320,4428,3699,4644,#N/A,5679.386971,5748,8112,30582,-1542,268,-18263,1777,34094,29040,30850,12319,32359
26039,MI,6108,#N/A,5659,8320,4428,3699,4449,#N/A,5476.551722,5748,8320,29352,-1762,49,-18614,1558,32663,27590,29401,10738,30910
26041,MI,5772,#N/A,5659,8320,4428,3699,4396,#N/A,5598.252871,5748,7685,28502,-1980,-170,-18965,1339,32274,26522,28332,9537,29841
26043,MI,5712,#N/A,5659,8320,4428,3699,4387,#N/A,5638.819921,5748,7752,28550,-1980,-170,-18965,1339,32205,26570,28380,9585,29889
26045,MI,7344,#N/A,5659,8320,4428,3699,4644,#N/A,5293.999998,5748,8101,30186,-1542,268,-18263,1777,34094,28644,30454,11923,31963
26047,MI,6816,#N/A,5659,8320,4428,3699,4561,#N/A,5983.639844,5748,8320,30567,-1542,268,-18263,1777,33483,29025,30835,12304,32344
26049,MI,6552,#N/A,5659,8320,4428,3699,4519,#N/A,5253.432948,5748,7699,28952,-1762,49,-18614,1558,33177,27190,29001,10338,30510
26051,MI,6444,#N/A,5659,8320,4428,3699,4502,#N/A,5801.08812,5748,8320,30012,-1762,49,-18614,1558,33052,28250,30061,11398,31570
26053,MI,5652,#N/A,5659,8320,4428,3699,4377,#N/A,5293.999998,5748,8320,28713,-1762,49,-18614,1558,32135,26951,28762,10099,30271
26055,MI,7368,#N/A,5659,8320,4428,3699,4648,#N/A,5902.505745,5748,8038,30756,-1542,268,-18263,1777,34122,29214,31024,12493,32533
26057,MI,5652,#N/A,5659,8320,4428,3699,4377,#N/A,5152.015324,5748,7608,27859,-1980,-170,-18965,1339,32135,25879,27689,8894,29198
26059,MI,6072,#N/A,5659,8320,4428,3699,4444,#N/A,4989.747124,5748,7823,28331,-1762,49,-18614,1558,32622,26569,28380,9717,29889
26061,MI,5736,#N/A,5659,8320,4428,3699,4391,#N/A,5821.371645,5748,7338,28342,-1980,-170,-18965,1339,32233,26362,28172,9377,29681
26063,MI,6324,#N/A,5659,8320,4428,3699,4483,#N/A,5253.432948,5748,8320,29344,-1762,49,-18614,1558,32913,27582,29393,10730,30902
26065,MI,7344,#N/A,5659,8320,4428,3699,4644,#N/A,5557.685821,5748,8083,30432,-1542,268,-18263,1777,34094,28890,30700,12169,32209
26067,MI,6144,#N/A,5659,8320,4428,3699,4455,#N/A,5192.582373,5748,8076,28859,-1762,49,-18614,1558,32705,27097,28908,10245,30417
26069,MI,6444,#N/A,5659,8320,4428,3699,4502,#N/A,5598.252871,5748,8320,29809,-1762,49,-18614,1558,33052,28047,29858,11195,31367
26071,MI,5652,#N/A,5659,8320,4428,3699,4377,#N/A,5354.850573,5748,8320,28774,-1762,49,-18614,1558,32135,27012,28823,10160,30332
26073,MI,7020,#N/A,5659,8320,4428,3699,4593,#N/A,5314.283523,5748,7597,29378,-1762,49,-18614,1558,33719,27616,29427,10764,30936
26075,MI,7128,#N/A,5659,8320,4428,3699,4610,#N/A,5050.597699,5748,7928,29553,-1542,268,-18263,1777,33844,28011,29821,11290,31330
26077,MI,6780,#N/A,5659,8320,4428,3699,4555,#N/A,5395.417622,5748,8021,29644,-1762,49,-18614,1558,33441,27882,29693,11030,31202
26079,MI,6360,#N/A,5659,8320,4428,3699,4489,#N/A,5659.103446,5748,8044,29510,-1762,49,-18614,1558,32955,27748,29559,10896,31068
26081,MI,7080,#N/A,5659,8320,4428,3699,4603,#N/A,5314.283523,5748,8356,30197,-1542,268,-18263,1777,33789,28655,30465,11934,31974
26083,MI,5700,#N/A,5659,8320,4428,3699,4385,#N/A,5801.08812,5748,7431,28379,-1980,-170,-18965,1339,32191,26399,28209,9414,29718
26085,MI,5652,#N/A,5659,8320,4428,3699,4377,#N/A,5111.448274,5748,8320,28530,-1762,49,-18614,1558,32135,26768,28579,9916,30088
26087,MI,7752,#N/A,5659,8320,4428,3699,4709,#N/A,5476.551722,5748,8158,30834,-1324,487,-17912,1996,34567,29510,31321,12922,32830
26089,MI,8112,#N/A,5659,8320,4428,3699,4765,#N/A,9289.854402,5748,8069,34918,-1324,487,-17912,1996,34983,33594,35405,17006,36914
26091,MI,6840,#N/A,5659,8320,4428,3699,4565,#N/A,4868.045975,5748,7997,29152,-1762,49,-18614,1558,33511,27390,29201,10538,30710
26093,MI,8988,#N/A,5659,8320,4428,3699,4903,#N/A,5476.551722,5748,8151,32062,1460,3271,-14996,4780,35997,33522,35333,17066,36842
26095,MI,5904,#N/A,5659,8320,4428,3699,4417,#N/A,5719.954021,5748,8320,29391,-1762,49,-18614,1558,32427,27629,29440,10777,30949
26097,MI,6612,#N/A,5659,8320,4428,3699,4529,#N/A,5679.386971,5748,8320,30058,-1542,268,-18263,1777,33247,28516,30326,11795,31835
26099,MI,7752,#N/A,5659,8320,4428,3699,4709,#N/A,5496.835247,5748,8132,30828,-1542,268,-18263,1777,34567,29286,31096,12565,32605
26101,MI,5676,#N/A,5659,8320,4428,3699,4381,#N/A,5699.670496,5748,8320,29143,-1762,49,-18614,1558,32163,27381,29192,10529,30701
26103,MI,6528,#N/A,5659,8320,4428,3699,4515,#N/A,5861.938695,5748,7909,29746,-1762,49,-18614,1558,33149,27984,29795,11132,31304
26105,MI,5940,#N/A,5659,8320,4428,3699,4423,#N/A,5192.582373,5748,7604,28183,-1980,-170,-18965,1339,32469,26203,28013,9218,29522
26107,MI,6444,#N/A,5659,8320,4428,3699,4502,#N/A,5152.015324,5748,7510,28553,-1762,49,-18614,1558,33052,26791,28602,9939,30111
26109,MI,5808,#N/A,5659,8320,4428,3699,4402,#N/A,6571.862066,5748,7587,29414,-1980,-170,-18965,1339,32316,27434,29244,10449,30753
26111,MI,6876,#N/A,5659,8320,4428,3699,4570,#N/A,5699.670496,5748,8109,30132,-1542,268,-18263,1777,33552,28590,30400,11869,31909
26113,MI,6444,#N/A,5659,8320,4428,3699,4502,#N/A,5557.685821,5748,7849,29298,-1762,49,-18614,1558,33052,27536,29347,10684,30856
26115,MI,7536,#N/A,5659,8320,4428,3699,4674,#N/A,5375.134097,5748,8222,30580,-1542,268,-18263,1777,34316,29038,30848,12317,32357
26117,MI,6192,#N/A,5659,8320,4428,3699,4462,#N/A,5111.448274,5748,8349,29100,-1762,49,-18614,1558,32760,27338,29149,10486,30658
26119,MI,5904,#N/A,5659,8320,4428,3699,4417,#N/A,5496.835247,5748,8320,29168,-1762,49,-18614,1558,32427,27406,29217,10554,30726
26121,MI,5664,#N/A,5659,8320,4428,3699,4379,#N/A,5070.881224,5748,7745,27927,-1980,-170,-18965,1339,32149,25947,27757,8962,29266
26123,MI,5988,#N/A,5659,8320,4428,3699,4430,#N/A,4989.747124,5748,8320,28745,-1762,49,-18614,1558,32524,26983,28794,10131,30303
26125,MI,7752,#N/A,5659,8320,4428,3699,4709,#N/A,5598.252871,5748,8134,30931,-1542,268,-18263,1777,34567,29389,31199,12668,32708
26127,MI,5916,#N/A,5659,8320,4428,3699,4419,#N/A,5415.701147,5748,8320,29099,-1762,49,-18614,1558,32441,27337,29148,10485,30657
26129,MI,5880,#N/A,5659,8320,4428,3699,4413,#N/A,5253.432948,5748,8320,28900,-1762,49,-18614,1558,32399,27138,28949,10286,30458
26131,MI,6000,#N/A,5659,8320,4428,3699,4432,#N/A,5375.134097,5748,8320,29142,-1762,49,-18614,1558,32538,27380,29191,10528,30700
26133,MI,5652,#N/A,5659,8320,4428,3699,4377,#N/A,4340.674328,5748,8320,27760,-1762,49,-18614,1558,32135,25998,27809,9146,29318
26135,MI,6072,#N/A,5659,8320,4428,3699,4444,#N/A,5476.551722,5748,8320,29316,-1762,49,-18614,1558,32622,27554,29365,10702,30874
26137,MI,5880,#N/A,5659,8320,4428,3699,4413,#N/A,5577.969346,5748,8320,29225,-1762,49,-18614,1558,32399,27463,29274,10611,30783
26139,MI,7968,#N/A,5659,8320,4428,3699,4743,#N/A,5172.298848,5748,8353,30941,-1324,487,-17912,1996,34817,29617,31428,13029,32937
26141,MI,5880,#N/A,5659,8320,4428,3699,4413,#N/A,5638.819921,5748,8320,29286,-1762,49,-18614,1558,32399,27524,29335,10672,30844
26143,MI,5880,#N/A,5659,8320,4428,3699,4413,#N/A,5334.567048,5748,8320,28982,-1762,49,-18614,1558,32399,27220,29031,10368,30540
26145,MI,6768,#N/A,5659,8320,4428,3699,4553,#N/A,5111.448274,5748,7802,29129,-1762,49,-18614,1558,33427,27367,29178,10515,30687
26147,MI,7752,#N/A,5659,8320,4428,3699,4709,#N/A,5253.432948,5748,8149,30601,-1324,487,-17912,1996,34567,29277,31088,12689,32597
26149,MI,6360,#N/A,5659,8320,4428,3699,4489,#N/A,5152.015324,5748,8020,28979,-1762,49,-18614,1558,32955,27217,29028,10365,30537
26151,MI,5652,#N/A,5659,8320,4428,3699,4377,#N/A,5111.448274,5748,8320,28530,-1762,49,-18614,1558,32135,26768,28579,9916,30088
26153,MI,5652,#N/A,5659,8320,4428,3699,4377,#N/A,5577.969346,5748,8320,28997,-1762,49,-18614,1558,32135,27235,29046,10383,30555
26155,MI,5988,#N/A,5659,8320,4428,3699,4430,#N/A,4868.045975,5748,7955,28258,-1762,49,-18614,1558,32524,26496,28307,9644,29816
26157,MI,6108,#N/A,5659,8320,4428,3699,4449,#N/A,5070.881224,5748,8320,28946,-1762,49,-18614,1558,32663,27184,28995,10332,30504
26159,MI,6780,#N/A,5659,8320,4428,3699,4555,#N/A,5395.417622,5748,8027,29649,-1762,49,-18614,1558,33441,27887,29698,11035,31207
26161,MI,9636,#N/A,5659,8320,4428,3699,5006,#N/A,5740.237546,5748,8289,33112,1678,3489,-14646,4998,36748,34790,36601,18466,38110
26163,MI,7752,#N/A,5659,8320,4428,3699,4709,#N/A,5354.850573,5748,8125,30679,-1542,268,-18263,1777,34567,29137,30947,12416,32456
26165,MI,6012,#N/A,5659,8320,4428,3699,4434,#N/A,5172.298848,5748,7821,28452,-1980,-170,-18965,1339,32552,26472,28282,9487,29791
27001,MN,7140,#N/A,5659,8320,4596,3699,5462,#N/A,5537.402297,5940,8320,30636,-4200,-526,-19057,983,34876,26436,30110,11579,31619
27003,MN,9072,#N/A,5659,8320,4596,3699,5821,#N/A,5415.701147,5940,8943,33070,-754,2920,-15215,4429,37167,32316,35990,17855,37499
27005,MN,6144,#N/A,5659,8320,4596,3699,5277,#N/A,5557.685821,5940,8320,29661,-4431,-756,-19419,753,33695,25230,28905,10242,30414
27007,MN,6156,#N/A,5659,8320,4596,3699,5279,#N/A,5476.551722,5940,7993,29265,-4431,-756,-19419,753,33709,24834,28509,9846,30018
27009,MN,7536,#N/A,5659,8320,4596,3699,5536,#N/A,6145.908043,5940,8399,31720,-3971,-296,-18695,1213,35346,27749,31424,13025,32933
27011,MN,6432,#N/A,5659,8320,4596,3699,5331,#N/A,5537.402297,5940,8320,29928,-4200,-526,-19057,983,34037,25728,29402,10871,30911
27013,MN,6756,#N/A,5659,8320,4596,3699,5391,#N/A,5435.984672,5940,8466,30297,-4200,-526,-19057,983,34421,26097,29771,11240,31280
27015,MN,6444,#N/A,5659,8320,4596,3699,5333,#N/A,5780.804595,5940,7993,29857,-4431,-756,-19419,753,34051,25426,29101,10438,30610
27017,MN,6324,#N/A,5659,8320,4596,3699,5311,#N/A,5801.08812,5940,7910,29674,-4431,-756,-19419,753,33909,25243,28918,10255,30427
27019,MN,9072,#N/A,5659,8320,4596,3699,5821,#N/A,7383.203062,5940,8926,35020,-754,2920,-15215,4429,37167,34266,37940,19805,39449
27021,MN,6528,#N/A,5659,8320,4596,3699,5349,#N/A,5293.999998,5940,7801,29262,-4431,-756,-19419,753,34151,24831,28506,9843,30015
27023,MN,6540,#N/A,5659,8320,4596,3699,5351,#N/A,5679.386971,5940,8320,30178,-4200,-526,-19057,983,34165,25978,29652,11121,31161
27025,MN,9072,#N/A,5659,8320,4596,3699,5821,#N/A,6024.206894,5940,8916,33651,-754,2920,-15215,4429,37167,32897,36571,18436,38080
27027,MN,6348,#N/A,5659,8320,4596,3699,5315,#N/A,5943.072795,5940,8345,30275,-4431,-756,-19419,753,33937,25844,29519,10856,31028
27029,MN,5652,#N/A,5659,8320,4596,3699,5186,#N/A,5557.685821,5940,8320,29169,-4431,-756,-19419,753,33112,24738,28413,9750,29922
27031,MN,7092,#N/A,5659,8320,4596,3699,5453,#N/A,5659.103446,5940,8320,30710,-4200,-526,-19057,983,34819,26510,30184,11653,31693
27033,MN,5652,#N/A,5659,8320,4596,3699,5186,#N/A,5557.685821,5940,8320,29169,-4431,-756,-19419,753,33112,24738,28413,9750,29922
27035,MN,6396,#N/A,5659,8320,4596,3699,5324,#N/A,5354.850573,5940,7758,29147,-4431,-756,-19419,753,33994,24716,28391,9728,29900
27037,MN,9072,#N/A,5659,8320,4596,3699,5821,#N/A,5922.78927,5940,8959,33593,-754,2920,-15215,4429,37167,32839,36513,18378,38022
27039,MN,7692,#N/A,5659,8320,4596,3699,5565,#N/A,5577.969346,5940,8846,31755,-3971,-296,-18695,1213,35531,27784,31459,13060,32968
27041,MN,5652,#N/A,5659,8320,4596,3699,5186,#N/A,5679.386971,5940,8043,29014,-4660,-986,-19781,523,33112,24354,28028,9233,29537
27043,MN,6012,#N/A,5659,8320,4596,3699,5253,#N/A,5517.118772,5940,8320,29488,-4431,-756,-19419,753,33539,25057,28732,10069,30241
27045,MN,6420,#N/A,5659,8320,4596,3699,5328,#N/A,5496.835247,5940,8835,30390,-4200,-526,-19057,983,34022,26190,29864,11333,31373
27047,MN,5652,#N/A,5659,8320,4596,3699,5186,#N/A,5922.78927,5940,7928,29141,-4660,-986,-19781,523,33112,24481,28155,9360,29664
27049,MN,6612,#N/A,5659,8320,4596,3699,5364,#N/A,6186.475093,5940,8330,30768,-4200,-526,-19057,983,34250,26568,30242,11711,31751
27051,MN,6444,#N/A,5659,8320,4596,3699,5333,#N/A,5679.386971,5940,8320,30082,-4200,-526,-19057,983,34051,25882,29556,11025,31065
27053,MN,9072,#N/A,5659,8320,4596,3699,5821,#N/A,5983.639844,5940,8998,33692,-754,2920,-15215,4429,37167,32938,36612,18477,38121
27055,MN,6240,#N/A,5659,8320,4596,3699,5295,#N/A,5456.268197,5940,8292,29627,-4431,-756,-19419,753,33809,25196,28871,10208,30380
27057,MN,5652,#N/A,5659,8320,4596,3699,5186,#N/A,5638.819921,5940,8320,29250,-4431,-756,-19419,753,33112,24819,28494,9831,30003
27059,MN,9072,#N/A,5659,8320,4596,3699,5821,#N/A,5801.08812,5940,8922,33434,-754,2920,-15215,4429,37167,32680,36354,18219,37863
27061,MN,6624,#N/A,5659,8320,4596,3699,5366,#N/A,5577.969346,5940,8320,30161,-4200,-526,-19057,983,34264,25961,29635,11104,31144
27063,MN,5928,#N/A,5659,8320,4596,3699,5237,#N/A,5456.268197,5940,8320,29343,-4431,-756,-19419,753,33439,24912,28587,9924,30096
27065,MN,6828,#N/A,5659,8320,4596,3699,5404,#N/A,5577.969346,5940,8320,30365,-4200,-526,-19057,983,34506,26165,29839,11308,31348
27067,MN,5832,#N/A,5659,8320,4596,3699,5219,#N/A,5659.103446,5940,8215,29345,-4431,-756,-19419,753,33325,24914,28589,9926,30098
27069,MN,6444,#N/A,5659,8320,4596,3699,5333,#N/A,5659.103446,5940,8320,30062,-4200,-526,-19057,983,34051,25862,29536,11005,31045
27071,MN,5652,#N/A,5659,8320,4596,3699,5186,#N/A,5537.402297,5940,8320,29148,-4431,-756,-19419,753,33112,24717,28392,9729,29901
27073,MN,5652,#N/A,5659,8320,4596,3699,5186,#N/A,5659.103446,5940,8320,29270,-4431,-756,-19419,753,33112,24839,28514,9851,30023
27075,MN,5724,#N/A,5659,8320,4596,3699,5199,#N/A,5699.670496,5940,8320,29383,-4431,-756,-19419,753,33197,24952,28627,9964,30136
27077,MN,5652,#N/A,5659,8320,4596,3699,5186,#N/A,5537.402297,5940,8320,29148,-4431,-756,-19419,753,33112,24717,28392,9729,29901
27079,MN,6312,#N/A,5659,8320,4596,3699,5308,#N/A,5517.118772,5940,8916,30384,-4200,-526,-19057,983,33894,26184,29858,11327,31367
27081,MN,6444,#N/A,5659,8320,4596,3699,5333,#N/A,5861.938695,5940,8320,30265,-4200,-526,-19057,983,34051,26065,29739,11208,31248
27083,MN,5784,#N/A,5659,8320,4596,3699,5210,#N/A,5801.08812,5940,8255,29479,-4431,-756,-19419,753,33268,25048,28723,10060,30232
27085,MN,6132,#N/A,5659,8320,4596,3699,5275,#N/A,5861.938695,5940,8335,29968,-4431,-756,-19419,753,33681,25537,29212,10549,30721
27087,MN,5652,#N/A,5659,8320,4596,3699,5186,#N/A,5679.386971,5940,8320,29290,-4431,-756,-19419,753,33112,24859,28534,9871,30043
27089,MN,6096,#N/A,5659,8320,4596,3699,5268,#N/A,5577.969346,5940,8320,29633,-4431,-756,-19419,753,33638,25202,28877,10214,30386
27091,MN,5904,#N/A,5659,8320,4596,3699,5233,#N/A,5719.954021,5940,8320,29583,-4431,-756,-19419,753,33411,25152,28827,10164,30336
27093,MN,7440,#N/A,5659,8320,4596,3699,5518,#N/A,5801.08812,5940,8320,31200,-3971,-296,-18695,1213,35232,27229,30904,12505,32413
27095,MN,6708,#N/A,5659,8320,4596,3699,5382,#N/A,5557.685821,5940,8916,30821,-4200,-526,-19057,983,34364,26621,30295,11764,31804
27097,MN,5880,#N/A,5659,8320,4596,3699,5228,#N/A,5679.386971,5940,8320,29518,-4431,-756,-19419,753,33382,25087,28762,10099,30271
27099,MN,6384,#N/A,5659,8320,4596,3699,5322,#N/A,4928.89655,5940,8075,29027,-4431,-756,-19419,753,33980,24596,28271,9608,29780
27101,MN,6444,#N/A,5659,8320,4596,3699,5333,#N/A,5476.551722,5940,8320,29880,-4200,-526,-19057,983,34051,25680,29354,10823,30863
27103,MN,6756,#N/A,5659,8320,4596,3699,5391,#N/A,6328.459768,5940,8464,31187,-4200,-526,-19057,983,34421,26987,30661,12130,32170
27105,MN,6444,#N/A,5659,8320,4596,3699,5333,#N/A,5131.731799,5940,8341,29556,-4200,-526,-19057,983,34051,25356,29030,10499,30539
27107,MN,5676,#N/A,5659,8320,4596,3699,5190,#N/A,5699.670496,5940,8320,29335,-4431,-756,-19419,753,33140,24904,28579,9916,30088
27109,MN,7692,#N/A,5659,8320,4596,3699,5565,#N/A,5577.969346,5940,8865,31774,-3971,-296,-18695,1213,35531,27803,31478,13079,32987
27111,MN,6084,#N/A,5659,8320,4596,3699,5266,#N/A,5699.670496,5940,7971,29394,-4431,-756,-19419,753,33624,24963,28638,9975,30147
27113,MN,5652,#N/A,5659,8320,4596,3699,5186,#N/A,5577.969346,5940,8320,29189,-4431,-756,-19419,753,33112,24758,28433,9770,29942
27115,MN,6732,#N/A,5659,8320,4596,3699,5386,#N/A,5740.237546,5940,8320,30431,-4200,-526,-19057,983,34392,26231,29905,11374,31414
27117,MN,6444,#N/A,5659,8320,4596,3699,5333,#N/A,5496.835247,5940,8320,29900,-4200,-526,-19057,983,34051,25700,29374,10843,30883
27119,MN,6492,#N/A,5659,8320,4596,3699,5342,#N/A,5780.804595,5940,8168,30080,-4431,-756,-19419,753,34108,25649,29324,10661,30833
27121,MN,6192,#N/A,5659,8320,4596,3699,5286,#N/A,5659.103446,5940,8320,29810,-4431,-756,-19419,753,33752,25379,29054,10391,30563
27123,MN,9072,#N/A,5659,8320,4596,3699,5821,#N/A,5922.78927,5940,9001,33634,-754,2920,-15215,4429,37167,32880,36554,18419,38063
27125,MN,5928,#N/A,5659,8320,4596,3699,5237,#N/A,5760.52107,5940,8320,29648,-4431,-756,-19419,753,33439,25217,28892,10229,30401
27127,MN,5652,#N/A,5659,8320,4596,3699,5186,#N/A,5719.954021,5940,8320,29331,-4431,-756,-19419,753,33112,24900,28575,9912,30084
27129,MN,6396,#N/A,5659,8320,4596,3699,5324,#N/A,5760.52107,5940,8320,30116,-4200,-526,-19057,983,33994,25916,29590,11059,31099
27131,MN,7536,#N/A,5659,8320,4596,3699,5536,#N/A,5476.551722,5940,8359,31011,-3971,-296,-18695,1213,35346,27040,30715,12316,32224
27133,MN,5652,#N/A,5659,8320,4596,3699,5186,#N/A,5456.268197,5940,8320,29067,-4431,-756,-19419,753,33112,24636,28311,9648,29820
27135,MN,5652,#N/A,5659,8320,4596,3699,5186,#N/A,5577.969346,5940,8320,29189,-4431,-756,-19419,753,33112,24758,28433,9770,29942
27137,MN,6324,#N/A,5659,8320,4596,3699,5311,#N/A,5679.386971,5940,7875,29518,-4431,-756,-19419,753,33909,25087,28762,10099,30271
27139,MN,9072,#N/A,5659,8320,4596,3699,5821,#N/A,5557.685821,5940,8927,33195,-754,2920,-15215,4429,37167,32441,36115,17980,37624
27141,MN,9072,#N/A,5659,8320,4596,3699,5821,#N/A,5314.283523,5940,8897,32922,-754,2920,-15215,4429,37167,32168,35842,17707,37351
27143,MN,6012,#N/A,5659,8320,4596,3699,5253,#N/A,5821.371645,5940,8909,30382,-4200,-526,-19057,983,33539,26182,29856,11325,31365
27145,MN,7536,#N/A,5659,8320,4596,3699,5536,#N/A,5679.386971,5940,8398,31252,-3971,-296,-18695,1213,35346,27281,30956,12557,32465
27147,MN,6960,#N/A,5659,8320,4596,3699,5429,#N/A,5963.356319,5940,8441,31003,-4200,-526,-19057,983,34663,26803,30477,11946,31986
27149,MN,6096,#N/A,5659,8320,4596,3699,5268,#N/A,5638.819921,5940,8320,29694,-4431,-756,-19419,753,33638,25263,28938,10275,30447
27151,MN,5652,#N/A,5659,8320,4596,3699,5186,#N/A,5638.819921,5940,8320,29250,-4431,-756,-19419,753,33112,24819,28494,9831,30003
27153,MN,6336,#N/A,5659,8320,4596,3699,5313,#N/A,5659.103446,5940,8320,29954,-4431,-756,-19419,753,33923,25523,29198,10535,30707
27155,MN,5652,#N/A,5659,8320,4596,3699,5186,#N/A,5679.386971,5940,8320,29290,-4431,-756,-19419,753,33112,24859,28534,9871,30043
27157,MN,6132,#N/A,5659,8320,4596,3699,5275,#N/A,5963.356319,5940,8849,30583,-4200,-526,-19057,983,33681,26383,30057,11526,31566
27159,MN,6420,#N/A,5659,8320,4596,3699,5328,#N/A,5476.551722,5940,8320,29856,-4200,-526,-19057,983,34022,25656,29330,10799,30839
27161,MN,5724,#N/A,5659,8320,4596,3699,5199,#N/A,5577.969346,5940,8320,29261,-4431,-756,-19419,753,33197,24830,28505,9842,30014
27163,MN,9072,#N/A,5659,8320,4596,3699,5821,#N/A,5902.505745,5940,8929,33543,-754,2920,-15215,4429,37167,32789,36463,18328,37972
27165,MN,5688,#N/A,5659,8320,4596,3699,5193,#N/A,5537.402297,5940,8320,29184,-4431,-756,-19419,753,33155,24753,28428,9765,29937
27167,MN,5760,#N/A,5659,8320,4596,3699,5206,#N/A,5719.954021,5940,8163,29282,-4431,-756,-19419,753,33240,24851,28526,9863,30035
27169,MN,5916,#N/A,5659,8320,4596,3699,5235,#N/A,6247.325668,5940,8307,30109,-4431,-756,-19419,753,33425,25678,29353,10690,30862
27171,MN,9072,#N/A,5659,8320,4596,3699,5821,#N/A,6287.892718,5940,8921,33920,-754,2920,-15215,4429,37167,33166,36840,18705,38349
27173,MN,5748,#N/A,5659,8320,4596,3699,5204,#N/A,5719.954021,5940,8320,29427,-4431,-756,-19419,753,33226,24996,28671,10008,30180
28001,MS,6216,#N/A,5540,8554,4881,3916,4517,#N/A,5679.100227,6620,8554,30985,31,-1397,-19928,112,33624,31016,29588,11057,31097
28003,MS,6216,#N/A,5540,8554,4881,3916,4517,#N/A,5738.671209,6620,8554,31045,31,-1397,-19928,112,33624,31076,29648,11117,31157
28005,MS,6216,#N/A,5540,8554,4881,3916,4517,#N/A,5877.670165,6620,8554,31184,31,-1397,-19928,112,33624,31215,29787,11256,31296
28007,MS,6216,#N/A,5540,8554,4881,3916,4517,#N/A,6135.811085,6620,8554,31442,31,-1397,-19928,112,33624,31473,30045,11514,31554
28009,MS,6216,#N/A,5540,8554,4881,3916,4517,#N/A,5738.671209,6620,8554,31045,31,-1397,-19928,112,33624,31076,29648,11117,31157
28011,MS,5520,#N/A,5540,8554,4881,3916,4409,#N/A,5857.813171,6620,8554,30468,31,-1397,-19928,112,32820,30499,29071,10540,30580
28013,MS,5544,#N/A,5540,8554,4881,3916,4413,#N/A,5877.670165,6620,8554,30512,31,-1397,-19928,112,32848,30543,29115,10584,30624
28015,MS,8772,#N/A,5540,8554,4881,3916,4914,#N/A,5837.956178,6620,8554,33700,4309,2881,-15254,4390,36577,38009,36581,18446,38090
28017,MS,5448,#N/A,5540,8554,4881,3916,4398,#N/A,5698.957221,6620,8554,30237,31,-1397,-19928,112,32737,30268,28840,10309,30349
28019,MS,5856,#N/A,5540,8554,4881,3916,4462,#N/A,5937.241147,6620,8554,30883,31,-1397,-19928,112,33209,30914,29486,10955,30995
28021,MS,6216,#N/A,5540,8554,4881,3916,4517,#N/A,5679.100227,6620,8554,30985,31,-1397,-19928,112,33624,31016,29588,11057,31097
28023,MS,6216,#N/A,5540,8554,4881,3916,4517,#N/A,5619.529246,6620,8554,30926,31,-1397,-19928,112,33624,30957,29529,10998,31038
28025,MS,5832,#N/A,5540,8554,4881,3916,4458,#N/A,5639.38624,6620,8554,30561,31,-1397,-19928,112,33181,30592,29164,10633,30673
28027,MS,6480,#N/A,5540,8554,4881,3916,4558,#N/A,5698.957221,6620,8554,31269,257,-1171,-19570,338,33929,31526,30098,11699,31607
28029,MS,7668,#N/A,5540,8554,4881,3916,4743,#N/A,5540.101271,6620,8554,32298,4083,2655,-15612,4164,35302,36381,34953,16686,36462
28031,MS,6060,#N/A,5540,8554,4881,3916,4493,#N/A,5619.529246,6620,8554,30770,31,-1397,-19928,112,33444,30801,29373,10842,30882
28033,MS,7896,#N/A,5540,8554,4881,3916,4778,#N/A,5500.387283,6620,8554,32486,4083,2655,-15612,4164,35565,36569,35141,16874,36650
28035,MS,6720,#N/A,5540,8554,4881,3916,4596,#N/A,5857.813171,6620,8554,31668,257,-1171,-19570,338,34207,31925,30497,12098,32006
28037,MS,5448,#N/A,5540,8554,4881,3916,4398,#N/A,5579.815258,6620,8554,30118,31,-1397,-19928,112,32737,30149,28721,10190,30230
28039,MS,7824,#N/A,5540,8554,4881,3916,4767,#N/A,5639.38624,6620,8554,32553,4083,2655,-15612,4164,35482,36636,35208,16941,36717
28041,MS,5748,#N/A,5540,8554,4881,3916,4445,#N/A,5917.384153,6620,8554,30755,31,-1397,-19928,112,33084,30786,29358,10827,30867
28043,MS,6156,#N/A,5540,8554,4881,3916,4508,#N/A,5917.384153,6620,8554,31163,31,-1397,-19928,112,33555,31194,29766,11235,31275
28045,MS,8268,#N/A,5540,8554,4881,3916,4836,#N/A,5976.955134,6620,8554,33335,4083,2655,-15612,4164,35995,37418,35990,17723,37499
28047,MS,8268,#N/A,5540,8554,4881,3916,4836,#N/A,5758.528202,6620,8554,33117,4083,2655,-15612,4164,35995,37200,35772,17505,37281
28049,MS,7668,#N/A,5540,8554,4881,3916,4743,#N/A,5718.814215,6620,8554,32477,4083,2655,-15612,4164,35302,36560,35132,16865,36641
28051,MS,6216,#N/A,5540,8554,4881,3916,4517,#N/A,6294.667035,6620,8554,31601,31,-1397,-19928,112,33624,31632,30204,11673,31713
28053,MS,5448,#N/A,5540,8554,4881,3916,4398,#N/A,5758.528202,6620,8554,30297,31,-1397,-19928,112,32737,30328,28900,10369,30409
28055,MS,9576,#N/A,5540,8554,4881,3916,5039,#N/A,5718.814215,6620,8554,34385,4536,3108,-14895,4617,37506,38921,37493,19490,39002
28057,MS,6216,#N/A,5540,8554,4881,3916,4517,#N/A,5579.815258,6620,8554,30886,31,-1397,-19928,112,33624,30917,29489,10958,30998
28059,MS,7824,#N/A,5540,8554,4881,3916,4767,#N/A,6096.097097,6620,8554,33010,4083,2655,-15612,4164,35482,37093,35665,17398,37174
28061,MS,6216,#N/A,5540,8554,4881,3916,4517,#N/A,5599.672252,6620,8554,30906,31,-1397,-19928,112,33624,30937,29509,10978,31018
28063,MS,5448,#N/A,5540,8554,4881,3916,4398,#N/A,5698.957221,6620,8554,30237,31,-1397,-19928,112,32737,30268,28840,10309,30349
28065,MS,5616,#N/A,5540,8554,4881,3916,4424,#N/A,5559.958264,6620,8554,30266,31,-1397,-19928,112,32931,30297,28869,10338,30378
28067,MS,8304,#N/A,5540,8554,4881,3916,4841,#N/A,5579.815258,6620,8554,32974,4083,2655,-15612,4164,36036,37057,35629,17362,37138
28069,MS,5700,#N/A,5540,8554,4881,3916,4437,#N/A,5738.671209,6620,8554,30529,31,-1397,-19928,112,33028,30560,29132,10601,30641
28071,MS,7704,#N/A,5540,8554,4881,3916,4748,#N/A,6671.949917,6620,8554,33466,4083,2655,-15612,4164,35343,37549,36121,17854,37630
28073,MS,6720,#N/A,5540,8554,4881,3916,4596,#N/A,5579.815258,6620,8554,31390,257,-1171,-19570,338,34207,31647,30219,11820,31728
28075,MS,6216,#N/A,5540,8554,4881,3916,4517,#N/A,5619.529246,6620,8554,30926,31,-1397,-19928,112,33624,30957,29529,10998,31038
28077,MS,6792,#N/A,5540,8554,4881,3916,4607,#N/A,5659.243233,6620,8554,31541,257,-1171,-19570,338,34290,31798,30370,11971,31879
28079,MS,6276,#N/A,5540,8554,4881,3916,4527,#N/A,5440.816302,6620,8554,30807,31,-1397,-19928,112,33694,30838,29410,10879,30919
28081,MS,6216,#N/A,5540,8554,4881,3916,4517,#N/A,5520.244277,6620,8554,30826,31,-1397,-19928,112,33624,30857,29429,10898,30938
28083,MS,6096,#N/A,5540,8554,4881,3916,4499,#N/A,5957.098141,6620,8554,31143,31,-1397,-19928,112,33486,31174,29746,11215,31255
28085,MS,5448,#N/A,5540,8554,4881,3916,4398,#N/A,5778.385196,6620,8554,30316,31,-1397,-19928,112,32737,30347,28919,10388,30428
28087,MS,6696,#N/A,5540,8554,4881,3916,4592,#N/A,5897.527159,6620,8554,31684,257,-1171,-19570,338,34179,31941,30513,12114,32022
28089,MS,7668,#N/A,5540,8554,4881,3916,4743,#N/A,6572.664948,6620,8554,33331,4083,2655,-15612,4164,35302,37414,35986,17719,37495
28091,MS,5796,#N/A,5540,8554,4881,3916,4452,#N/A,5619.529246,6620,8554,30506,31,-1397,-19928,112,33139,30537,29109,10578,30618
28093,MS,5448,#N/A,5540,8554,4881,3916,4398,#N/A,5659.243233,6620,8554,30197,31,-1397,-19928,112,32737,30228,28800,10269,30309
28095,MS,5556,#N/A,5540,8554,4881,3916,4415,#N/A,5500.387283,6620,8554,30146,31,-1397,-19928,112,32862,30177,28749,10218,30258
28097,MS,6060,#N/A,5540,8554,4881,3916,4493,#N/A,5818.099184,6620,8554,30968,31,-1397,-19928,112,33444,30999,29571,11040,31080
28099,MS,6096,#N/A,5540,8554,4881,3916,4499,#N/A,5619.529246,6620,8554,30806,31,-1397,-19928,112,33486,30837,29409,10878,30918
28101,MS,5820,#N/A,5540,8554,4881,3916,4456,#N/A,5639.38624,6620,8554,30549,31,-1397,-19928,112,33167,30580,29152,10621,30661
28103,MS,6216,#N/A,5540,8554,4881,3916,4517,#N/A,5857.813171,6620,8554,31164,31,-1397,-19928,112,33624,31195,29767,11236,31276
28105,MS,7200,#N/A,5540,8554,4881,3916,4670,#N/A,6076.240103,6620,8554,32366,257,-1171,-19570,338,34761,32623,31195,12796,32704
28107,MS,6360,#N/A,5540,8554,4881,3916,4540,#N/A,5778.385196,6620,8554,31228,31,-1397,-19928,112,33791,31259,29831,11300,31340
28109,MS,6000,#N/A,5540,8554,4881,3916,4484,#N/A,5778.385196,6620,8554,30868,31,-1397,-19928,112,33375,30899,29471,10940,30980
28111,MS,6720,#N/A,5540,8554,4881,3916,4596,#N/A,5619.529246,6620,8554,31430,257,-1171,-19570,338,34207,31687,30259,11860,31768
28113,MS,5796,#N/A,5540,8554,4881,3916,4452,#N/A,5440.816302,6620,8554,30327,31,-1397,-19928,112,33139,30358,28930,10399,30439
28115,MS,5448,#N/A,5540,8554,4881,3916,4398,#N/A,5857.813171,6620,8554,30396,31,-1397,-19928,112,32737,30427,28999,10468,30508
28117,MS,5796,#N/A,5540,8554,4881,3916,4452,#N/A,5520.244277,6620,8554,30406,31,-1397,-19928,112,33139,30437,29009,10478,30518
28119,MS,6216,#N/A,5540,8554,4881,3916,4517,#N/A,5639.38624,6620,8554,30945,31,-1397,-19928,112,33624,30976,29548,11017,31057
28121,MS,7668,#N/A,5540,8554,4881,3916,4743,#N/A,5758.528202,6620,8554,32517,4083,2655,-15612,4164,35302,36600,35172,16905,36681
28123,MS,6204,#N/A,5540,8554,4881,3916,4516,#N/A,5559.958264,6620,8554,30854,31,-1397,-19928,112,33611,30885,29457,10926,30966
28125,MS,6216,#N/A,5540,8554,4881,3916,4517,#N/A,5718.814215,6620,8554,31025,31,-1397,-19928,112,33624,31056,29628,11097,31137
28127,MS,6216,#N/A,5540,8554,4881,3916,4517,#N/A,5679.100227,6620,8554,30985,31,-1397,-19928,112,33624,31016,29588,11057,31097
28129,MS,6216,#N/A,5540,8554,4881,3916,4517,#N/A,5698.957221,6620,8554,31005,31,-1397,-19928,112,33624,31036,29608,11077,31117
28131,MS,8268,#N/A,5540,8554,4881,3916,4836,#N/A,5976.955134,6620,8554,33335,4083,2655,-15612,4164,35995,37418,35990,17723,37499
28133,MS,5448,#N/A,5540,8554,4881,3916,4398,#N/A,5937.241147,6620,8554,30475,31,-1397,-19928,112,32737,30506,29078,10547,30587
28135,MS,6216,#N/A,5540,8554,4881,3916,4517,#N/A,5837.956178,6620,8554,31144,31,-1397,-19928,112,33624,31175,29747,11216,31256
28137,MS,6300,#N/A,5540,8554,4881,3916,4530,#N/A,5440.816302,6620,8554,30831,31,-1397,-19928,112,33721,30862,29434,10903,30943
28139,MS,6216,#N/A,5540,8554,4881,3916,4517,#N/A,5897.527159,6620,8554,31204,31,-1397,-19928,112,33624,31235,29807,11276,31316
28141,MS,5544,#N/A,5540,8554,4881,3916,4413,#N/A,5480.530289,6620,8554,30115,31,-1397,-19928,112,32848,30146,28718,10187,30227
28143,MS,6156,#N/A,5540,8554,4881,3916,4508,#N/A,5540.101271,6620,8554,30786,31,-1397,-19928,112,33555,30817,29389,10858,30898
28145,MS,6216,#N/A,5540,8554,4881,3916,4517,#N/A,5599.672252,6620,8554,30906,31,-1397,-19928,112,33624,30937,29509,10978,31018
28147,MS,7560,#N/A,5540,8554,4881,3916,4726,#N/A,5679.100227,6620,8554,32329,4083,2655,-15612,4164,35177,36412,34984,16717,36493
28149,MS,6432,#N/A,5540,8554,4881,3916,4551,#N/A,5778.385196,6620,8554,31300,257,-1171,-19570,338,33874,31557,30129,11730,31638
28151,MS,5892,#N/A,5540,8554,4881,3916,4467,#N/A,5639.38624,6620,8554,30621,31,-1397,-19928,112,33250,30652,29224,10693,30733
28153,MS,5448,#N/A,5540,8554,4881,3916,4398,#N/A,5897.527159,6620,8554,30436,31,-1397,-19928,112,32737,30467,29039,10508,30548
28155,MS,6216,#N/A,5540,8554,4881,3916,4517,#N/A,5937.241147,6620,8554,31243,31,-1397,-19928,112,33624,31274,29846,11315,31355
28157,MS,5496,#N/A,5540,8554,4881,3916,4406,#N/A,5857.813171,6620,8554,30444,31,-1397,-19928,112,32793,30475,29047,10516,30556
28159,MS,6060,#N/A,5540,8554,4881,3916,4493,#N/A,5818.099184,6620,8554,30968,31,-1397,-19928,112,33444,30999,29571,11040,31080
28161,MS,6216,#N/A,5540,8554,4881,3916,4517,#N/A,6115.954091,6620,8554,31422,31,-1397,-19928,112,33624,31453,30025,11494,31534
28163,MS,5928,#N/A,5540,8554,4881,3916,4473,#N/A,6155.668079,6620,8554,31174,31,-1397,-19928,112,33292,31205,29777,11246,31286
29001,MO,5976,#N/A,5659,8320,4531,3699,3811,#N/A,4928.89655,7044,7261,28909,-4072,-2310,-20973,-801,31996,24837,26599,7936,28108
29003,MO,6684,#N/A,5659,8320,4531,3699,3906,#N/A,5152.015324,7044,8120,30699,-3719,-1957,-20356,-448,32799,26980,28742,10343,30251
29005,MO,5304,#N/A,5659,8320,4531,3699,3720,#N/A,5537.402297,7044,8320,29904,-3895,-2133,-20664,-624,31233,26009,27771,9240,29280
29007,MO,5832,#N/A,5659,8320,4531,3699,3791,#N/A,4766.628351,7044,7928,29269,-3895,-2133,-20664,-624,31832,25374,27136,8605,28645
29009,MO,6036,#N/A,5659,8320,4531,3699,3819,#N/A,5496.835247,7044,8320,30596,-3895,-2133,-20664,-624,32064,26701,28463,9932,29972
29011,MO,5472,#N/A,5659,8320,4531,3699,3742,#N/A,5091.164749,7044,8320,29626,-3895,-2133,-20664,-624,31423,25731,27493,8962,29002
29013,MO,5724,#N/A,5659,8320,4531,3699,3776,#N/A,5375.134097,7044,8400,30242,-3895,-2133,-20664,-624,31709,26347,28109,9578,29618
29015,MO,5364,#N/A,5659,8320,4531,3699,3728,#N/A,5192.582373,7044,8320,29620,-3895,-2133,-20664,-624,31301,25725,27487,8956,28996
29017,MO,6024,#N/A,5659,8320,4531,3699,3817,#N/A,5415.701147,7044,8038,30220,-3895,-2133,-20664,-624,32050,26325,28087,9556,29596
29019,MO,6432,#N/A,5659,8320,4531,3699,3872,#N/A,5861.938695,7044,8202,31239,-3719,-1957,-20356,-448,32513,27520,29282,10883,30791
29021,MO,6684,#N/A,5659,8320,4531,3699,3906,#N/A,5010.030649,7044,8102,30539,-3719,-1957,-20356,-448,32799,26820,28582,10183,30091
29023,MO,5484,#N/A,5659,8320,4531,3699,3744,#N/A,4908.613025,7044,7355,28491,-4072,-2310,-20973,-801,31437,24419,26181,7518,27690
29025,MO,8244,#N/A,5659,8320,4531,3699,4117,#N/A,5618.536396,7044,8398,33004,233,1995,-16140,3504,34570,33237,34999,16864,36508
29027,MO,5484,#N/A,5659,8320,4531,3699,3744,#N/A,5719.954021,7044,8202,30149,-3895,-2133,-20664,-624,31437,26254,28016,9485,29525
29029,MO,6324,#N/A,5659,8320,4531,3699,3858,#N/A,5983.639844,7044,8320,31371,-3719,-1957,-20356,-448,32391,27652,29414,11015,30923
29031,MO,6024,#N/A,5659,8320,4531,3699,3817,#N/A,5273.716473,7044,7998,30038,-3895,-2133,-20664,-624,32050,26143,27905,9374,29414
29033,MO,5568,#N/A,5659,8320,4531,3699,3755,#N/A,5091.164749,7044,8320,29722,-3895,-2133,-20664,-624,31532,25827,27589,9058,29098
29035,MO,6036,#N/A,5659,8320,4531,3699,3819,#N/A,4928.89655,7044,8320,30028,-3895,-2133,-20664,-624,32064,26133,27895,9364,29404
29037,MO,8244,#N/A,5659,8320,4531,3699,4117,#N/A,5456.268197,7044,8403,32847,233,1995,-16140,3504,34570,33080,34842,16707,36351
29039,MO,5292,#N/A,5659,8320,4531,3699,3718,#N/A,5111.448274,7044,8320,29466,-3895,-2133,-20664,-624,31219,25571,27333,8802,28842
29041,MO,5292,#N/A,5659,8320,4531,3699,3718,#N/A,4989.747124,7044,8320,29345,-3895,-2133,-20664,-624,31219,25450,27212,8681,28721
29043,MO,5796,#N/A,5659,8320,4531,3699,3786,#N/A,5841.65517,7044,7919,30299,-3895,-2133,-20664,-624,31791,26404,28166,9635,29675
29045,MO,5532,#N/A,5659,8320,4531,3699,3751,#N/A,4766.628351,7044,7895,28937,-4072,-2310,-20973,-801,31492,24865,26627,7964,28136
29047,MO,8244,#N/A,5659,8320,4531,3699,4117,#N/A,5537.402297,7044,8401,32926,233,1995,-16140,3504,34570,33159,34921,16786,36430
29049,MO,8244,#N/A,5659,8320,4531,3699,4117,#N/A,5943.072795,7044,8400,33331,233,1995,-16140,3504,34570,33564,35326,17191,36835
29051,MO,5664,#N/A,5659,8320,4531,3699,3768,#N/A,5435.984672,7044,8194,30037,-3895,-2133,-20664,-624,31641,26142,27904,9373,29413
29053,MO,5472,#N/A,5659,8320,4531,3699,3742,#N/A,5415.701147,7044,8320,29951,-3895,-2133,-20664,-624,31423,26056,27818,9287,29327
29055,MO,5796,#N/A,5659,8320,4531,3699,3786,#N/A,5922.78927,7044,8320,30782,-3895,-2133,-20664,-624,31791,26887,28649,10118,30158
29056,MO,7572,#N/A,5659,8320,4531,3699,4026,#N/A,5659,7044,8320,32294,57,1819,-16448,3328,33807,32351,34113,15846,35622
29057,MO,5484,#N/A,5659,8320,4531,3699,3744,#N/A,5334.567048,7044,8320,29882,-3895,-2133,-20664,-624,31437,25987,27749,9218,29258
29059,MO,5904,#N/A,5659,8320,4531,3699,3801,#N/A,5395.417622,7044,7934,29976,-3895,-2133,-20664,-624,31914,26081,27843,9312,29352
29061,MO,5364,#N/A,5659,8320,4531,3699,3728,#N/A,5517.118772,7044,8320,29944,-3895,-2133,-20664,-624,31301,26049,27811,9280,29320
29063,MO,6684,#N/A,5659,8320,4531,3699,3906,#N/A,5091.164749,7044,8103,30621,-3719,-1957,-20356,-448,32799,26902,28664,10265,30173
29065,MO,5376,#N/A,5659,8320,4531,3699,3729,#N/A,5293.999998,7044,8320,29733,-3895,-2133,-20664,-624,31314,25838,27600,9069,29109
29067,MO,6036,#N/A,5659,8320,4531,3699,3819,#N/A,5456.268197,7044,8320,30555,-3895,-2133,-20664,-624,32064,26660,28422,9891,29931
29069,MO,5292,#N/A,5659,8320,4531,3699,3718,#N/A,4685.494251,7044,7088,27808,-4248,-2486,-21281,-977,31219,23560,25322,6527,26831
29071,MO,7572,#N/A,5659,8320,4531,3699,4026,#N/A,5030.314174,7044,8275,31620,57,1819,-16448,3328,33807,31677,33439,15172,34948
29073,MO,5532,#N/A,5659,8320,4531,3699,3751,#N/A,5131.731799,7044,8320,29727,-3895,-2133,-20664,-624,31492,25832,27594,9063,29103
29075,MO,5292,#N/A,5659,8320,4531,3699,3718,#N/A,5131.731799,7044,8320,29487,-3895,-2133,-20664,-624,31219,25592,27354,8823,28863
29077,MO,5796,#N/A,5659,8320,4531,3699,3786,#N/A,5456.268197,7044,7898,29893,-3895,-2133,-20664,-624,31791,25998,27760,9229,29269
29079,MO,5976,#N/A,5659,8320,4531,3699,3811,#N/A,5476.551722,7044,8320,30516,-3895,-2133,-20664,-624,31996,26621,28383,9852,29892
29081,MO,5640,#N/A,5659,8320,4531,3699,3765,#N/A,5517.118772,7044,8320,30220,-3895,-2133,-20664,-624,31614,26325,28087,9556,29596
29083,MO,5688,#N/A,5659,8320,4531,3699,3772,#N/A,4665.210726,7044,8320,29416,-3895,-2133,-20664,-624,31669,25521,27283,8752,28792
29085,MO,5292,#N/A,5659,8320,4531,3699,3718,#N/A,5050.597699,7044,8320,29406,-3895,-2133,-20664,-624,31219,25511,27273,8742,28782
29087,MO,5292,#N/A,5659,8320,4531,3699,3718,#N/A,5233.149423,7044,8320,29588,-3895,-2133,-20664,-624,31219,25693,27455,8924,28964
29089,MO,6432,#N/A,5659,8320,4531,3699,3872,#N/A,5598.252871,7044,8320,31093,-3719,-1957,-20356,-448,32513,27374,29136,10737,30645
29091,MO,5460,#N/A,5659,8320,4531,3699,3741,#N/A,4847.76245,7044,7295,28346,-4072,-2310,-20973,-801,31410,24274,26036,7373,27545
29093,MO,6036,#N/A,5659,8320,4531,3699,3819,#N/A,5293.999998,7044,8320,30393,-3895,-2133,-20664,-624,32064,26498,28260,9729,29769
29095,MO,8244,#N/A,5659,8320,4531,3699,4117,#N/A,5334.567048,7044,8405,32726,233,1995,-16140,3504,34570,32959,34721,16586,36230
29097,MO,5556,#N/A,5659,8320,4531,3699,3754,#N/A,5050.597699,7044,7969,29319,-4072,-2310,-20973,-801,31519,25247,27009,8346,28518
29099,MO,7572,#N/A,5659,8320,4531,3699,4026,#N/A,5618.536396,7044,8273,32206,57,1819,-16448,3328,33807,32263,34025,15758,35534
29101,MO,6096,#N/A,5659,8320,4531,3699,3827,#N/A,5111.448274,7044,8134,30085,-3895,-2133,-20664,-624,32132,26190,27952,9421,29461
29103,MO,5424,#N/A,5659,8320,4531,3699,3736,#N/A,4989.747124,7044,8320,29477,-3895,-2133,-20664,-624,31369,25582,27344,8813,28853
29105,MO,6036,#N/A,5659,8320,4531,3699,3819,#N/A,4726.061301,7044,7568,29073,-3895,-2133,-20664,-624,32064,25178,26940,8409,28449
29107,MO,8244,#N/A,5659,8320,4531,3699,4117,#N/A,6125.624519,7044,8402,33514,233,1995,-16140,3504,34570,33747,35509,17374,37018
29109,MO,5460,#N/A,5659,8320,4531,3699,3741,#N/A,5537.402297,7044,8320,30060,-3895,-2133,-20664,-624,31410,26165,27927,9396,29436
29111,MO,5292,#N/A,5659,8320,4531,3699,3718,#N/A,4989.747124,7044,8040,29065,-4072,-2310,-20973,-801,31219,24993,26755,8092,28264
29113,MO,7572,#N/A,5659,8320,4531,3699,4026,#N/A,5050.597699,7044,8276,31642,57,1819,-16448,3328,33807,31699,33461,15194,34970
29115,MO,5292,#N/A,5659,8320,4531,3699,3718,#N/A,5050.597699,7044,8320,29406,-3895,-2133,-20664,-624,31219,25511,27273,8742,28782
29117,MO,5700,#N/A,5659,8320,4531,3699,3773,#N/A,5496.835247,7044,8320,30260,-3895,-2133,-20664,-624,31682,26365,28127,9596,29636
29119,MO,5328,#N/A,5659,8320,4531,3699,3723,#N/A,5861.938695,7044,8233,30166,-4072,-2310,-20973,-801,31260,26094,27856,9193,29365
29121,MO,5292,#N/A,5659,8320,4531,3699,3718,#N/A,4949.180075,7044,8320,29304,-3895,-2133,-20664,-624,31219,25409,27171,8640,28680
29123,MO,5544,#N/A,5659,8320,4531,3699,3752,#N/A,5354.850573,7044,8320,29962,-3895,-2133,-20664,-624,31505,26067,27829,9298,29338
29125,MO,6036,#N/A,5659,8320,4531,3699,3819,#N/A,5395.417622,7044,8320,30494,-3895,-2133,-20664,-624,32064,26599,28361,9830,29870
29127,MO,5496,#N/A,5659,8320,4531,3699,3746,#N/A,4827.478925,7044,7931,28998,-4072,-2310,-20973,-801,31451,24926,26688,8025,28197
29129,MO,5292,#N/A,5659,8320,4531,3699,3718,#N/A,4989.747124,7044,8320,29345,-3895,-2133,-20664,-624,31219,25450,27212,8681,28721
29131,MO,5856,#N/A,5659,8320,4531,3699,3794,#N/A,6044.490419,7044,8320,30963,-3895,-2133,-20664,-624,31859,27068,28830,10299,30339
29133,MO,5292,#N/A,5659,8320,4531,3699,3718,#N/A,5050.597699,7044,8320,29406,-3895,-2133,-20664,-624,31219,25511,27273,8742,28782
29135,MO,5796,#N/A,5659,8320,4531,3699,3786,#N/A,5679.386971,7044,8206,30425,-3895,-2133,-20664,-624,31791,26530,28292,9761,29801
29137,MO,5292,#N/A,5659,8320,4531,3699,3718,#N/A,4786.911875,7044,8320,29142,-3895,-2133,-20664,-624,31219,25247,27009,8478,28518
29139,MO,5556,#N/A,5659,8320,4531,3699,3754,#N/A,5010.030649,7044,8320,29629,-3895,-2133,-20664,-624,31519,25734,27496,8965,29005
29141,MO,5484,#N/A,5659,8320,4531,3699,3744,#N/A,5638.819921,7044,8320,30186,-3895,-2133,-20664,-624,31437,26291,28053,9522,29562
29143,MO,5760,#N/A,5659,8320,4531,3699,3781,#N/A,5131.731799,7044,8320,29955,-3895,-2133,-20664,-624,31750,26060,27822,9291,29331
29145,MO,5556,#N/A,5659,8320,4531,3699,3754,#N/A,4969.4636,7044,7990,29258,-4072,-2310,-20973,-801,31519,25186,26948,8285,28457
29147,MO,5736,#N/A,5659,8320,4531,3699,3778,#N/A,5679.386971,7044,7548,29707,-4072,-2310,-20973,-801,31723,25635,27397,8734,28906
29149,MO,6036,#N/A,5659,8320,4531,3699,3819,#N/A,5050.597699,7044,8320,30150,-3895,-2133,-20664,-624,32064,26255,28017,9486,29526
29151,MO,5664,#N/A,5659,8320,4531,3699,3768,#N/A,5638.819921,7044,8210,30256,-3895,-2133,-20664,-624,31641,26361,28123,9592,29632
29153,MO,6036,#N/A,5659,8320,4531,3699,3819,#N/A,5496.835247,7044,8320,30596,-3895,-2133,-20664,-624,32064,26701,28463,9932,29972
29155,MO,5616,#N/A,5659,8320,4531,3699,3762,#N/A,5070.881224,7044,8320,29750,-3895,-2133,-20664,-624,31587,25855,27617,9086,29126
29157,MO,5388,#N/A,5659,8320,4531,3699,3731,#N/A,5314.283523,7044,8320,29765,-3895,-2133,-20664,-624,31328,25870,27632,9101,29141
29159,MO,5868,#N/A,5659,8320,4531,3699,3796,#N/A,4888.3295,7044,7631,29130,-4072,-2310,-20973,-801,31873,25058,26820,8157,28329
29161,MO,5628,#N/A,5659,8320,4531,3699,3764,#N/A,5030.314174,7044,7835,29236,-4072,-2310,-20973,-801,31601,25164,26926,8263,28435
29163,MO,5292,#N/A,5659,8320,4531,3699,3718,#N/A,5010.030649,7044,8320,29365,-3895,-2133,-20664,-624,31219,25470,27232,8701,28741
29165,MO,8244,#N/A,5659,8320,4531,3699,4117,#N/A,6713.846741,7044,8400,34101,233,1995,-16140,3504,34570,34334,36096,17961,37605
29167,MO,5292,#N/A,5659,8320,4531,3699,3718,#N/A,4786.911875,7044,7925,28747,-4072,-2310,-20973,-801,31219,24675,26437,7774,27946
29169,MO,7380,#N/A,5659,8320,4531,3699,4000,#N/A,5537.402297,7044,8105,31766,-3719,-1957,-20356,-448,33589,28047,29809,11410,31318
29171,MO,5664,#N/A,5659,8320,4531,3699,3768,#N/A,4807.1954,7044,8320,29534,-3895,-2133,-20664,-624,31641,25639,27401,8870,28910
29173,MO,6036,#N/A,5659,8320,4531,3699,3819,#N/A,5030.314174,7044,7967,29777,-3895,-2133,-20664,-624,32064,25882,27644,9113,29153
29175,MO,5628,#N/A,5659,8320,4531,3699,3764,#N/A,4746.344826,7044,7453,28571,-4072,-2310,-20973,-801,31601,24499,26261,7598,27770
29177,MO,8244,#N/A,5659,8320,4531,3699,4117,#N/A,5598.252871,7044,8399,32984,233,1995,-16140,3504,34570,33217,34979,16844,36488
29179,MO,5700,#N/A,5659,8320,4531,3699,3773,#N/A,5456.268197,7044,8320,30219,-3895,-2133,-20664,-624,31682,26324,28086,9555,29595
29181,MO,5292,#N/A,5659,8320,4531,3699,3718,#N/A,5050.597699,7044,8320,29406,-3895,-2133,-20664,-624,31219,25511,27273,8742,28782
29183,MO,7572,#N/A,5659,8320,4531,3699,4026,#N/A,5699.670496,7044,8269,32284,57,1819,-16448,3328,33807,32341,34103,15836,35612
29185,MO,5868,#N/A,5659,8320,4531,3699,3796,#N/A,4928.89655,7044,8320,29860,-3895,-2133,-20664,-624,31873,25965,27727,9196,29236
29186,MO,5352,#N/A,5659,8320,4531,3699,3726,#N/A,5517.118772,7044,8320,29932,-3895,-2133,-20664,-624,31287,26037,27799,9268,29308
29187,MO,5832,#N/A,5659,8320,4531,3699,3791,#N/A,5212.865898,7044,7190,28978,-4072,-2310,-20973,-801,31832,24906,26668,8005,28177
29189,MO,7572,#N/A,5659,8320,4531,3699,4026,#N/A,5801.08812,7044,8264,32380,57,1819,-16448,3328,33807,32437,34199,15932,35708
29195,MO,5292,#N/A,5659,8320,4531,3699,3718,#N/A,4644.927201,7044,7599,28279,-4072,-2310,-20973,-801,31219,24207,25969,7306,27478
29197,MO,5292,#N/A,5659,8320,4531,3699,3718,#N/A,4888.3295,7044,7358,28281,-4072,-2310,-20973,-801,31219,24209,25971,7308,27480
29199,MO,5292,#N/A,5659,8320,4531,3699,3718,#N/A,5233.149423,7044,8320,29588,-3895,-2133,-20664,-624,31219,25693,27455,8924,28964
29201,MO,5460,#N/A,5659,8320,4531,3699,3741,#N/A,5983.639844,7044,7963,30149,-4072,-2310,-20973,-801,31410,26077,27839,9176,29348
29203,MO,5292,#N/A,5659,8320,4531,3699,3718,#N/A,5010.030649,7044,8320,29365,-3895,-2133,-20664,-624,31219,25470,27232,8701,28741
29205,MO,5292,#N/A,5659,8320,4531,3699,3718,#N/A,4827.478925,7044,8320,29182,-3895,-2133,-20664,-624,31219,25287,27049,8518,28558
29207,MO,5352,#N/A,5659,8320,4531,3699,3726,#N/A,5760.52107,7044,8320,30176,-3895,-2133,-20664,-624,31287,26281,28043,9512,29552
29209,MO,5904,#N/A,5659,8320,4531,3699,3801,#N/A,5740.237546,7044,7442,29829,-4072,-2310,-20973,-801,31914,25757,27519,8856,29028
29211,MO,5568,#N/A,5659,8320,4531,3699,3755,#N/A,5212.865898,7044,8320,29844,-3895,-2133,-20664,-624,31532,25949,27711,9180,29220
29213,MO,6384,#N/A,5659,8320,4531,3699,3866,#N/A,5963.356319,7044,7410,30500,-3895,-2133,-20664,-624,32459,26605,28367,9836,29876
29215,MO,5292,#N/A,5659,8320,4531,3699,3718,#N/A,5598.252871,7044,8320,29953,-3895,-2133,-20664,-624,31219,26058,27820,9289,29329
29217,MO,5544,#N/A,5659,8320,4531,3699,3752,#N/A,5598.252871,7044,8320,30205,-3895,-2133,-20664,-624,31505,26310,28072,9541,29581
29219,MO,7572,#N/A,5659,8320,4531,3699,4026,#N/A,4847.76245,7044,8276,31439,57,1819,-16448,3328,33807,31496,33258,14991,34767
29221,MO,6036,#N/A,5659,8320,4531,3699,3819,#N/A,5719.954021,7044,8320,30819,-3895,-2133,-20664,-624,32064,26924,28686,10155,30195
29223,MO,6036,#N/A,5659,8320,4531,3699,3819,#N/A,5152.015324,7044,8320,30251,-3895,-2133,-20664,-624,32064,26356,28118,9587,29627
29225,MO,5796,#N/A,5659,8320,4531,3699,3786,#N/A,5537.402297,7044,7919,29995,-3895,-2133,-20664,-624,31791,26100,27862,9331,29371
29227,MO,5292,#N/A,5659,8320,4531,3699,3718,#N/A,5557.685821,7044,8320,29913,-3895,-2133,-20664,-624,31219,26018,27780,9249,29289
29229,MO,5292,#N/A,5659,8320,4531,3699,3718,#N/A,5091.164749,7044,8320,29446,-3895,-2133,-20664,-624,31219,25551,27313,8782,28822
29510,MO,7572,#N/A,5659,8320,4531,3699,4026,#N/A,5557.685821,7044,8253,32125,57,1819,-16448,3328,33807,32182,33944,15677,35453
30001,MT,5652,#N/A,6612,7382,4360,3971,3783,#N/A,6825.415088,7586,7382,31416,-7706,-2701,-21100,-1192,31760,23710,28715,10316,30224
30003,MT,6444,#N/A,6612,7382,4360,3971,3890,#N/A,6635.820225,7586,7382,32019,-7706,-2701,-21100,-1192,32659,24313,29318,10919,30827
30005,MT,5652,#N/A,6612,7382,4360,3971,3783,#N/A,6896.513162,7586,7382,31488,-7706,-2701,-21100,-1192,31760,23782,28787,10388,30296
30007,MT,5820,#N/A,6612,7382,4360,3971,3805,#N/A,6778.016372,7586,7382,31537,-7706,-2701,-21100,-1192,31950,23831,28836,10437,30345
30009,MT,6204,#N/A,6612,7382,4360,3971,3857,#N/A,6612.120867,7586,7306,31680,-7706,-2701,-21100,-1192,32386,23974,28979,10580,30488
30011,MT,6288,#N/A,6612,7382,4360,3971,3869,#N/A,6896.513162,7586,7382,32124,-7706,-2701,-21100,-1192,32482,24418,29423,11024,30932
30013,MT,5964,#N/A,6612,7382,4360,3971,3825,#N/A,6398.826645,7586,7073,30993,-7706,-2701,-21100,-1192,32114,23287,28292,9893,29801
30015,MT,6444,#N/A,6612,7382,4360,3971,3890,#N/A,6493.624077,7586,7382,31877,-7706,-2701,-21100,-1192,32659,24171,29176,10777,30685
30017,MT,6408,#N/A,6612,7382,4360,3971,3885,#N/A,6683.218941,7586,7382,32030,-7706,-2701,-21100,-1192,32618,24324,29329,10930,30838
30019,MT,5892,#N/A,6612,7382,4360,3971,3815,#N/A,7512.696469,7586,7382,32344,-7706,-2701,-21100,-1192,32032,24638,29643,11244,31152
30021,MT,5736,#N/A,6612,7382,4360,3971,3794,#N/A,7252.003531,7586,7382,31927,-7706,-2701,-21100,-1192,31855,24221,29226,10827,30735
30023,MT,6444,#N/A,6612,7382,4360,3971,3890,#N/A,6896.513162,7586,7382,32280,-7706,-2701,-21100,-1192,32659,24574,29579,11180,31088
30025,MT,6288,#N/A,6612,7382,4360,3971,3869,#N/A,7086.108026,7586,7382,32313,-7706,-2701,-21100,-1192,32482,24607,29612,11213,31121
30027,MT,6204,#N/A,6612,7382,4360,3971,3857,#N/A,6683.218941,7586,7382,31826,-7706,-2701,-21100,-1192,32386,24120,29125,10726,30634
30029,MT,7140,#N/A,6612,7382,4360,3971,3984,#N/A,6517.323435,7586,7084,32298,-3931,1075,-17192,2584,33449,28367,33373,15106,34882
30031,MT,7152,#N/A,6612,7382,4360,3971,3985,#N/A,6754.317014,7586,7316,32779,-3931,1075,-17192,2584,33462,28848,33854,15587,35363
30033,MT,5892,#N/A,6612,7382,4360,3971,3815,#N/A,6612.120867,7586,7382,31443,-7706,-2701,-21100,-1192,32032,23737,28742,10343,30251
30035,MT,6444,#N/A,6612,7382,4360,3971,3890,#N/A,6635.820225,7586,7382,32019,-7706,-2701,-21100,-1192,32659,24313,29318,10919,30827
30037,MT,6492,#N/A,6612,7382,4360,3971,3896,#N/A,6588.421509,7586,7313,31951,-7706,-2701,-21100,-1192,32713,24245,29250,10851,30759
30039,MT,5676,#N/A,6612,7382,4360,3971,3786,#N/A,6896.513162,7586,7382,31512,-7706,-2701,-21100,-1192,31787,23806,28811,10412,30320
30041,MT,5760,#N/A,6612,7382,4360,3971,3797,#N/A,6801.71573,7586,7382,31501,-7706,-2701,-21100,-1192,31882,23795,28800,10401,30309
30043,MT,6540,#N/A,6612,7382,4360,3971,3903,#N/A,6778.016372,7586,7347,32222,-3931,1075,-17192,2584,32768,28291,33297,15030,34806
30045,MT,6444,#N/A,6612,7382,4360,3971,3890,#N/A,6588.421509,7586,7382,31971,-7706,-2701,-21100,-1192,32659,24265,29270,10871,30779
30047,MT,6444,#N/A,6612,7382,4360,3971,3890,#N/A,7678.591974,7586,7382,33062,-7706,-2701,-21100,-1192,32659,25356,30361,11962,31870
30049,MT,6216,#N/A,6612,7382,4360,3971,3859,#N/A,6706.918299,7586,7340,31819,-7706,-2701,-21100,-1192,32400,24113,29118,10719,30627
30051,MT,5892,#N/A,6612,7382,4360,3971,3815,#N/A,6469.924719,7586,7382,31301,-7706,-2701,-21100,-1192,32032,23595,28600,10201,30109
30053,MT,6444,#N/A,6612,7382,4360,3971,3890,#N/A,6612.120867,7586,7382,31995,-7706,-2701,-21100,-1192,32659,24289,29294,10895,30803
30055,MT,5892,#N/A,6612,7382,4360,3971,3815,#N/A,7228.304173,7586,7382,32059,-7706,-2701,-21100,-1192,32032,24353,29358,10959,30867
30057,MT,7056,#N/A,6612,7382,4360,3971,3972,#N/A,6849.114446,7586,7382,32844,-3931,1075,-17192,2584,33353,28913,33919,15652,35428
30059,MT,5652,#N/A,6612,7382,4360,3971,3783,#N/A,6730.617656,7586,7382,31322,-7706,-2701,-21100,-1192,31760,23616,28621,10222,30130
30061,MT,6348,#N/A,6612,7382,4360,3971,3877,#N/A,6659.519583,7586,7382,31947,-7706,-2701,-21100,-1192,32550,24241,29246,10847,30755
30063,MT,8112,#N/A,6612,7382,4360,3971,4115,#N/A,6849.114446,7586,7160,33678,-3755,1251,-16884,2760,34552,29923,34929,16794,36438
30065,MT,5652,#N/A,6612,7382,4360,3971,3783,#N/A,6541.022793,7586,7382,31132,-7706,-2701,-21100,-1192,31760,23426,28431,10032,29940
30067,MT,6648,#N/A,6612,7382,4360,3971,3917,#N/A,6659.519583,7586,7382,32247,-3931,1075,-17192,2584,32890,28316,33322,15055,34831
30069,MT,5892,#N/A,6612,7382,4360,3971,3815,#N/A,6541.022793,7586,7382,31372,-7706,-2701,-21100,-1192,32032,23666,28671,10272,30180
30071,MT,6012,#N/A,6612,7382,4360,3971,3831,#N/A,6943.911878,7586,7382,31895,-7706,-2701,-21100,-1192,32168,24189,29194,10795,30703
30073,MT,6444,#N/A,6612,7382,4360,3971,3890,#N/A,6469.924719,7586,7382,31853,-7706,-2701,-21100,-1192,32659,24147,29152,10753,30661
30075,MT,5892,#N/A,6612,7382,4360,3971,3815,#N/A,6967.611236,7586,7382,31799,-7706,-2701,-21100,-1192,32032,24093,29098,10699,30607
30077,MT,6444,#N/A,6612,7382,4360,3971,3890,#N/A,6754.317014,7586,7382,32137,-7706,-2701,-21100,-1192,32659,24431,29436,11037,30945
30079,MT,6444,#N/A,6612,7382,4360,3971,3890,#N/A,7228.304173,7586,7382,32611,-7706,-2701,-21100,-1192,32659,24905,29910,11511,31419
30081,MT,6120,#N/A,6612,7382,4360,3971,3846,#N/A,8057.781701,7586,7382,33117,-7706,-2701,-21100,-1192,32291,25411,30416,12017,31925
30083,MT,6444,#N/A,6612,7382,4360,3971,3890,#N/A,7560.095185,7586,7382,32943,-7706,-2701,-21100,-1192,32659,25237,30242,11843,31751
30085,MT,5652,#N/A,6612,7382,4360,3971,3783,#N/A,7773.389406,7586,7382,32364,-7706,-2701,-21100,-1192,31760,24658,29663,11264,31172
30087,MT,5652,#N/A,6612,7382,4360,3971,3783,#N/A,6635.820225,7586,7382,31227,-7706,-2701,-21100,-1192,31760,23521,28526,10127,30035
30089,MT,5688,#N/A,6612,7382,4360,3971,3787,#N/A,6659.519583,7586,7382,31287,-7706,-2701,-21100,-1192,31800,23581,28586,10187,30095
30091,MT,6444,#N/A,6612,7382,4360,3971,3890,#N/A,7797.088764,7586,7382,33180,-7706,-2701,-21100,-1192,32659,25474,30479,12080,31988
30093,MT,5652,#N/A,6612,7382,4360,3971,3783,#N/A,7180.905457,7586,6550,30940,-7882,-2877,-21408,-1368,31760,23058,28063,9532,29572
30095,MT,5652,#N/A,6612,7382,4360,3971,3783,#N/A,6612.120867,7586,7382,31203,-7706,-2701,-21100,-1192,31760,23497,28502,10103,30011
30097,MT,6492,#N/A,6612,7382,4360,3971,3896,#N/A,6635.820225,7586,7382,32067,-3931,1075,-17192,2584,32713,28136,33142,14875,34651
30099,MT,5952,#N/A,6612,7382,4360,3971,3823,#N/A,6683.218941,7586,7382,31574,-7706,-2701,-21100,-1192,32100,23868,28873,10474,30382
30101,MT,6444,#N/A,6612,7382,4360,3971,3890,#N/A,6469.924719,7586,7382,31853,-7706,-2701,-21100,-1192,32659,24147,29152,10753,30661
30103,MT,5892,#N/A,6612,7382,4360,3971,3815,#N/A,6541.022793,7586,7382,31372,-7706,-2701,-21100,-1192,32032,23666,28671,10272,30180
30105,MT,6444,#N/A,6612,7382,4360,3971,3890,#N/A,7512.696469,7586,7382,32896,-7706,-2701,-21100,-1192,32659,25190,30195,11796,31704
30107,MT,5892,#N/A,6612,7382,4360,3971,3815,#N/A,6635.820225,7586,7382,31467,-7706,-2701,-21100,-1192,32032,23761,28766,10367,30275
30109,MT,5892,#N/A,6612,7382,4360,3971,3815,#N/A,7583.794542,7586,7382,32415,-7706,-2701,-21100,-1192,32032,24709,29714,11315,31223
30111,MT,6204,#N/A,6612,7382,4360,3971,3857,#N/A,6517.323435,7586,7296,31574,-7706,-2701,-21100,-1192,32386,23868,28873,10474,30382
31001,NE,5208,#N/A,5659,8320,4674,3699,4142,#N/A,5375.134097,7596,8126,30004,-2840,-3862,-22393,-2353,31702,27164,26142,7611,27651
31003,NE,5940,#N/A,5659,8320,4674,3699,4252,#N/A,5456.268197,7596,8320,31011,-2606,-3629,-22028,-2120,32544,28405,27382,8983,28891
31005,NE,5304,#N/A,5659,8320,4674,3699,4157,#N/A,5740.237546,7596,8320,30659,-2840,-3862,-22393,-2353,31813,27819,26797,8266,28306
31007,NE,5280,#N/A,5659,8320,4674,3699,4153,#N/A,5740.237546,7596,8095,30410,-2840,-3862,-22393,-2353,31785,27570,26548,8017,28057
31009,NE,5304,#N/A,5659,8320,4674,3699,4157,#N/A,5415.701147,7596,8320,30335,-2840,-3862,-22393,-2353,31813,27495,26473,7942,27982
31011,NE,5940,#N/A,5659,8320,4674,3699,4252,#N/A,5334.567048,7596,8320,30890,-2606,-3629,-22028,-2120,32544,28284,27261,8862,28770
31013,NE,5400,#N/A,5659,8320,4674,3699,4171,#N/A,5740.237546,7596,8320,30755,-2840,-3862,-22393,-2353,31923,27915,26893,8362,28402
31015,NE,5940,#N/A,5659,8320,4674,3699,4252,#N/A,5435.984672,7596,8320,30991,-2606,-3629,-22028,-2120,32544,28385,27362,8963,28871
31017,NE,5208,#N/A,5659,8320,4674,3699,4142,#N/A,5273.716473,7596,8320,30097,-2840,-3862,-22393,-2353,31702,27257,26235,7704,27744
31019,NE,5736,#N/A,5659,8320,4674,3699,4222,#N/A,5719.954021,7596,8474,31225,-2606,-3629,-22028,-2120,32310,28619,27596,9197,29105
31021,NE,5208,#N/A,5659,8320,4674,3699,4142,#N/A,5456.268197,7596,8320,30279,-2840,-3862,-22393,-2353,31702,27439,26417,7886,27926
31023,NE,5208,#N/A,5659,8320,4674,3699,4142,#N/A,5659.103446,7596,8320,30482,-2840,-3862,-22393,-2353,31702,27642,26620,8089,28129
31025,NE,7548,#N/A,5659,8320,4674,3699,4494,#N/A,5821.371645,7596,8515,33179,1460,438,-17697,1947,34394,34639,33617,15482,35126
31027,NE,5208,#N/A,5659,8320,4674,3699,4142,#N/A,5415.701147,7596,8320,30239,-2840,-3862,-22393,-2353,31702,27399,26377,7846,27886
31029,NE,5208,#N/A,5659,8320,4674,3699,4142,#N/A,5659.103446,7596,8320,30482,-2840,-3862,-22393,-2353,31702,27642,26620,8089,28129
31031,NE,5580,#N/A,5659,8320,4674,3699,4198,#N/A,5557.685821,7596,8320,30753,-2840,-3862,-22393,-2353,32130,27913,26891,8360,28400
31033,NE,5508,#N/A,5659,8320,4674,3699,4187,#N/A,5821.371645,7596,8320,30944,-2840,-3862,-22393,-2353,32047,28104,27082,8551,28591
31035,NE,5940,#N/A,5659,8320,4674,3699,4252,#N/A,5273.716473,7596,8320,30829,-2606,-3629,-22028,-2120,32544,28223,27200,8801,28709
31037,NE,5940,#N/A,5659,8320,4674,3699,4252,#N/A,5435.984672,7596,8320,30991,-2606,-3629,-22028,-2120,32544,28385,27362,8963,28871
31039,NE,5292,#N/A,5659,8320,4674,3699,4155,#N/A,5435.984672,7596,8320,30343,-2840,-3862,-22393,-2353,31799,27503,26481,7950,27990
31041,NE,5940,#N/A,5659,8320,4674,3699,4252,#N/A,5415.701147,7596,8320,30971,-2606,-3629,-22028,-2120,32544,28365,27342,8943,28851
31043,NE,6492,#N/A,5659,8320,4674,3699,4335,#N/A,5152.015324,7596,8370,31309,-2606,-3629,-22028,-2120,33179,28703,27680,9281,29189
31045,NE,5208,#N/A,5659,8320,4674,3699,4142,#N/A,5719.954021,7596,8320,30543,-2840,-3862,-22393,-2353,31702,27703,26681,8150,28190
31047,NE,5328,#N/A,5659,8320,4674,3699,4160,#N/A,5212.865898,7596,8370,30206,-2840,-3862,-22393,-2353,31840,27366,26344,7813,27853
31049,NE,5208,#N/A,5659,8320,4674,3699,4142,#N/A,5841.65517,7596,8320,30665,-2840,-3862,-22393,-2353,31702,27825,26803,8272,28312
31051,NE,6492,#N/A,5659,8320,4674,3699,4335,#N/A,5375.134097,7596,8359,31522,-2606,-3629,-22028,-2120,33179,28916,27893,9494,29402
31053,NE,5940,#N/A,5659,8320,4674,3699,4252,#N/A,5375.134097,7596,8089,30699,-2840,-3862,-22393,-2353,32544,27859,26837,8306,28346
31055,NE,7548,#N/A,5659,8320,4674,3699,4494,#N/A,5496.835247,7596,8535,32875,1460,438,-17697,1947,34394,34335,33313,15178,34822
31057,NE,5208,#N/A,5659,8320,4674,3699,4142,#N/A,5476.551722,7596,8320,30300,-2840,-3862,-22393,-2353,31702,27460,26438,7907,27947
31059,NE,5208,#N/A,5659,8320,4674,3699,4142,#N/A,5435.984672,7596,8320,30259,-2840,-3862,-22393,-2353,31702,27419,26397,7866,27906
31061,NE,5280,#N/A,5659,8320,4674,3699,4153,#N/A,5598.252871,7596,8320,30493,-2840,-3862,-22393,-2353,31785,27653,26631,8100,28140
31063,NE,5820,#N/A,5659,8320,4674,3699,4234,#N/A,5456.268197,7596,8320,30891,-2606,-3629,-22028,-2120,32406,28285,27262,8863,28771
31065,NE,5208,#N/A,5659,8320,4674,3699,4142,#N/A,5557.685821,7596,8320,30381,-2840,-3862,-22393,-2353,31702,27541,26519,7988,28028
31067,NE,5484,#N/A,5659,8320,4674,3699,4184,#N/A,5415.701147,7596,8070,30265,-2840,-3862,-22393,-2353,32020,27425,26403,7872,27912
31069,NE,5280,#N/A,5659,8320,4674,3699,4153,#N/A,5740.237546,7596,8320,30635,-2840,-3862,-22393,-2353,31785,27795,26773,8242,28282
31071,NE,5280,#N/A,5659,8320,4674,3699,4153,#N/A,5293.999998,7596,8320,30189,-2840,-3862,-22393,-2353,31785,27349,26327,7796,27836
31073,NE,5376,#N/A,5659,8320,4674,3699,4167,#N/A,5577.969346,7596,8365,30613,-2840,-3862,-22393,-2353,31895,27773,26751,8220,28260
31075,NE,5280,#N/A,5659,8320,4674,3699,4153,#N/A,5719.954021,7596,8320,30615,-2840,-3862,-22393,-2353,31785,27775,26753,8222,28262
31077,NE,5280,#N/A,5659,8320,4674,3699,4153,#N/A,5598.252871,7596,8320,30493,-2840,-3862,-22393,-2353,31785,27653,26631,8100,28140
31079,NE,5916,#N/A,5659,8320,4674,3699,4249,#N/A,5212.865898,7596,8390,30814,-2606,-3629,-22028,-2120,32517,28208,27185,8786,28694
31081,NE,5208,#N/A,5659,8320,4674,3699,4142,#N/A,5273.716473,7596,8379,30156,-2840,-3862,-22393,-2353,31702,27316,26294,7763,27803
31083,NE,5208,#N/A,5659,8320,4674,3699,4142,#N/A,5618.536396,7596,8320,30442,-2840,-3862,-22393,-2353,31702,27602,26580,8049,28089
31085,NE,5304,#N/A,5659,8320,4674,3699,4157,#N/A,5638.819921,7596,8320,30558,-2840,-3862,-22393,-2353,31813,27718,26696,8165,28205
31087,NE,5280,#N/A,5659,8320,4674,3699,4153,#N/A,5476.551722,7596,8320,30372,-2840,-3862,-22393,-2353,31785,27532,26510,7979,28019
31089,NE,5940,#N/A,5659,8320,4674,3699,4252,#N/A,5537.402297,7596,8320,31092,-2606,-3629,-22028,-2120,32544,28486,27463,9064,28972
31091,NE,5304,#N/A,5659,8320,4674,3699,4157,#N/A,5699.670496,7596,8320,30619,-2840,-3862,-22393,-2353,31813,27779,26757,8226,28266
31093,NE,5208,#N/A,5659,8320,4674,3699,4142,#N/A,5375.134097,7596,8378,30256,-2840,-3862,-22393,-2353,31702,27416,26394,7863,27903
31095,NE,5340,#N/A,5659,8320,4674,3699,4162,#N/A,5354.850573,7596,8320,30310,-2840,-3862,-22393,-2353,31854,27470,26448,7917,27957
31097,NE,5208,#N/A,5659,8320,4674,3699,4142,#N/A,5679.386971,7596,8320,30502,-2840,-3862,-22393,-2353,31702,27662,26640,8109,28149
31099,NE,5940,#N/A,5659,8320,4674,3699,4252,#N/A,5618.536396,7596,8454,31308,-2606,-3629,-22028,-2120,32544,28702,27679,9280,29188
31101,NE,5940,#N/A,5659,8320,4674,3699,4252,#N/A,5699.670496,7596,8320,31255,-2606,-3629,-22028,-2120,32544,28649,27626,9227,29135
31103,NE,5280,#N/A,5659,8320,4674,3699,4153,#N/A,5273.716473,7596,8320,30169,-2840,-3862,-22393,-2353,31785,27329,26307,7776,27816
31105,NE,5400,#N/A,5659,8320,4674,3699,4171,#N/A,5841.65517,7596,8320,30857,-2840,-3862,-22393,-2353,31923,28017,26995,8464,28504
31107,NE,5940,#N/A,5659,8320,4674,3699,4252,#N/A,5577.969346,7596,8320,31133,-2606,-3629,-22028,-2120,32544,28527,27504,9105,29013
31109,NE,6360,#N/A,5659,8320,4674,3699,4315,#N/A,5780.804595,7596,8330,31766,-2606,-3629,-22028,-2120,33027,29160,28137,9738,29646
31111,NE,5568,#N/A,5659,8320,4674,3699,4196,#N/A,5577.969346,7596,8006,30447,-2840,-3862,-22393,-2353,32116,27607,26585,8054,28094
31113,NE,6396,#N/A,5659,8320,4674,3699,4321,#N/A,5435.984672,7596,8072,31199,-2606,-3629,-22028,-2120,33069,28593,27570,9171,29079
31115,NE,5280,#N/A,5659,8320,4674,3699,4153,#N/A,5375.134097,7596,8320,30270,-2840,-3862,-22393,-2353,31785,27430,26408,7877,27917
31117,NE,5304,#N/A,5659,8320,4674,3699,4157,#N/A,5699.670496,7596,8076,30375,-2840,-3862,-22393,-2353,31813,27535,26513,7982,28022
31119,NE,5364,#N/A,5659,8320,4674,3699,4166,#N/A,5456.268197,7596,8240,30355,-2840,-3862,-22393,-2353,31882,27515,26493,7962,28002
31121,NE,5208,#N/A,5659,8320,4674,3699,4142,#N/A,5314.283523,7596,8380,30197,-2840,-3862,-22393,-2353,31702,27357,26335,7804,27844
31123,NE,5208,#N/A,5659,8320,4674,3699,4142,#N/A,5780.804595,7596,8320,30604,-2840,-3862,-22393,-2353,31702,27764,26742,8211,28251
31125,NE,5940,#N/A,5659,8320,4674,3699,4252,#N/A,5517.118772,7596,8320,31072,-2606,-3629,-22028,-2120,32544,28466,27443,9044,28952
31127,NE,5592,#N/A,5659,8320,4674,3699,4200,#N/A,5233.149423,7596,8320,30440,-2840,-3862,-22393,-2353,32144,27600,26578,8047,28087
31129,NE,5940,#N/A,5659,8320,4674,3699,4252,#N/A,5334.567048,7596,8320,30890,-2606,-3629,-22028,-2120,32544,28284,27261,8862,28770
31131,NE,5472,#N/A,5659,8320,4674,3699,4182,#N/A,5496.835247,7596,8320,30584,-2840,-3862,-22393,-2353,32006,27744,26722,8191,28231
31133,NE,5208,#N/A,5659,8320,4674,3699,4142,#N/A,5395.417622,7596,8320,30218,-2840,-3862,-22393,-2353,31702,27378,26356,7825,27865
31135,NE,5280,#N/A,5659,8320,4674,3699,4153,#N/A,5699.670496,7596,8320,30595,-2840,-3862,-22393,-2353,31785,27755,26733,8202,28242
31137,NE,5940,#N/A,5659,8320,4674,3699,4252,#N/A,5577.969346,7596,8320,31133,-2606,-3629,-22028,-2120,32544,28527,27504,9105,29013
31139,NE,5940,#N/A,5659,8320,4674,3699,4252,#N/A,5435.984672,7596,8252,30923,-2606,-3629,-22028,-2120,32544,28317,27294,8895,28803
31141,NE,5940,#N/A,5659,8320,4674,3699,4252,#N/A,5537.402297,7596,8443,31215,-2606,-3629,-22028,-2120,32544,28609,27586,9187,29095
31143,NE,5208,#N/A,5659,8320,4674,3699,4142,#N/A,5537.402297,7596,8320,30360,-2840,-3862,-22393,-2353,31702,27520,26498,7967,28007
31145,NE,5556,#N/A,5659,8320,4674,3699,4195,#N/A,5314.283523,7596,8320,30485,-2840,-3862,-22393,-2353,32103,27645,26623,8092,28132
31147,NE,5844,#N/A,5659,8320,4674,3699,4238,#N/A,5435.984672,7596,8320,30895,-2606,-3629,-22028,-2120,32434,28289,27266,8867,28775
31149,NE,5316,#N/A,5659,8320,4674,3699,4158,#N/A,5233.149423,7596,8320,30164,-2840,-3862,-22393,-2353,31826,27324,26302,7771,27811
31151,NE,6132,#N/A,5659,8320,4674,3699,4281,#N/A,5679.386971,7596,8320,31426,-2606,-3629,-22028,-2120,32765,28820,27797,9398,29306
31153,NE,7548,#N/A,5659,8320,4674,3699,4494,#N/A,5557.685821,7596,8525,32925,1460,438,-17697,1947,34394,34385,33363,15228,34872
31155,NE,6504,#N/A,5659,8320,4674,3699,4337,#N/A,5801.08812,7596,8510,32110,-2606,-3629,-22028,-2120,33193,29504,28481,10082,29990
31157,NE,5676,#N/A,5659,8320,4674,3699,4213,#N/A,5598.252871,7596,8033,30603,-2840,-3862,-22393,-2353,32241,27763,26741,8210,28250
31159,NE,5484,#N/A,5659,8320,4674,3699,4184,#N/A,5719.954021,7596,8329,30828,-2840,-3862,-22393,-2353,32020,27988,26966,8435,28475
31161,NE,5940,#N/A,5659,8320,4674,3699,4252,#N/A,5902.505745,7596,8320,31458,-2606,-3629,-22028,-2120,32544,28852,27829,9430,29338
31163,NE,5208,#N/A,5659,8320,4674,3699,4142,#N/A,5395.417622,7596,8320,30218,-2840,-3862,-22393,-2353,31702,27378,26356,7825,27865
31165,NE,5940,#N/A,5659,8320,4674,3699,4252,#N/A,5740.237546,7596,8096,31072,-2840,-3862,-22393,-2353,32544,28232,27210,8679,28719
31167,NE,5208,#N/A,5659,8320,4674,3699,4142,#N/A,5476.551722,7596,8250,30230,-2840,-3862,-22393,-2353,31702,27390,26368,7837,27877
31169,NE,5208,#N/A,5659,8320,4674,3699,4142,#N/A,5273.716473,7596,8320,30097,-2840,-3862,-22393,-2353,31702,27257,26235,7704,27744
31171,NE,5388,#N/A,5659,8320,4674,3699,4169,#N/A,5517.118772,7596,8320,30520,-2840,-3862,-22393,-2353,31909,27680,26658,8127,28167
31173,NE,5208,#N/A,5659,8320,4674,3699,4142,#N/A,5334.567048,7596,8320,30158,-2840,-3862,-22393,-2353,31702,27318,26296,7765,27805
31175,NE,5208,#N/A,5659,8320,4674,3699,4142,#N/A,5375.134097,7596,8320,30198,-2840,-3862,-22393,-2353,31702,27358,26336,7805,27845
31177,NE,7548,#N/A,5659,8320,4674,3699,4494,#N/A,5577.969346,7596,8515,32936,1460,438,-17697,1947,34394,34396,33374,15239,34883
31179,NE,5208,#N/A,5659,8320,4674,3699,4142,#N/A,5395.417622,7596,8320,30218,-2840,-3862,-22393,-2353,31702,27378,26356,7825,27865
31181,NE,5940,#N/A,5659,8320,4674,3699,4252,#N/A,5375.134097,7596,8320,30930,-2606,-3629,-22028,-2120,32544,28324,27301,8902,28810
31183,NE,5280,#N/A,5659,8320,4674,3699,4153,#N/A,5456.268197,7596,8320,30351,-2840,-3862,-22393,-2353,31785,27511,26489,7958,27998
31185,NE,5436,#N/A,5659,8320,4674,3699,4177,#N/A,5273.716473,7596,8320,30325,-2840,-3862,-22393,-2353,31965,27485,26463,7932,27972
32001,NV,7584,#N/A,6612,7382,5003,3971,3520,#N/A,7275.702889,6290,7241,32361,-11454,-2190,-20589,-681,34072,20907,30171,11772,31680
32003,NV,10116,#N/A,6612,7382,5003,3971,3811,#N/A,6754.317014,6290,7526,34658,-7289,1975,-16028,3484,36895,27369,36633,18630,38142
32005,NV,9456,#N/A,6612,7382,5003,3971,3735,#N/A,6683.218941,6290,7446,33846,-7478,1786,-16349,3295,36159,26368,35632,17497,37141
32007,NV,7800,#N/A,6612,7382,5003,3971,3545,#N/A,7275.702889,6290,8139,33476,-7667,1598,-16669,3107,34313,25809,35074,16807,36583
32009,NV,5652,#N/A,6612,7382,5003,3971,3297,#N/A,8176.278491,6290,7382,31471,-11832,-2567,-21230,-1058,31917,19639,28904,10241,30413
32011,NV,7344,#N/A,6612,7382,5003,3971,3492,#N/A,7038.70931,6290,8059,32703,-7667,1598,-16669,3107,33804,25036,34301,16034,35810
32013,NV,6156,#N/A,6612,7382,5003,3971,3355,#N/A,6564.722151,6290,7493,30474,-11643,-2378,-20909,-869,32479,18831,28096,9565,29605
32015,NV,7620,#N/A,6612,7382,5003,3971,3524,#N/A,7086.108026,6290,7382,32349,-11454,-2190,-20589,-681,34112,20895,30159,11760,31668
32017,NV,6936,#N/A,6612,7382,5003,3971,3445,#N/A,6706.918299,6290,7382,31286,-11454,-2190,-20589,-681,33349,19832,29096,10697,30605
32019,NV,7944,#N/A,6612,7382,5003,3971,3561,#N/A,6635.820225,6290,7053,31894,-11454,-2190,-20589,-681,34473,20440,29704,11305,31213
32021,NV,9000,#N/A,6612,7382,5003,3971,3683,#N/A,6943.911878,6290,7382,33587,-7478,1786,-16349,3295,35651,26109,35373,17238,36882
32023,NV,7260,#N/A,6612,7382,5003,3971,3482,#N/A,6564.722151,6290,6402,30487,-11643,-2378,-20909,-869,33710,18844,28109,9578,29618
32027,NV,6444,#N/A,6612,7382,5003,3971,3388,#N/A,6849.114446,6290,7382,30936,-11643,-2378,-20909,-869,32800,19293,28558,10027,30067
32029,NV,8364,#N/A,6612,7382,5003,3971,3610,#N/A,6872.813804,6290,7376,32874,-7667,1598,-16669,3107,34942,25207,34472,16205,35981
32031,NV,8364,#N/A,6612,7382,5003,3971,3610,#N/A,6849.114446,6290,7375,32849,-7667,1598,-16669,3107,34942,25182,34447,16180,35956
32033,NV,7692,#N/A,6612,7382,5003,3971,3532,#N/A,6446.225361,6290,7382,31781,-11454,-2190,-20589,-681,34192,20327,29591,11192,31100
32510,NV,8196,#N/A,6612,7382,5003,3971,3590,#N/A,7631.193258,6290,7127,33215,-7667,1598,-16669,3107,34754,25548,34813,16546,36322
33001,NH,8388,#N/A,6434,6855,4991,3644,5008,#N/A,7310.449044,6304,6842,32489,-4934,-1901,-20300,-392,35320,27555,30588,12189,32097
33003,NH,9384,#N/A,6434,6855,4991,3644,5172,#N/A,8279.025889,6304,6855,34466,-1123,1910,-16357,3419,36480,33343,36376,18109,37885
33005,NH,8844,#N/A,6434,6855,4991,3644,5083,#N/A,7033.712803,6304,6766,32592,-4934,-1901,-20300,-392,35851,27658,30691,12292,32200
33007,NH,6648,#N/A,6434,6855,4991,3644,4720,#N/A,7172.080923,6304,6241,30009,-5357,-2324,-20987,-815,33292,24652,27685,9022,29194
33009,NH,9696,#N/A,6434,6855,4991,3644,5224,#N/A,7471.878518,6304,6714,33830,-1123,1910,-16357,3419,36844,32707,35740,17473,37249
33011,NH,10444,#N/A,6434,6855,4991,3644,5347,#N/A,6918.406035,6304,7416,34727,-7518,2333,-15670,3842,37715,27209,37060,19057,38569
33013,NH,9612,#N/A,6434,6855,4991,3644,5210,#N/A,7079.83551,6304,7248,33887,-7730,2121,-16014,3630,36746,26157,36008,17873,37517
33015,NH,10472,#N/A,6434,6855,4991,3644,5352,#N/A,7125.958216,6304,7417,34963,-7518,2333,-15670,3842,37748,27445,37296,19293,38805
33017,NH,10056,#N/A,6434,6855,4991,3644,5283,#N/A,6987.590096,6304,7435,34427,-7730,2121,-16014,3630,37263,26697,36548,18413,38057
33019,NH,9024,#N/A,6434,6855,4991,3644,5113,#N/A,6572.485734,6304,6714,32259,-1123,1910,-16357,3419,36061,31136,34169,15902,35678
34001,NJ,11004,#N/A,6434,6855,4558,3644,4312,#N/A,6826.160622,7768,6920,36162,1681,2609,-15262,4118,36807,37843,38771,20900,40280
34003,NJ,14184,#N/A,6434,6855,4558,3644,4734,#N/A,7633.307992,7768,7482,40711,2387,3315,-14028,4824,40409,43098,44026,26683,45535
34005,NJ,11304,#N/A,6434,6855,4558,3644,4352,#N/A,6503.301673,7768,7233,36453,1858,2786,-14953,4295,37147,38311,39239,21500,40748
34007,NJ,11304,#N/A,6434,6855,4558,3644,4352,#N/A,6941.467389,7768,7252,36909,1858,2786,-14953,4295,37147,38767,39695,21956,41204
34009,NJ,9132,#N/A,6434,6855,4558,3644,4064,#N/A,7817.79882,7768,6529,34891,1328,2256,-15879,3765,34687,36219,37147,19012,38656
34011,NJ,10440,#N/A,6434,6855,4558,3644,4237,#N/A,6203.504078,7768,6840,34895,1681,2609,-15262,4118,36168,36576,37504,19633,39013
34013,NJ,12708,#N/A,6434,6855,4558,3644,4538,#N/A,8025.351001,7768,7528,39674,2211,3139,-14336,4648,38737,41885,42813,25338,44322
34015,NJ,11304,#N/A,6434,6855,4558,3644,4352,#N/A,6411.056259,7768,7230,36357,1858,2786,-14953,4295,37147,38215,39143,21404,40652
34017,NJ,13068,#N/A,6434,6855,4558,3644,4586,#N/A,6849.221975,7768,7699,39028,2211,3139,-14336,4648,39145,41239,42167,24692,43676
34019,NJ,14208,#N/A,6434,6855,4558,3644,4737,#N/A,8163.719122,7768,7372,41156,2387,3315,-14028,4824,40436,43543,44471,27128,45980
34021,NJ,12204,#N/A,6434,6855,4558,3644,4471,#N/A,6987.590096,7768,7488,38092,2034,2962,-14645,4471,38166,40126,41054,23447,42563
34023,NJ,14208,#N/A,6434,6855,4558,3644,4737,#N/A,6664.731147,7768,7432,39717,2387,3315,-14028,4824,40436,42104,43032,25689,44541
34025,NJ,12996,#N/A,6434,6855,4558,3644,4576,#N/A,7033.712803,7768,7403,38845,2211,3139,-14336,4648,39063,41056,41984,24509,43493
34027,NJ,12708,#N/A,6434,6855,4558,3644,4538,#N/A,7402.694458,7768,7400,38923,2034,2962,-14645,4471,38737,40957,41885,24278,43394
34029,NJ,12996,#N/A,6434,6855,4558,3644,4576,#N/A,6780.037915,7768,7385,38573,2211,3139,-14336,4648,39063,40784,41712,24237,43221
34031,NJ,14184,#N/A,6434,6855,4558,3644,4734,#N/A,6687.792501,7768,7474,39758,2387,3315,-14028,4824,40409,42145,43073,25730,44582
34033,NJ,11304,#N/A,6434,6855,4558,3644,4352,#N/A,7494.939872,7768,7217,37428,1858,2786,-14953,4295,37147,39286,40214,22475,41723
34035,NJ,14208,#N/A,6434,6855,4558,3644,4737,#N/A,7310.449044,7768,7402,40333,2387,3315,-14028,4824,40436,42720,43648,26305,45157
34037,NJ,12708,#N/A,6434,6855,4558,3644,4538,#N/A,7725.553406,7768,7371,39217,2034,2962,-14645,4471,38737,41251,42179,24572,43688
34039,NJ,12708,#N/A,6434,6855,4558,3644,4538,#N/A,6572.485734,7768,7470,38162,2211,3139,-14336,4648,38737,40373,41301,23826,42810
34041,NJ,11520,#N/A,6434,6855,4558,3644,4381,#N/A,7541.062579,7768,6902,37375,1858,2786,-14953,4295,37392,39233,40161,22422,41670
35001,NM,7860,#N/A,6612,7382,4759,3971,4502,#N/A,6398.826645,4610,7238,30078,-1163,-321,-18852,1188,35086,28915,29757,11226,31266
35003,NM,6444,#N/A,6612,7382,4759,3971,4294,#N/A,6588.421509,4610,7382,28995,-1690,-548,-19211,961,33462,27305,28447,9784,29956
35005,NM,5724,#N/A,6612,7382,4759,3971,4188,#N/A,6256.630498,4610,6781,27343,-3238,-1001,-19928,508,32636,24105,26342,7415,27851
35006,NM,5844,#N/A,6612,7382,4759,3971,4205,#N/A,6209.231782,4610,6855,27489,-3238,-1001,-19928,508,32773,24251,26488,7561,27997
35007,NM,6012,#N/A,6612,7382,4759,3971,4230,#N/A,7465.297753,4610,7382,29440,-2411,-774,-19569,735,32966,27029,28666,9871,30175
35009,NM,5964,#N/A,6612,7382,4759,3971,4223,#N/A,6825.415088,4610,6954,28324,-2411,-774,-19569,735,32911,25913,27550,8755,29059
35011,NM,6444,#N/A,6612,7382,4759,3971,4294,#N/A,6564.722151,4610,7382,28972,-1690,-548,-19211,961,33462,27282,28424,9761,29933
35013,NM,7440,#N/A,6612,7382,4759,3971,4440,#N/A,6493.624077,4610,6906,29420,-1690,-548,-19211,961,34604,27730,28872,10209,30381
35015,NM,6648,#N/A,6612,7382,4759,3971,4324,#N/A,6967.611236,4610,7360,29556,-1690,-548,-19211,961,33696,27866,29008,10345,30517
35017,NM,6444,#N/A,6612,7382,4759,3971,4294,#N/A,6801.71573,4610,6365,28192,-2411,-774,-19569,735,33462,25781,27418,8623,28927
35019,NM,5940,#N/A,6612,7382,4759,3971,4219,#N/A,6493.624077,4610,7382,28397,-2411,-774,-19569,735,32883,25986,27623,8828,29132
35021,NM,5940,#N/A,6612,7382,4759,3971,4219,#N/A,7252.003531,4610,7382,29155,-2411,-774,-19569,735,32883,26744,28381,9586,29890
35023,NM,5940,#N/A,6612,7382,4759,3971,4219,#N/A,6612.120867,4610,7382,28515,-2411,-774,-19569,735,32883,26104,27741,8946,29250
35025,NM,7020,#N/A,6612,7382,4759,3971,4378,#N/A,6967.611236,4610,7559,30127,-1690,-548,-19211,961,34122,28437,29579,10916,31088
35027,NM,7884,#N/A,6612,7382,4759,3971,4506,#N/A,6730.617656,4610,7382,30578,-1163,-321,-18852,1188,35114,29415,30257,11726,31766
35028,NM,10104,#N/A,6612,7382,4759,3971,4832,#N/A,6896.513162,4610,8971,34552,3756,3894,-14109,5403,37660,38308,38446,20443,39955
35029,NM,6432,#N/A,6612,7382,4759,3971,4292,#N/A,6469.924719,4610,6390,27873,-2411,-774,-19569,735,33448,25462,27099,8304,28608
35031,NM,6444,#N/A,6612,7382,4759,3971,4294,#N/A,6232.93114,4610,7145,28403,-2411,-774,-19569,735,33462,25992,27629,8834,29138
35033,NM,6768,#N/A,6612,7382,4759,3971,4341,#N/A,6991.310594,4610,7382,29722,-1690,-548,-19211,961,33833,28032,29174,10511,30683
35035,NM,6444,#N/A,6612,7382,4759,3971,4294,#N/A,6778.016372,4610,6658,28461,-2411,-774,-19569,735,33462,26050,27687,8892,29196
35037,NM,6000,#N/A,6612,7382,4759,3971,4228,#N/A,6517.323435,4610,7382,28480,-2411,-774,-19569,735,32952,26069,27706,8911,29215
35039,NM,6564,#N/A,6612,7382,4759,3971,4311,#N/A,6588.421509,4610,7062,28796,-2411,-774,-19569,735,33599,26385,28022,9227,29531
35041,NM,6612,#N/A,6612,7382,4759,3971,4318,#N/A,6375.127287,4610,6863,28431,-2411,-774,-19569,735,33654,26020,27657,8862,29166
35043,NM,7860,#N/A,6612,7382,4759,3971,4502,#N/A,6943.911878,4610,7259,30644,-1163,-321,-18852,1188,35086,29481,30323,11792,31832
35045,NM,6516,#N/A,6612,7382,4759,3971,4304,#N/A,6375.127287,4610,7534,29006,-1690,-548,-19211,961,33544,27316,28458,9795,29967
35047,NM,6504,#N/A,6612,7382,4759,3971,4302,#N/A,6849.114446,4610,6098,28032,-3238,-1001,-19928,508,33530,24794,27031,8104,28540
35049,NM,9684,#N/A,6612,7382,4759,3971,4771,#N/A,6825.415088,4610,7101,32192,-637,-95,-18494,1414,37179,31555,32097,13698,33606
35051,NM,5916,#N/A,6612,7382,4759,3971,4216,#N/A,6185.532424,4610,7382,28065,-2411,-774,-19569,735,32856,25654,27291,8496,28800
35053,NM,5652,#N/A,6612,7382,4759,3971,4177,#N/A,6446.225361,4610,7382,28061,-2411,-774,-19569,735,32553,25650,27287,8492,28796
35055,NM,9048,#N/A,6612,7382,4759,3971,4677,#N/A,8081.481059,4610,6372,32082,-1163,-321,-18852,1188,36449,30919,31761,13230,33270
35057,NM,7860,#N/A,6612,7382,4759,3971,4502,#N/A,6493.624077,4610,7260,30194,-1163,-321,-18852,1188,35086,29031,29873,11342,31382
35059,NM,5916,#N/A,6612,7382,4759,3971,4216,#N/A,6683.218941,4610,7382,28562,-2411,-774,-19569,735,32856,26151,27788,8993,29297
35061,NM,7860,#N/A,6612,7382,4759,3971,4502,#N/A,6351.427929,4610,7260,30052,-1163,-321,-18852,1188,35086,28889,29731,11200,31240
36001,NY,9000,#N/A,6434,6855,4654,3644,4900,#N/A,7425.755811,8608,7116,35793,1010,1701,-16302,3210,35487,36803,37494,19491,39003
36003,NY,6120,#N/A,6434,6855,4654,3644,4439,#N/A,7149.01957,8608,6855,32376,-4071,-2480,-20879,-971,32146,28305,29896,11497,31405
36005,NY,14580,#N/A,6434,6855,4654,3644,5794,#N/A,7218.20363,8608,7815,41865,4665,3156,-13923,4665,41961,46530,45021,27942,46530
36007,NY,6504,#N/A,6434,6855,4654,3644,4500,#N/A,6249.626785,8608,6552,31557,-4071,-2480,-20879,-971,32591,27486,29077,10678,30586
36009,NY,6300,#N/A,6434,6855,4654,3644,4467,#N/A,5903.706484,8608,6432,30888,-4071,-2480,-20879,-971,32354,26817,28408,10009,29917
36011,NY,7032,#N/A,6434,6855,4654,3644,4585,#N/A,6088.197311,8608,6672,32044,22,1313,-16954,2822,33204,32066,33357,15090,34866
36013,NY,5868,#N/A,6434,6855,4654,3644,4398,#N/A,5949.82919,8608,6348,30418,-4565,-2674,-21205,-1165,31853,25853,27744,9213,29253
36015,NY,7200,#N/A,6434,6855,4654,3644,4612,#N/A,5719.215656,8608,6495,31666,22,1313,-16954,2822,33399,31688,32979,14712,34488
36017,NY,6096,#N/A,6434,6855,4654,3644,4435,#N/A,6895.344682,8608,6855,32098,-4071,-2480,-20879,-971,32118,28027,29618,11219,31127
36019,NY,7656,#N/A,6434,6855,4654,3644,4685,#N/A,6295.749492,8608,6508,32712,22,1313,-16954,2822,33928,32734,34025,15758,35534
36021,NY,8652,#N/A,6434,6855,4654,3644,4844,#N/A,6434.117613,8608,6722,34060,1010,1701,-16302,3210,35083,35070,35761,17758,37270
36023,NY,7212,#N/A,6434,6855,4654,3644,4614,#N/A,6111.258665,8608,6680,32255,22,1313,-16954,2822,33413,32277,33568,15301,35077
36025,NY,6348,#N/A,6434,6855,4654,3644,4475,#N/A,7886.98288,8608,6855,33342,-4071,-2480,-20879,-971,32410,29271,30862,12463,32371
36027,NY,12276,#N/A,6434,6855,4654,3644,5425,#N/A,7149.01957,8608,7372,39049,3986,2477,-14998,3986,39288,43035,41526,24051,43035
36029,NY,6840,#N/A,6434,6855,4654,3644,4554,#N/A,6364.933553,8608,6595,32052,22,1313,-16954,2822,32981,32074,33365,15098,34874
36031,NY,7632,#N/A,6434,6855,4654,3644,4681,#N/A,6180.442725,8608,6855,32919,516,1506,-16629,3015,33900,33435,34425,16290,35934
36033,NY,6672,#N/A,6434,6855,4654,3644,4527,#N/A,5534.724828,8608,6320,30779,-4071,-2480,-20879,-971,32786,26708,28299,9900,29808
36035,NY,6612,#N/A,6434,6855,4654,3644,4517,#N/A,6111.258665,8608,6415,31390,-4071,-2480,-20879,-971,32716,27319,28910,10511,30419
36037,NY,7320,#N/A,6434,6855,4654,3644,4631,#N/A,6019.013251,8608,6768,32359,22,1313,-16954,2822,33538,32381,33672,15405,35181
36039,NY,7908,#N/A,6434,6855,4654,3644,4725,#N/A,7310.449044,8608,6855,34325,516,1506,-16629,3015,34220,34841,35831,17696,37340
36041,NY,6576,#N/A,6434,6855,4654,3644,4512,#N/A,6710.853854,8608,6855,32394,22,1313,-16954,2822,32675,32416,33707,15440,35216
36043,NY,7344,#N/A,6434,6855,4654,3644,4635,#N/A,5880.64513,8608,6546,32022,22,1313,-16954,2822,33566,32044,33335,15068,34844
36045,NY,9348,#N/A,6434,6855,4654,3644,4956,#N/A,6019.013251,8608,6628,34247,1010,1701,-16302,3210,35891,35257,35948,17945,37457
36047,NY,14580,#N/A,6434,6855,4654,3644,5794,#N/A,7218.20363,8608,7887,41938,4665,3156,-13923,4665,41961,46603,45094,28015,46603
36049,NY,6576,#N/A,6434,6855,4654,3644,4512,#N/A,6503.301673,8608,6855,32186,22,1313,-16954,2822,32675,32208,33499,15232,35008
36051,NY,8220,#N/A,6434,6855,4654,3644,4775,#N/A,6180.442725,8608,6738,33391,516,1506,-16629,3015,34582,33907,34897,16762,36406
36053,NY,7512,#N/A,6434,6855,4654,3644,4662,#N/A,6341.872199,8608,6748,32854,22,1313,-16954,2822,33761,32876,34167,15900,35676
36055,NY,8220,#N/A,6434,6855,4654,3644,4775,#N/A,6364.933553,8608,6714,33551,516,1506,-16629,3015,34582,34067,35057,16922,36566
36057,NY,7044,#N/A,6434,6855,4654,3644,4587,#N/A,6203.504078,8608,6501,32000,22,1313,-16954,2822,33218,32022,33313,15046,34822
36059,NY,15708,#N/A,6434,6855,4654,3644,5975,#N/A,7656.369346,8608,7439,43055,4665,3156,-13923,4665,43270,47720,46211,29132,47720
36061,NY,14580,#N/A,6434,6855,4654,3644,5794,#N/A,10077.81146,8608,8394,45304,4665,3156,-13923,4665,41961,49969,48460,31381,49969
36063,NY,6840,#N/A,6434,6855,4654,3644,4554,#N/A,5995.951897,8608,6620,31708,22,1313,-16954,2822,32981,31730,33021,14754,34530
36065,NY,7344,#N/A,6434,6855,4654,3644,4635,#N/A,6295.749492,8608,6525,32417,22,1313,-16954,2822,33566,32439,33730,15463,35239
36067,NY,7512,#N/A,6434,6855,4654,3644,4662,#N/A,6295.749492,8608,6728,32788,22,1313,-16954,2822,33761,32810,34101,15834,35610
36069,NY,8220,#N/A,6434,6855,4654,3644,4775,#N/A,6157.381371,8608,6731,33361,516,1506,-16629,3015,34582,33877,34867,16732,36376
36071,NY,12276,#N/A,6434,6855,4654,3644,5425,#N/A,6803.099268,8608,7375,38706,3986,2477,-14998,3986,39288,42692,41183,23708,42692
36073,NY,8220,#N/A,6434,6855,4654,3644,4775,#N/A,5488.602121,8608,6735,32696,516,1506,-16629,3015,34582,33212,34202,16067,35711
36075,NY,7512,#N/A,6434,6855,4654,3644,4662,#N/A,5788.399716,8608,6742,32294,22,1313,-16954,2822,33761,32316,33607,15340,35116
36077,NY,8160,#N/A,6434,6855,4654,3644,4765,#N/A,6480.24032,8608,6533,33425,516,1506,-16629,3015,34512,33941,34931,16796,36440
36079,NY,14580,#N/A,6434,6855,4654,3644,5794,#N/A,8325.148596,8608,7357,42514,4421,2912,-14299,4421,41961,46935,45426,28215,46935
36081,NY,14580,#N/A,6434,6855,4654,3644,5794,#N/A,7056.774156,8608,7711,41600,4421,2912,-14299,4421,41961,46021,44512,27301,46021
36083,NY,9000,#N/A,6434,6855,4654,3644,4900,#N/A,7218.20363,8608,7110,35581,1010,1701,-16302,3210,35487,36591,37282,19279,38791
36085,NY,14580,#N/A,6434,6855,4654,3644,5794,#N/A,7356.571751,8608,7520,41709,4421,2912,-14299,4421,41961,46130,44621,27410,46130
36087,NY,14580,#N/A,6434,6855,4654,3644,5794,#N/A,6780.037915,8608,7400,41012,4421,2912,-14299,4421,41961,45433,43924,26713,45433
36089,NY,6840,#N/A,6434,6855,4654,3644,4554,#N/A,5949.82919,8608,6355,31397,-4071,-2480,-20879,-971,32981,27326,28917,10518,30426
36091,NY,9000,#N/A,6434,6855,4654,3644,4900,#N/A,7402.694458,8608,7106,35761,1010,1701,-16302,3210,35487,36771,37462,19459,38971
36093,NY,9000,#N/A,6434,6855,4654,3644,4900,#N/A,6872.283328,8608,7116,35240,1010,1701,-16302,3210,35487,36250,36941,18938,38450
36095,NY,9000,#N/A,6434,6855,4654,3644,4900,#N/A,6849.221975,8608,7116,35217,1010,1701,-16302,3210,35487,36227,36918,18915,38427
36097,NY,6420,#N/A,6434,6855,4654,3644,4487,#N/A,6042.074604,8608,6855,31569,-4071,-2480,-20879,-971,32494,27498,29089,10690,30598
36099,NY,7188,#N/A,6434,6855,4654,3644,4610,#N/A,5419.418061,8608,6529,31389,22,1313,-16954,2822,33385,31411,32702,14435,34211
36101,NY,6636,#N/A,6434,6855,4654,3644,4521,#N/A,5857.583777,8608,6480,31226,-4071,-2480,-20879,-971,32744,27155,28746,10347,30255
36103,NY,15708,#N/A,6434,6855,4654,3644,5975,#N/A,7402.694458,8608,7388,42750,4665,3156,-13923,4665,43270,47415,45906,28827,47415
36105,NY,8772,#N/A,6434,6855,4654,3644,4863,#N/A,5788.399716,8608,6855,33667,1010,1701,-16302,3210,35222,34677,35368,17365,36877
36107,NY,6504,#N/A,6434,6855,4654,3644,4500,#N/A,7172.080923,8608,6577,32505,-4071,-2480,-20879,-971,32591,28434,30025,11626,31534
36109,NY,11316,#N/A,6434,6855,4654,3644,5271,#N/A,7033.712803,8608,6576,37178,3598,2089,-15650,3598,38174,40776,39267,21528,40776
36111,NY,9828,#N/A,6434,6855,4654,3644,5033,#N/A,6918.406035,8608,6778,35777,1504,1894,-15977,3403,36448,37281,37671,19800,39180
36113,NY,10020,#N/A,6434,6855,4654,3644,5063,#N/A,6803.099268,8608,6664,35739,1504,1894,-15977,3403,36670,37243,37633,19762,39142
36115,NY,10020,#N/A,6434,6855,4654,3644,5063,#N/A,7886.98288,8608,6672,36831,1504,1894,-15977,3403,36670,38335,38725,20854,40234
36117,NY,8220,#N/A,6434,6855,4654,3644,4775,#N/A,5903.706484,8608,6736,33112,516,1506,-16629,3015,34582,33628,34618,16483,36127
36119,NY,14124,#N/A,6434,6855,4654,3644,5721,#N/A,7402.694458,8608,7451,41229,4421,2912,-14299,4421,41432,45650,44141,26930,45650
36121,NY,6000,#N/A,6434,6855,4654,3644,4419,#N/A,7172.080923,8608,6855,32279,-4071,-2480,-20879,-971,32006,28208,29799,11400,31308
36123,NY,6072,#N/A,6434,6855,4654,3644,4431,#N/A,5188.804527,8608,6736,30248,-4071,-2480,-20879,-971,32090,26177,27768,9369,29277
37001,NC,6504,#N/A,5540,8554,4642,3916,5050,#N/A,5540.101271,9428,8137,33525,3781,2630,-15505,4139,34206,37306,36155,18020,37664
37003,NC,6444,#N/A,5540,8554,4642,3916,5040,#N/A,5540.101271,9428,8118,33446,3781,2630,-15505,4139,34136,37227,36076,17941,37585
37005,NC,6444,#N/A,5540,8554,4642,3916,5040,#N/A,5480.530289,9428,8554,33823,3781,2630,-15505,4139,34136,37604,36453,18318,37962
37007,NC,6444,#N/A,5540,8554,4642,3916,5040,#N/A,5381.24532,9428,8554,33723,3781,2630,-15505,4139,34136,37504,36353,18218,37862
37009,NC,5832,#N/A,5540,8554,4642,3916,4934,#N/A,5520.244277,9428,8554,33250,3781,2630,-15505,4139,33418,37031,35880,17745,37389
37011,NC,6240,#N/A,5540,8554,4642,3916,5004,#N/A,5520.244277,9428,8554,33658,3781,2630,-15505,4139,33896,37439,36288,18153,37797
37013,NC,5952,#N/A,5540,8554,4642,3916,4954,#N/A,5619.529246,9428,7925,32841,3232,2080,-16187,3589,33558,36073,34921,16654,36430
37015,NC,5652,#N/A,5540,8554,4642,3916,4902,#N/A,5162.818388,9428,8554,32713,3781,2630,-15505,4139,33206,36494,35343,17208,36852
37017,NC,5652,#N/A,5540,8554,4642,3916,4902,#N/A,5520.244277,9428,8554,33070,3781,2630,-15505,4139,33206,36851,35700,17565,37209
37019,NC,7932,#N/A,5540,8554,4642,3916,5297,#N/A,6155.668079,9428,8022,35454,3911,2760,-15243,4269,35881,39365,38214,20211,39723
37021,NC,7272,#N/A,5540,8554,4642,3916,5183,#N/A,5401.102314,9428,7978,33995,3911,2760,-15243,4269,35107,37906,36755,18752,38264
37023,NC,6444,#N/A,5540,8554,4642,3916,5040,#N/A,4845.106488,9428,8115,32748,3781,2630,-15505,4139,34136,36529,35378,17243,36887
37025,NC,8232,#N/A,5540,8554,4642,3916,5349,#N/A,5401.102314,9428,8540,35517,4040,2889,-14982,4398,36233,39557,38406,20535,39915
37027,NC,6444,#N/A,5540,8554,4642,3916,5040,#N/A,5023.819432,9428,8111,32923,3781,2630,-15505,4139,34136,36704,35553,17418,37062
37029,NC,7752,#N/A,5540,8554,4642,3916,5266,#N/A,5837.956178,9428,8387,35321,4040,2889,-14982,4398,35670,39361,38210,20339,39719
37031,NC,6996,#N/A,5540,8554,4642,3916,5135,#N/A,6393.952004,9428,8020,34754,3781,2630,-15505,4139,34783,38535,37384,19249,38893
37033,NC,5652,#N/A,5540,8554,4642,3916,4902,#N/A,4884.820475,9428,8554,32435,3781,2630,-15505,4139,33206,36216,35065,16930,36574
37035,NC,6444,#N/A,5540,8554,4642,3916,5040,#N/A,5321.674339,9428,8140,33250,3781,2630,-15505,4139,34136,37031,35880,17745,37389
37037,NC,8532,#N/A,5540,8554,4642,3916,5401,#N/A,6155.668079,9428,8387,36419,4040,2889,-14982,4398,36585,40459,39308,21437,40817
37039,NC,5652,#N/A,5540,8554,4642,3916,4902,#N/A,5758.528202,9428,8554,33309,3781,2630,-15505,4139,33206,37090,35939,17804,37448
37041,NC,6444,#N/A,5540,8554,4642,3916,5040,#N/A,5460.673295,9428,8554,33803,3781,2630,-15505,4139,34136,37584,36433,18298,37942
37043,NC,6444,#N/A,5540,8554,4642,3916,5040,#N/A,5837.956178,9428,8554,34180,3781,2630,-15505,4139,34136,37961,36810,18675,38319
37045,NC,6132,#N/A,5540,8554,4642,3916,4986,#N/A,4924.534463,9428,7757,32158,3232,2080,-16187,3589,33770,35390,34238,15971,35747
37047,NC,6240,#N/A,5540,8554,4642,3916,5004,#N/A,5361.388326,9428,8554,33499,3781,2630,-15505,4139,33896,37280,36129,17994,37638
37049,NC,7008,#N/A,5540,8554,4642,3916,5137,#N/A,5877.670165,9428,8159,34389,3911,2760,-15243,4269,34797,38300,37149,19146,38658
37051,NC,7656,#N/A,5540,8554,4642,3916,5250,#N/A,5420.959308,9428,8339,34760,3911,2760,-15243,4269,35558,38671,37520,19517,39029
37053,NC,11268,#N/A,5540,8554,4642,3916,5875,#N/A,6374.09501,9428,8764,39751,4429,3278,-14197,4787,39795,44180,43029,25554,44538
37055,NC,8280,#N/A,5540,8554,4642,3916,5358,#N/A,6910.233843,9428,8420,36954,4040,2889,-14982,4398,36290,40994,39843,21972,41352
37057,NC,6072,#N/A,5540,8554,4642,3916,4975,#N/A,4984.105444,9428,8189,32589,3781,2630,-15505,4139,33699,36370,35219,17084,36728
37059,NC,6792,#N/A,5540,8554,4642,3916,5100,#N/A,5579.815258,9428,8194,33910,3781,2630,-15505,4139,34544,37691,36540,18405,38049
37061,NC,6072,#N/A,5540,8554,4642,3916,4975,#N/A,5460.673295,9428,8554,33431,3781,2630,-15505,4139,33699,37212,36061,17926,37570
37063,NC,8532,#N/A,5540,8554,4642,3916,5401,#N/A,5639.38624,9428,8356,35871,4040,2889,-14982,4398,36585,39911,38760,20889,40269
37065,NC,6540,#N/A,5540,8554,4642,3916,5056,#N/A,5301.817345,9428,7731,32917,3781,2630,-15505,4139,34248,36698,35547,17412,37056
37067,NC,6792,#N/A,5540,8554,4642,3916,5100,#N/A,5460.673295,9428,8175,33771,3781,2630,-15505,4139,34544,37552,36401,18266,37910
37069,NC,8664,#N/A,5540,8554,4642,3916,5424,#N/A,5242.246364,9428,9063,36313,4170,3019,-14720,4528,36740,40483,39332,21593,40841
37071,NC,8232,#N/A,5540,8554,4642,3916,5349,#N/A,5162.818388,9428,8540,35278,4040,2889,-14982,4398,36233,39318,38167,20296,39676
37073,NC,6120,#N/A,5540,8554,4642,3916,4983,#N/A,5659.243233,9428,8762,33885,3781,2630,-15505,4139,33755,37666,36515,18380,38024
37075,NC,5652,#N/A,5540,8554,4642,3916,4902,#N/A,5798.24219,9428,8554,33348,3781,2630,-15505,4139,33206,37129,35978,17843,37487
37077,NC,7380,#N/A,5540,8554,4642,3916,5202,#N/A,5281.960351,9428,8433,34439,3911,2760,-15243,4269,35234,38350,37199,19196,38708
37079,NC,5652,#N/A,5540,8554,4642,3916,4902,#N/A,5083.390413,9428,8554,32633,3781,2630,-15505,4139,33206,36414,35263,17128,36772
37081,NC,7176,#N/A,5540,8554,4642,3916,5166,#N/A,5559.958264,9428,8172,34252,3911,2760,-15243,4269,34994,38163,37012,19009,38521
37083,NC,6324,#N/A,5540,8554,4642,3916,5019,#N/A,5222.38937,9428,7255,32146,3232,2080,-16187,3589,33995,35378,34226,15959,35735
37085,NC,6288,#N/A,5540,8554,4642,3916,5013,#N/A,5599.672252,9428,8437,33669,3781,2630,-15505,4139,33953,37450,36299,18164,37808
37087,NC,6228,#N/A,5540,8554,4642,3916,5002,#N/A,5818.099184,9428,7978,33368,3781,2630,-15505,4139,33882,37149,35998,17863,37507
37089,NC,7272,#N/A,5540,8554,4642,3916,5183,#N/A,5460.673295,9428,7977,34054,3911,2760,-15243,4269,35107,37965,36814,18811,38323
37091,NC,6444,#N/A,5540,8554,4642,3916,5040,#N/A,5162.818388,9428,8554,33505,3781,2630,-15505,4139,34136,37286,36135,18000,37644
37093,NC,6216,#N/A,5540,8554,4642,3916,5000,#N/A,5619.529246,9428,8351,33530,3781,2630,-15505,4139,33868,37311,36160,18025,37669
37095,NC,7668,#N/A,5540,8554,4642,3916,5252,#N/A,5996.812128,9428,8554,35563,4040,2889,-14982,4398,35572,39603,38452,20581,39961
37097,NC,7836,#N/A,5540,8554,4642,3916,5281,#N/A,5559.958264,9428,8538,35278,4040,2889,-14982,4398,35769,39318,38167,20296,39676
37099,NC,6348,#N/A,5540,8554,4642,3916,5023,#N/A,5718.814215,9428,7585,32995,3232,2080,-16187,3589,34023,36227,35075,16808,36584
37101,NC,8664,#N/A,5540,8554,4642,3916,5424,#N/A,5738.671209,9428,9074,36820,4170,3019,-14720,4528,36740,40990,39839,22100,41348
37103,NC,6924,#N/A,5540,8554,4642,3916,5123,#N/A,5659.243233,9428,8196,34123,3911,2760,-15243,4269,34699,38034,36883,18880,38392
37105,NC,7404,#N/A,5540,8554,4642,3916,5206,#N/A,5698.957221,9428,8408,34855,3911,2760,-15243,4269,35262,38766,37615,19612,39124
37107,NC,5976,#N/A,5540,8554,4642,3916,4959,#N/A,4805.3925,9428,7547,31673,3232,2080,-16187,3589,33587,34905,33753,15486,35262
37109,NC,6444,#N/A,5540,8554,4642,3916,5040,#N/A,5142.961395,9428,8538,33469,3781,2630,-15505,4139,34136,37250,36099,17964,37608
37111,NC,5652,#N/A,5540,8554,4642,3916,4902,#N/A,5659.243233,9428,7559,32214,3232,2080,-16187,3589,33206,35446,34294,16027,35803
37113,NC,6324,#N/A,5540,8554,4642,3916,5019,#N/A,5957.098141,9428,8554,34179,3781,2630,-15505,4139,33995,37960,36809,18674,38318
37115,NC,7272,#N/A,5540,8554,4642,3916,5183,#N/A,5818.099184,9428,8013,34447,3911,2760,-15243,4269,35107,38358,37207,19204,38716
37117,NC,6444,#N/A,5540,8554,4642,3916,5040,#N/A,5401.102314,9428,8554,33743,3781,2630,-15505,4139,34136,37524,36373,18238,37882
37119,NC,8232,#N/A,5540,8554,4642,3916,5349,#N/A,5837.956178,9428,8537,35951,4040,2889,-14982,4398,36233,39991,38840,20969,40349
37121,NC,5652,#N/A,5540,8554,4642,3916,4902,#N/A,5778.385196,9428,8554,33328,3781,2630,-15505,4139,33206,37109,35958,17823,37467
37123,NC,6036,#N/A,5540,8554,4642,3916,4969,#N/A,5301.817345,9428,8554,33236,3781,2630,-15505,4139,33657,37017,35866,17731,37375
37125,NC,6384,#N/A,5540,8554,4642,3916,5029,#N/A,6532.950961,9428,8045,34306,3781,2630,-15505,4139,34065,38087,36936,18801,38445
37127,NC,6540,#N/A,5540,8554,4642,3916,5056,#N/A,5043.676426,9428,7729,32657,3781,2630,-15505,4139,34248,36438,35287,17152,36796
37129,NC,7932,#N/A,5540,8554,4642,3916,5297,#N/A,5937.241147,9428,8236,35450,4040,2889,-14982,4398,35881,39490,38339,20468,39848
37131,NC,5724,#N/A,5540,8554,4642,3916,4915,#N/A,5818.099184,9428,7327,32213,1427,275,-18124,1784,33291,33640,32488,14089,33997
37133,NC,7392,#N/A,5540,8554,4642,3916,5204,#N/A,5540.101271,9428,8590,34866,3911,2760,-15243,4269,35248,38777,37626,19623,39135
37135,NC,8532,#N/A,5540,8554,4642,3916,5401,#N/A,6850.662862,9428,8364,37090,4040,2889,-14982,4398,36585,41130,39979,22108,41488
37137,NC,5652,#N/A,5540,8554,4642,3916,4902,#N/A,5996.812128,9428,8188,33181,3232,2080,-16187,3589,33206,36413,35261,16994,36770
37139,NC,7068,#N/A,5540,8554,4642,3916,5148,#N/A,5559.958264,9428,8365,34337,3911,2760,-15243,4269,34868,38248,37097,19094,38606
37141,NC,5844,#N/A,5540,8554,4642,3916,4936,#N/A,6314.524029,9428,8270,33773,3232,2080,-16187,3589,33432,37005,35853,17586,37362
37143,NC,7524,#N/A,5540,8554,4642,3916,5227,#N/A,5500.387283,9428,8379,34748,3911,2760,-15243,4269,35403,38659,37508,19505,39017
37145,NC,5988,#N/A,5540,8554,4642,3916,4961,#N/A,5281.960351,9428,8382,32996,3781,2630,-15505,4139,33601,36777,35626,17491,37135
37147,NC,6372,#N/A,5540,8554,4642,3916,5027,#N/A,5559.958264,9428,8208,33484,3781,2630,-15505,4139,34051,37265,36114,17979,37623
37149,NC,5832,#N/A,5540,8554,4642,3916,4934,#N/A,5857.813171,9428,8554,33588,3781,2630,-15505,4139,33418,37369,36218,18083,37727
37151,NC,7176,#N/A,5540,8554,4642,3916,5166,#N/A,5162.818388,9428,8183,33866,3911,2760,-15243,4269,34994,37777,36626,18623,38135
37153,NC,6444,#N/A,5540,8554,4642,3916,5040,#N/A,4745.821519,9428,7337,31871,3232,2080,-16187,3589,34136,35103,33951,15684,35460
37155,NC,5868,#N/A,5540,8554,4642,3916,4940,#N/A,4785.535506,9428,7621,31618,3232,2080,-16187,3589,33460,34850,33698,15431,35207
37157,NC,6048,#N/A,5540,8554,4642,3916,4971,#N/A,5460.673295,9428,8180,33032,3781,2630,-15505,4139,33671,36813,35662,17527,37171
37159,NC,6168,#N/A,5540,8554,4642,3916,4992,#N/A,5003.962438,9428,8540,33056,3781,2630,-15505,4139,33812,36837,35686,17551,37195
37161,NC,6444,#N/A,5540,8554,4642,3916,5040,#N/A,4825.249494,9428,7430,32043,3232,2080,-16187,3589,34136,35275,34123,15856,35632
37163,NC,6156,#N/A,5540,8554,4642,3916,4990,#N/A,5162.818388,9428,8554,33217,3781,2630,-15505,4139,33798,36998,35847,17712,37356
37165,NC,5700,#N/A,5540,8554,4642,3916,4911,#N/A,5540.101271,9428,7161,31745,1427,275,-18124,1784,33263,33172,32020,13621,33529
37167,NC,5796,#N/A,5540,8554,4642,3916,4927,#N/A,5103.247407,9428,8108,32352,3232,2080,-16187,3589,33375,35584,34432,16165,35941
37169,NC,6792,#N/A,5540,8554,4642,3916,5100,#N/A,5837.956178,9428,8190,34164,3781,2630,-15505,4139,34544,37945,36794,18659,38303
37171,NC,6444,#N/A,5540,8554,4642,3916,5040,#N/A,5440.816302,9428,7588,32817,3232,2080,-16187,3589,34136,36049,34897,16630,36406
37173,NC,6456,#N/A,5540,8554,4642,3916,5042,#N/A,5619.529246,9428,8554,33974,3781,2630,-15505,4139,34150,37755,36604,18469,38113
37175,NC,5940,#N/A,5540,8554,4642,3916,4952,#N/A,5996.812128,9428,7768,33048,3232,2080,-16187,3589,33544,36280,35128,16861,36637
37177,NC,6444,#N/A,5540,8554,4642,3916,5040,#N/A,6096.097097,9428,8430,34314,3781,2630,-15505,4139,34136,38095,36944,18809,38453
37179,NC,8232,#N/A,5540,8554,4642,3916,5349,#N/A,5659.243233,9428,8539,35774,4040,2889,-14982,4398,36233,39814,38663,20792,40172
37181,NC,5868,#N/A,5540,8554,4642,3916,4940,#N/A,5162.818388,9428,7677,32052,3232,2080,-16187,3589,33460,35284,34132,15865,35641
37183,NC,8664,#N/A,5540,8554,4642,3916,5424,#N/A,5897.527159,9428,9094,37000,4170,3019,-14720,4528,36740,41170,40019,22280,41528
37185,NC,5808,#N/A,5540,8554,4642,3916,4929,#N/A,5242.246364,9428,8554,32948,3781,2630,-15505,4139,33389,36729,35578,17443,37087
37187,NC,6120,#N/A,5540,8554,4642,3916,4983,#N/A,5500.387283,9428,8554,33518,3781,2630,-15505,4139,33755,37299,36148,18013,37657
37189,NC,7524,#N/A,5540,8554,4642,3916,5227,#N/A,6711.663905,9428,7399,34978,3781,2630,-15505,4139,35403,38759,37608,19473,39117
37191,NC,6132,#N/A,5540,8554,4642,3916,4986,#N/A,5222.38937,9428,8193,32891,3781,2630,-15505,4139,33770,36672,35521,17386,37030
37193,NC,6444,#N/A,5540,8554,4642,3916,5040,#N/A,5599.672252,9428,7450,32838,3232,2080,-16187,3589,34136,36070,34918,16651,36427
37195,NC,7128,#N/A,5540,8554,4642,3916,5158,#N/A,5162.818388,9428,7752,33387,3781,2630,-15505,4139,34938,37168,36017,17882,37526
37197,NC,6792,#N/A,5540,8554,4642,3916,5100,#N/A,5520.244277,9428,8192,33848,3781,2630,-15505,4139,34544,37629,36478,18343,37987
37199,NC,5772,#N/A,5540,8554,4642,3916,4923,#N/A,5520.244277,9428,8554,33190,3781,2630,-15505,4139,33347,36971,35820,17685,37329
38001,ND,6120,#N/A,5659,8320,4613,3699,3619,#N/A,6024.206894,7404,8320,31567,-6055,-3709,-22108,-2200,32030,25512,27858,9459,29367
38003,ND,6324,#N/A,5659,8320,4613,3699,3645,#N/A,5719.954021,7404,8320,31467,-6055,-3709,-22108,-2200,32260,25412,27758,9359,29267
38005,ND,6444,#N/A,5659,8320,4613,3699,3661,#N/A,5760.52107,7404,8320,31628,-6055,-3709,-22108,-2200,32396,25573,27919,9520,29428
38007,ND,6192,#N/A,5659,8320,4613,3699,3629,#N/A,6490.727967,7404,8320,32106,-6055,-3709,-22108,-2200,32112,26051,28397,9998,29906
38009,ND,5652,#N/A,5659,8320,4613,3699,3560,#N/A,5902.505745,7404,8320,30978,-6531,-3885,-22416,-2376,31503,24447,27093,8562,28602
38011,ND,6444,#N/A,5659,8320,4613,3699,3661,#N/A,6024.206894,7404,8320,31891,-6055,-3709,-22108,-2200,32396,25836,28182,9783,29691
38013,ND,5928,#N/A,5659,8320,4613,3699,3595,#N/A,6348.743292,7404,8320,31700,-6055,-3709,-22108,-2200,31814,25645,27991,9592,29500
38015,ND,6756,#N/A,5659,8320,4613,3699,3701,#N/A,5577.969346,7404,8754,32190,-1979,67,-18200,1576,32748,30211,32257,13990,33766
38017,ND,6348,#N/A,5659,8320,4613,3699,3649,#N/A,5699.670496,7404,8347,31498,-6055,-3709,-22108,-2200,32288,25443,27789,9390,29298
38019,ND,5652,#N/A,5659,8320,4613,3699,3560,#N/A,5821.371645,7404,8320,30896,-6531,-3885,-22416,-2376,31503,24365,27011,8480,28520
38021,ND,6444,#N/A,5659,8320,4613,3699,3661,#N/A,5801.08812,7404,8320,31668,-6055,-3709,-22108,-2200,32396,25613,27959,9560,29468
38023,ND,6120,#N/A,5659,8320,4613,3699,3619,#N/A,6713.846741,7404,8320,32257,-6055,-3709,-22108,-2200,32030,26202,28548,10149,30057
38025,ND,5916,#N/A,5659,8320,4613,3699,3594,#N/A,6450.160917,7404,8320,31789,-6531,-3885,-22416,-2376,31801,25258,27904,9373,29413
38027,ND,6444,#N/A,5659,8320,4613,3699,3661,#N/A,5963.356319,7404,8320,31830,-6055,-3709,-22108,-2200,32396,25775,28121,9722,29630
38029,ND,6444,#N/A,5659,8320,4613,3699,3661,#N/A,5618.536396,7404,8320,31486,-6055,-3709,-22108,-2200,32396,25431,27777,9378,29286
38031,ND,5976,#N/A,5659,8320,4613,3699,3601,#N/A,5922.78927,7404,8320,31322,-6055,-3709,-22108,-2200,31868,25267,27613,9214,29122
38033,ND,6444,#N/A,5659,8320,4613,3699,3661,#N/A,6490.727967,7404,8320,32358,-6055,-3709,-22108,-2200,32396,26303,28649,10250,30158
38035,ND,6492,#N/A,5659,8320,4613,3699,3667,#N/A,5638.819921,7404,8144,31378,-6055,-3709,-22108,-2200,32450,25323,27669,9270,29178
38037,ND,5652,#N/A,5659,8320,4613,3699,3560,#N/A,5699.670496,7404,8320,30775,-6531,-3885,-22416,-2376,31503,24244,26890,8359,28399
38039,ND,6444,#N/A,5659,8320,4613,3699,3661,#N/A,5699.670496,7404,8320,31567,-6055,-3709,-22108,-2200,32396,25512,27858,9459,29367
38041,ND,6444,#N/A,5659,8320,4613,3699,3661,#N/A,5983.639844,7404,8320,31851,-6055,-3709,-22108,-2200,32396,25796,28142,9743,29651
38043,ND,5736,#N/A,5659,8320,4613,3699,3571,#N/A,5659.103446,7404,8320,30818,-6531,-3885,-22416,-2376,31598,24287,26933,8402,28442
38045,ND,5652,#N/A,5659,8320,4613,3699,3560,#N/A,5943.072795,7404,8320,31018,-6531,-3885,-22416,-2376,31503,24487,27133,8602,28642
38047,ND,6120,#N/A,5659,8320,4613,3699,3619,#N/A,5659.103446,7404,8320,31202,-6055,-3709,-22108,-2200,32030,25147,27493,9094,29002
38049,ND,6000,#N/A,5659,8320,4613,3699,3604,#N/A,5902.505745,7404,8446,31451,-6055,-3709,-22108,-2200,31895,25396,27742,9343,29251
38051,ND,6912,#N/A,5659,8320,4613,3699,3720,#N/A,5659.103446,7404,8320,31994,-6055,-3709,-22108,-2200,32923,25939,28285,9886,29794
38053,ND,5652,#N/A,5659,8320,4613,3699,3560,#N/A,6531.295017,7404,8320,31606,-6531,-3885,-22416,-2376,31503,25075,27721,9190,29230
38055,ND,6156,#N/A,5659,8320,4613,3699,3624,#N/A,5699.670496,7404,8320,31279,-6055,-3709,-22108,-2200,32071,25224,27570,9171,29079
38057,ND,6444,#N/A,5659,8320,4613,3699,3661,#N/A,5861.938695,7404,8320,31729,-6055,-3709,-22108,-2200,32396,25674,28020,9621,29529
38059,ND,6756,#N/A,5659,8320,4613,3699,3701,#N/A,6044.490419,7404,8726,32630,-1979,67,-18200,1576,32748,30651,32697,14430,34206
38061,ND,10824,#N/A,5659,8320,4613,3699,4219,#N/A,6308.176243,7404,8320,36555,-343,1373,-16498,2882,37334,36212,37928,20057,39437
38063,ND,6444,#N/A,5659,8320,4613,3699,3661,#N/A,5659.103446,7404,8320,31526,-6055,-3709,-22108,-2200,32396,25471,27817,9418,29326
38065,ND,6120,#N/A,5659,8320,4613,3699,3619,#N/A,5618.536396,7404,8723,31565,-6055,-3709,-22108,-2200,32030,25510,27856,9457,29365
38067,ND,6444,#N/A,5659,8320,4613,3699,3661,#N/A,5638.819921,7404,8320,31506,-6055,-3709,-22108,-2200,32396,25451,27797,9398,29306
38069,ND,6444,#N/A,5659,8320,4613,3699,3661,#N/A,5902.505745,7404,8320,31770,-6055,-3709,-22108,-2200,32396,25715,28061,9662,29570
38071,ND,6168,#N/A,5659,8320,4613,3699,3626,#N/A,5679.386971,7404,8320,31270,-6055,-3709,-22108,-2200,32085,25215,27561,9162,29070
38073,ND,6132,#N/A,5659,8320,4613,3699,3621,#N/A,5740.237546,7404,8320,31295,-6055,-3709,-22108,-2200,32044,25240,27586,9187,29095
38075,ND,5652,#N/A,5659,8320,4613,3699,3560,#N/A,5922.78927,7404,8447,31125,-6531,-3885,-22416,-2376,31503,24594,27240,8709,28749
38077,ND,5652,#N/A,5659,8320,4613,3699,3560,#N/A,5699.670496,7404,8158,30613,-6531,-3885,-22416,-2376,31503,24082,26728,8197,28237
38079,ND,6444,#N/A,5659,8320,4613,3699,3661,#N/A,5760.52107,7404,8320,31628,-6055,-3709,-22108,-2200,32396,25573,27919,9520,29428
38081,ND,5652,#N/A,5659,8320,4613,3699,3560,#N/A,5699.670496,7404,8320,30775,-6531,-3885,-22416,-2376,31503,24244,26890,8359,28399
38083,ND,6288,#N/A,5659,8320,4613,3699,3641,#N/A,5719.954021,7404,8320,31431,-6055,-3709,-22108,-2200,32220,25376,27722,9323,29231
38085,ND,6120,#N/A,5659,8320,4613,3699,3619,#N/A,5618.536396,7404,8731,31572,-6055,-3709,-22108,-2200,32030,25517,27863,9464,29372
38087,ND,6192,#N/A,5659,8320,4613,3699,3629,#N/A,6003.923369,7404,8320,31619,-6055,-3709,-22108,-2200,32112,25564,27910,9511,29419
38089,ND,7512,#N/A,5659,8320,4613,3699,3797,#N/A,5983.639844,7404,8841,33439,-816,930,-17205,2439,33600,32623,34369,16234,35878
38091,ND,6168,#N/A,5659,8320,4613,3699,3626,#N/A,5699.670496,7404,8320,31291,-6055,-3709,-22108,-2200,32085,25236,27582,9183,29091
38093,ND,6084,#N/A,5659,8320,4613,3699,3615,#N/A,6003.923369,7404,7992,31183,-6531,-3885,-22416,-2376,31990,24652,27298,8767,28807
38095,ND,5652,#N/A,5659,8320,4613,3699,3560,#N/A,5740.237546,7404,8320,30815,-6531,-3885,-22416,-2376,31503,24284,26930,8399,28439
38097,ND,5736,#N/A,5659,8320,4613,3699,3571,#N/A,5699.670496,7404,8320,30859,-6531,-3885,-22416,-2376,31598,24328,26974,8443,28483
38099,ND,6444,#N/A,5659,8320,4613,3699,3661,#N/A,5659.103446,7404,8320,31526,-6055,-3709,-22108,-2200,32396,25471,27817,9418,29326
38101,ND,10164,#N/A,5659,8320,4613,3699,4135,#N/A,5922.78927,7404,8483,35672,-343,1373,-16498,2882,36590,35329,37045,19174,38554
38103,ND,6444,#N/A,5659,8320,4613,3699,3661,#N/A,5699.670496,7404,8320,31567,-6055,-3709,-22108,-2200,32396,25512,27858,9459,29367
38105,ND,10368,#N/A,5659,8320,4613,3699,4161,#N/A,6511.011492,7404,8981,36963,-121,1595,-16144,3104,36820,36842,38558,20819,40067
39001,OH,5832,#N/A,5659,8320,4185,3699,3486,#N/A,5091.164749,6180,8320,29122,-4415,-1446,-20109,63,31181,24707,27676,9013,29185
39003,OH,5868,#N/A,5659,8320,4185,3699,3491,#N/A,5030.314174,6180,7956,28733,-4415,-1446,-20109,63,31222,24318,27287,8624,28796
39005,OH,6036,#N/A,5659,8320,4185,3699,3512,#N/A,4786.911875,6180,8025,28727,-4415,-1446,-20109,63,31411,24312,27281,8618,28790
39007,OH,5700,#N/A,5659,8320,4185,3699,3470,#N/A,5212.865898,6180,7784,28576,-4415,-1446,-20109,63,31033,24161,27130,8467,28639
39009,OH,7092,#N/A,5659,8320,4185,3699,3645,#N/A,5395.417622,6180,7297,29664,-4415,-1446,-20109,63,32600,25249,28218,9555,29727
39011,OH,5700,#N/A,5659,8320,4185,3699,3470,#N/A,4928.89655,6180,8285,28792,-4415,-1446,-20109,63,31033,24377,27346,8683,28855
39013,OH,5916,#N/A,5659,8320,4185,3699,3497,#N/A,4928.89655,6180,7707,28431,-4415,-1446,-20109,63,31276,24016,26985,8322,28494
39015,OH,5664,#N/A,5659,8320,4185,3699,3465,#N/A,5354.850573,6180,8339,29237,-4415,-1446,-20109,63,30992,24822,27791,9128,29300
39017,OH,6648,#N/A,5659,8320,4185,3699,3589,#N/A,5517.118772,6180,8339,30384,-4238,-1269,-19800,240,32100,26146,29115,10584,30624
39019,OH,6108,#N/A,5659,8320,4185,3699,3521,#N/A,5943.072795,6180,7999,29929,-4415,-1446,-20109,63,31492,25514,28483,9820,29992
39021,OH,6024,#N/A,5659,8320,4185,3699,3510,#N/A,5638.819921,6180,8146,29688,-4415,-1446,-20109,63,31397,25273,28242,9579,29751
39023,OH,6564,#N/A,5659,8320,4185,3699,3578,#N/A,5111.448274,6180,7818,29373,-4415,-1446,-20109,63,32005,24958,27927,9264,29436
39025,OH,6648,#N/A,5659,8320,4185,3699,3589,#N/A,5435.984672,6180,8337,30300,-4238,-1269,-19800,240,32100,26062,29031,10500,30540
39027,OH,5748,#N/A,5659,8320,4185,3699,3476,#N/A,4847.76245,6180,8046,28521,-4415,-1446,-20109,63,31087,24106,27075,8412,28584
39029,OH,5712,#N/A,5659,8320,4185,3699,3471,#N/A,5050.597699,6180,7822,28464,-4415,-1446,-20109,63,31046,24049,27018,8355,28527
39031,OH,5772,#N/A,5659,8320,4185,3699,3479,#N/A,4624.643676,6180,7814,28090,-4415,-1446,-20109,63,31114,23675,26644,7981,28153
39033,OH,5532,#N/A,5659,8320,4185,3699,3448,#N/A,5354.850573,6180,7689,28455,-4591,-1622,-20417,-113,30843,23864,26833,8038,28342
39035,OH,7104,#N/A,5659,8320,4185,3699,3646,#N/A,5699.670496,6180,7983,30666,-4238,-1269,-19800,240,32613,26428,29397,10866,30906
39037,OH,6072,#N/A,5659,8320,4185,3699,3516,#N/A,4766.628351,6180,7933,28651,-4415,-1446,-20109,63,31451,24236,27205,8542,28714
39039,OH,5712,#N/A,5659,8320,4185,3699,3471,#N/A,4705.777776,6180,8109,28406,-4415,-1446,-20109,63,31046,23991,26960,8297,28469
39041,OH,7440,#N/A,5659,8320,4185,3699,3689,#N/A,5740.237546,6180,8336,31395,-4062,-1093,-19492,416,32992,27333,30302,11903,31811
39043,OH,7740,#N/A,5659,8320,4185,3699,3726,#N/A,4888.3295,6180,7920,30427,-4062,-1093,-19492,416,33329,26365,29334,10935,30843
39045,OH,7440,#N/A,5659,8320,4185,3699,3689,#N/A,5415.701147,6180,8337,31072,-4062,-1093,-19492,416,32992,27010,29979,11580,31488
39047,OH,6216,#N/A,5659,8320,4185,3699,3535,#N/A,4705.777776,6180,7489,28290,-4415,-1446,-20109,63,31614,23875,26844,8181,28353
39049,OH,7440,#N/A,5659,8320,4185,3699,3689,#N/A,5618.536396,6180,8339,31276,-4062,-1093,-19492,416,32992,27214,30183,11784,31692
39051,OH,6192,#N/A,5659,8320,4185,3699,3532,#N/A,5577.969346,6180,7938,29587,-4415,-1446,-20109,63,31587,25172,28141,9478,29650
39053,OH,5928,#N/A,5659,8320,4185,3699,3498,#N/A,4685.494251,6180,7461,27953,-4591,-1622,-20417,-113,31289,23362,26331,7536,27840
39055,OH,7104,#N/A,5659,8320,4185,3699,3646,#N/A,6348.743292,6180,8049,31380,-4238,-1269,-19800,240,32613,27142,30111,11580,31620
39057,OH,6516,#N/A,5659,8320,4185,3699,3572,#N/A,5354.850573,6180,7894,29644,-4415,-1446,-20109,63,31951,25229,28198,9535,29707
39059,OH,5772,#N/A,5659,8320,4185,3699,3479,#N/A,4746.344826,6180,7552,27950,-4591,-1622,-20417,-113,31114,23359,26328,7533,27837
39061,OH,6648,#N/A,5659,8320,4185,3699,3589,#N/A,5375.134097,6180,8338,30240,-4238,-1269,-19800,240,32100,26002,28971,10440,30480
39063,OH,5892,#N/A,5659,8320,4185,3699,3494,#N/A,5618.536396,6180,8106,29496,-4415,-1446,-20109,63,31249,25081,28050,9387,29559
39065,OH,5748,#N/A,5659,8320,4185,3699,3476,#N/A,5375.134097,6180,8320,29322,-4415,-1446,-20109,63,31087,24907,27876,9213,29385
39067,OH,6132,#N/A,5659,8320,4185,3699,3524,#N/A,5172.298848,6180,8320,29503,-4415,-1446,-20109,63,31519,25088,28057,9394,29566
39069,OH,6180,#N/A,5659,8320,4185,3699,3530,#N/A,5415.701147,6180,8320,29795,-4238,-1269,-19800,240,31573,25557,28526,9995,30035
39071,OH,5604,#N/A,5659,8320,4185,3699,3458,#N/A,5172.298848,6180,8320,28975,-4415,-1446,-20109,63,30925,24560,27529,8866,29038
39073,OH,5760,#N/A,5659,8320,4185,3699,3477,#N/A,5496.835247,6180,8338,29474,-4415,-1446,-20109,63,31100,25059,28028,9365,29537
39075,OH,5700,#N/A,5659,8320,4185,3699,3470,#N/A,5719.954021,6180,8320,29619,-4415,-1446,-20109,63,31033,25204,28173,9510,29682
39077,OH,5568,#N/A,5659,8320,4185,3699,3453,#N/A,4786.911875,6180,8224,28458,-4415,-1446,-20109,63,30884,24043,27012,8349,28521
39079,OH,6156,#N/A,5659,8320,4185,3699,3527,#N/A,5273.716473,6180,7344,28653,-4415,-1446,-20109,63,31546,24238,27207,8544,28716
39081,OH,5988,#N/A,5659,8320,4185,3699,3506,#N/A,5070.881224,6180,7665,28603,-4415,-1446,-20109,63,31357,24188,27157,8494,28666
39083,OH,6180,#N/A,5659,8320,4185,3699,3530,#N/A,5091.164749,6180,8136,29286,-4415,-1446,-20109,63,31573,24871,27840,9177,29349
39085,OH,7104,#N/A,5659,8320,4185,3699,3646,#N/A,5699.670496,6180,8025,30708,-4238,-1269,-19800,240,32613,26470,29439,10908,30948
39087,OH,6276,#N/A,5659,8320,4185,3699,3542,#N/A,5050.597699,6180,7780,28986,-4415,-1446,-20109,63,31681,24571,27540,8877,29049
39089,OH,7440,#N/A,5659,8320,4185,3699,3689,#N/A,5375.134097,6180,8339,31033,-4062,-1093,-19492,416,32992,26971,29940,11541,31449
39091,OH,5592,#N/A,5659,8320,4185,3699,3456,#N/A,4847.76245,6180,7992,28311,-4415,-1446,-20109,63,30911,23896,26865,8202,28374
39093,OH,7104,#N/A,5659,8320,4185,3699,3646,#N/A,5435.984672,6180,8030,30449,-4238,-1269,-19800,240,32613,26211,29180,10649,30689
39095,OH,6192,#N/A,5659,8320,4185,3699,3532,#N/A,5273.716473,6180,7911,29256,-4415,-1446,-20109,63,31587,24841,27810,9147,29319
39097,OH,7440,#N/A,5659,8320,4185,3699,3689,#N/A,5719.954021,6180,8338,31377,-4062,-1093,-19492,416,32992,27315,30284,11885,31793
39099,OH,6180,#N/A,5659,8320,4185,3699,3530,#N/A,5273.716473,6180,7713,29046,-4415,-1446,-20109,63,31573,24631,27600,8937,29109
39101,OH,6540,#N/A,5659,8320,4185,3699,3575,#N/A,4928.89655,6180,7735,29083,-4415,-1446,-20109,63,31978,24668,27637,8974,29146
39103,OH,7104,#N/A,5659,8320,4185,3699,3646,#N/A,5679.386971,6180,8034,30696,-4238,-1269,-19800,240,32613,26458,29427,10896,30936
39105,OH,5556,#N/A,5659,8320,4185,3699,3452,#N/A,5638.819921,6180,8320,29394,-4415,-1446,-20109,63,30871,24979,27948,9285,29457
39107,OH,5448,#N/A,5659,8320,4185,3699,3438,#N/A,4604.360151,6180,8352,28283,-4415,-1446,-20109,63,30749,23868,26837,8174,28346
39109,OH,6516,#N/A,5659,8320,4185,3699,3572,#N/A,5131.731799,6180,7913,29439,-4415,-1446,-20109,63,31951,25024,27993,9330,29502
39111,OH,6216,#N/A,5659,8320,4185,3699,3535,#N/A,5233.149423,6180,8320,29648,-4238,-1269,-19800,240,31614,25410,28379,9848,29888
39113,OH,6516,#N/A,5659,8320,4185,3699,3572,#N/A,5192.582373,6180,7865,29453,-4415,-1446,-20109,63,31951,25038,28007,9344,29516
39115,OH,6000,#N/A,5659,8320,4185,3699,3507,#N/A,5152.015324,6180,8320,29351,-4415,-1446,-20109,63,31370,24936,27905,9242,29414
39117,OH,7440,#N/A,5659,8320,4185,3699,3689,#N/A,5577.969346,6180,8338,31235,-4062,-1093,-19492,416,32992,27173,30142,11743,31651
39119,OH,6216,#N/A,5659,8320,4185,3699,3535,#N/A,5010.030649,6180,7849,28954,-4415,-1446,-20109,63,31614,24539,27508,8845,29017
39121,OH,5772,#N/A,5659,8320,4185,3699,3479,#N/A,5030.314174,6180,8320,29001,-4415,-1446,-20109,63,31114,24586,27555,8892,29064
39123,OH,6192,#N/A,5659,8320,4185,3699,3532,#N/A,5922.78927,6180,8021,30015,-4415,-1446,-20109,63,31587,25600,28569,9906,30078
39125,OH,5832,#N/A,5659,8320,4185,3699,3486,#N/A,5192.582373,6180,8320,29224,-4415,-1446,-20109,63,31181,24809,27778,9115,29287
39127,OH,5448,#N/A,5659,8320,4185,3699,3438,#N/A,5517.118772,6180,8338,29182,-4415,-1446,-20109,63,30749,24767,27736,9073,29245
39129,OH,7440,#N/A,5659,8320,4185,3699,3689,#N/A,4868.045975,6180,8337,30524,-4062,-1093,-19492,416,32992,26462,29431,11032,30940
39131,OH,6216,#N/A,5659,8320,4185,3699,3535,#N/A,5273.716473,6180,8320,29689,-4238,-1269,-19800,240,31614,25451,28420,9889,29929
39133,OH,6648,#N/A,5659,8320,4185,3699,3589,#N/A,5760.52107,6180,8159,30447,-4238,-1269,-19800,240,32100,26209,29178,10647,30687
39135,OH,5832,#N/A,5659,8320,4185,3699,3486,#N/A,5273.716473,6180,8320,29305,-4415,-1446,-20109,63,31181,24890,27859,9196,29368
39137,OH,5688,#N/A,5659,8320,4185,3699,3468,#N/A,5233.149423,6180,8320,29120,-4415,-1446,-20109,63,31019,24705,27674,9011,29183
39139,OH,5544,#N/A,5659,8320,4185,3699,3450,#N/A,5212.865898,6180,7766,28402,-4591,-1622,-20417,-113,30857,23811,26780,7985,28289
39141,OH,6228,#N/A,5659,8320,4185,3699,3536,#N/A,4888.3295,6180,7761,28756,-4415,-1446,-20109,63,31627,24341,27310,8647,28819
39143,OH,6048,#N/A,5659,8320,4185,3699,3513,#N/A,4888.3295,6180,8054,28869,-4415,-1446,-20109,63,31424,24454,27423,8760,28932
39145,OH,6216,#N/A,5659,8320,4185,3699,3535,#N/A,4969.4636,6180,7276,28341,-4415,-1446,-20109,63,31614,23926,26895,8232,28404
39147,OH,5712,#N/A,5659,8320,4185,3699,3471,#N/A,4969.4636,6180,7958,28519,-4415,-1446,-20109,63,31046,24104,27073,8410,28582
39149,OH,5832,#N/A,5659,8320,4185,3699,3486,#N/A,4868.045975,6180,8325,28904,-4415,-1446,-20109,63,31181,24489,27458,8795,28967
39151,OH,6108,#N/A,5659,8320,4185,3699,3521,#N/A,5354.850573,6180,7980,29322,-4415,-1446,-20109,63,31492,24907,27876,9213,29385
39153,OH,6648,#N/A,5659,8320,4185,3699,3589,#N/A,5577.969346,6180,8148,30253,-4238,-1269,-19800,240,32100,26015,28984,10453,30493
39155,OH,6180,#N/A,5659,8320,4185,3699,3530,#N/A,5152.015324,6180,7736,28947,-4415,-1446,-20109,63,31573,24532,27501,8838,29010
39157,OH,5892,#N/A,5659,8320,4185,3699,3494,#N/A,5192.582373,6180,8004,28968,-4415,-1446,-20109,63,31249,24553,27522,8859,29031
39159,OH,7188,#N/A,5659,8320,4185,3699,3657,#N/A,5070.881224,6180,8339,30476,-4062,-1093,-19492,416,32708,26414,29383,10984,30892
39161,OH,5532,#N/A,5659,8320,4185,3699,3448,#N/A,5618.536396,6180,8017,29047,-4415,-1446,-20109,63,30843,24632,27601,8938,29110
39163,OH,6216,#N/A,5659,8320,4185,3699,3535,#N/A,5111.448274,6180,8320,29526,-4238,-1269,-19800,240,31614,25288,28257,9726,29766
39165,OH,6648,#N/A,5659,8320,4185,3699,3589,#N/A,5395.417622,6180,8339,30261,-4238,-1269,-19800,240,32100,26023,28992,10461,30501
39167,OH,5640,#N/A,5659,8320,4185,3699,3462,#N/A,5253.432948,6180,7756,28529,-4591,-1622,-20417,-113,30965,23938,26907,8112,28416
39169,OH,6072,#N/A,5659,8320,4185,3699,3516,#N/A,5030.314174,6180,8253,29234,-4415,-1446,-20109,63,31451,24819,27788,9125,29297
39171,OH,5520,#N/A,5659,8320,4185,3699,3447,#N/A,5354.850573,6180,8320,29074,-4415,-1446,-20109,63,30830,24659,27628,8965,29137
39173,OH,6192,#N/A,5659,8320,4185,3699,3532,#N/A,5212.865898,6180,7928,29212,-4415,-1446,-20109,63,31587,24797,27766,9103,29275
39175,OH,6216,#N/A,5659,8320,4185,3699,3535,#N/A,5537.402297,6180,8320,29952,-4238,-1269,-19800,240,31614,25714,28683,10152,30192
40001,OK,5316,#N/A,5540,8554,4910,3916,3535,#N/A,5381.24532,7004,8554,30171,-4274,-1871,-20402,-362,31771,25897,28300,9769,29809
40003,OK,5316,#N/A,5540,8554,4910,3916,3535,#N/A,5301.817345,7004,8554,30092,-4274,-1871,-20402,-362,31771,25818,28221,9690,29730
40005,OK,5316,#N/A,5540,8554,4910,3916,3535,#N/A,5659.243233,7004,8554,30449,-4274,-1871,-20402,-362,31771,26175,28578,10047,30087
40007,OK,5520,#N/A,5540,8554,4910,3916,3561,#N/A,5520.244277,7004,8554,30514,-4274,-1871,-20402,-362,32001,26240,28643,10112,30152
40009,OK,6060,#N/A,5540,8554,4910,3916,3628,#N/A,5897.527159,7004,8458,31336,-4274,-1871,-20402,-362,32608,27062,29465,10934,30974
40011,OK,5616,#N/A,5540,8554,4910,3916,3573,#N/A,5758.528202,7004,8554,30849,-4274,-1871,-20402,-362,32109,26575,28978,10447,30487
40013,OK,5664,#N/A,5540,8554,4910,3916,3579,#N/A,5679.100227,7004,7805,30068,-4483,-2080,-20743,-571,32163,25585,27988,9325,29497
40015,OK,5652,#N/A,5540,8554,4910,3916,3577,#N/A,5500.387283,7004,8554,30626,-4274,-1871,-20402,-362,32149,26352,28755,10224,30264
40017,OK,6780,#N/A,5540,8554,4910,3916,3719,#N/A,6254.953048,7004,8514,32469,-4066,-1663,-20062,-154,33419,28403,30806,12407,32315
40019,OK,5496,#N/A,5540,8554,4910,3916,3558,#N/A,5202.532376,7004,8257,29876,-4274,-1871,-20402,-362,31974,25602,28005,9474,29514
40021,OK,5976,#N/A,5540,8554,4910,3916,3618,#N/A,5401.102314,7004,7814,30111,-4274,-1871,-20402,-362,32514,25837,28240,9709,29749
40023,OK,5412,#N/A,5540,8554,4910,3916,3547,#N/A,5698.957221,7004,8554,30585,-4274,-1871,-20402,-362,31879,26311,28714,10183,30223
40025,OK,6072,#N/A,5540,8554,4910,3916,3630,#N/A,5659.243233,7004,8554,31205,-4066,-1663,-20062,-154,32622,27139,29542,11143,31051
40027,OK,6780,#N/A,5540,8554,4910,3916,3719,#N/A,5857.813171,7004,8512,32070,-4066,-1663,-20062,-154,33419,28004,30407,12008,31916
40029,OK,5316,#N/A,5540,8554,4910,3916,3535,#N/A,5738.671209,7004,8554,30529,-4274,-1871,-20402,-362,31771,26255,28658,10127,30167
40031,OK,6480,#N/A,5540,8554,4910,3916,3681,#N/A,5420.959308,7004,8326,31147,-4066,-1663,-20062,-154,33081,27081,29484,11085,30993
40033,OK,5364,#N/A,5540,8554,4910,3916,3541,#N/A,5401.102314,7004,8361,30046,-4274,-1871,-20402,-362,31825,25772,28175,9644,29684
40035,OK,6072,#N/A,5540,8554,4910,3916,3630,#N/A,5401.102314,7004,8554,30947,-4066,-1663,-20062,-154,32622,26881,29284,10885,30793
40037,OK,6804,#N/A,5540,8554,4910,3916,3722,#N/A,5599.672252,7004,8403,31727,-4066,-1663,-20062,-154,33446,27661,30064,11665,31573
40039,OK,5952,#N/A,5540,8554,4910,3916,3615,#N/A,5897.527159,7004,8387,31157,-4274,-1871,-20402,-362,32487,26883,29286,10755,30795
40041,OK,5520,#N/A,5540,8554,4910,3916,3561,#N/A,5520.244277,7004,8554,30514,-4274,-1871,-20402,-362,32001,26240,28643,10112,30152
40043,OK,5520,#N/A,5540,8554,4910,3916,3561,#N/A,5917.384153,7004,8554,30911,-4274,-1871,-20402,-362,32001,26637,29040,10509,30549
40045,OK,6072,#N/A,5540,8554,4910,3916,3630,#N/A,5837.956178,7004,8554,31384,-4066,-1663,-20062,-154,32622,27318,29721,11322,31230
40047,OK,6252,#N/A,5540,8554,4910,3916,3652,#N/A,5103.247407,7004,8308,30584,-4066,-1663,-20062,-154,32824,26518,28921,10522,30430
40049,OK,5316,#N/A,5540,8554,4910,3916,3535,#N/A,5698.957221,7004,8554,30489,-4274,-1871,-20402,-362,31771,26215,28618,10087,30127
40051,OK,5316,#N/A,5540,8554,4910,3916,3535,#N/A,5659.243233,7004,8512,30407,-4274,-1871,-20402,-362,31771,26133,28536,10005,30045
40053,OK,6072,#N/A,5540,8554,4910,3916,3630,#N/A,5123.104401,7004,8554,30669,-4066,-1663,-20062,-154,32622,26603,29006,10607,30515
40055,OK,6336,#N/A,5540,8554,4910,3916,3663,#N/A,5738.671209,7004,8554,31549,-4066,-1663,-20062,-154,32919,27483,29886,11487,31395
40057,OK,5520,#N/A,5540,8554,4910,3916,3561,#N/A,5798.24219,7004,8554,30792,-4274,-1871,-20402,-362,32001,26518,28921,10390,30430
40059,OK,5520,#N/A,5540,8554,4910,3916,3561,#N/A,5877.670165,7004,8554,30872,-4274,-1871,-20402,-362,32001,26598,29001,10470,30510
40061,OK,5316,#N/A,5540,8554,4910,3916,3535,#N/A,5361.388326,7004,8554,30151,-4274,-1871,-20402,-362,31771,25877,28280,9749,29789
40063,OK,6072,#N/A,5540,8554,4910,3916,3630,#N/A,5659.243233,7004,8554,31205,-4066,-1663,-20062,-154,32622,27139,29542,11143,31051
40065,OK,5496,#N/A,5540,8554,4910,3916,3558,#N/A,5579.815258,7004,8179,30175,-4274,-1871,-20402,-362,31974,25901,28304,9773,29813
40067,OK,5316,#N/A,5540,8554,4910,3916,3535,#N/A,5420.959308,7004,8554,30211,-4274,-1871,-20402,-362,31771,25937,28340,9809,29849
40069,OK,5316,#N/A,5540,8554,4910,3916,3535,#N/A,5480.530289,7004,8554,30271,-4274,-1871,-20402,-362,31771,25997,28400,9869,29909
40071,OK,5640,#N/A,5540,8554,4910,3916,3576,#N/A,4924.534463,7004,8062,29547,-4274,-1871,-20402,-362,32136,25273,27676,9145,29185
40073,OK,5856,#N/A,5540,8554,4910,3916,3603,#N/A,5599.672252,7004,8554,30930,-4274,-1871,-20402,-362,32379,26656,29059,10528,30568
40075,OK,5328,#N/A,5540,8554,4910,3916,3537,#N/A,5540.101271,7004,8554,30342,-4274,-1871,-20402,-362,31785,26068,28471,9940,29980
40077,OK,5736,#N/A,5540,8554,4910,3916,3588,#N/A,5460.673295,7004,8554,30671,-4274,-1871,-20402,-362,32244,26397,28800,10269,30309
40079,OK,5712,#N/A,5540,8554,4910,3916,3585,#N/A,5321.674339,7004,7842,29796,-4274,-1871,-20402,-362,32217,25522,27925,9394,29434
40081,OK,5796,#N/A,5540,8554,4910,3916,3595,#N/A,5619.529246,7004,8514,30849,-4274,-1871,-20402,-362,32311,26575,28978,10447,30487
40083,OK,6780,#N/A,5540,8554,4910,3916,3719,#N/A,5877.670165,7004,8512,32090,-4066,-1663,-20062,-154,33419,28024,30427,12028,31936
40085,OK,6072,#N/A,5540,8554,4910,3916,3630,#N/A,5579.815258,7004,8554,31126,-4066,-1663,-20062,-154,32622,27060,29463,11064,30972
40087,OK,6780,#N/A,5540,8554,4910,3916,3719,#N/A,5758.528202,7004,8514,31973,-4066,-1663,-20062,-154,33419,27907,30310,11911,31819
40089,OK,5316,#N/A,5540,8554,4910,3916,3535,#N/A,5619.529246,7004,8554,30410,-4274,-1871,-20402,-362,31771,26136,28539,10008,30048
40091,OK,5340,#N/A,5540,8554,4910,3916,3538,#N/A,5718.814215,7004,8554,30533,-4274,-1871,-20402,-362,31798,26259,28662,10131,30171
40093,OK,5520,#N/A,5540,8554,4910,3916,3561,#N/A,5381.24532,7004,8554,30375,-4274,-1871,-20402,-362,32001,26101,28504,9973,30013
40095,OK,5460,#N/A,5540,8554,4910,3916,3553,#N/A,5420.959308,7004,8554,30355,-4274,-1871,-20402,-362,31933,26081,28484,9953,29993
40097,OK,5316,#N/A,5540,8554,4910,3916,3535,#N/A,5540.101271,7004,8554,30330,-4274,-1871,-20402,-362,31771,26056,28459,9928,29968
40099,OK,5496,#N/A,5540,8554,4910,3916,3558,#N/A,5500.387283,7004,8554,30470,-4274,-1871,-20402,-362,31974,26196,28599,10068,30108
40101,OK,5484,#N/A,5540,8554,4910,3916,3556,#N/A,5639.38624,7004,7630,29674,-4483,-2080,-20743,-571,31960,25191,27594,8931,29103
40103,OK,6072,#N/A,5540,8554,4910,3916,3630,#N/A,5520.244277,7004,8554,31066,-4066,-1663,-20062,-154,32622,27000,29403,11004,30912
40105,OK,5808,#N/A,5540,8554,4910,3916,3597,#N/A,5520.244277,7004,8554,30802,-4274,-1871,-20402,-362,32325,26528,28931,10400,30440
40107,OK,6036,#N/A,5540,8554,4910,3916,3625,#N/A,5698.957221,7004,8554,31209,-4066,-1663,-20062,-154,32581,27143,29546,11147,31055
40109,OK,6780,#N/A,5540,8554,4910,3916,3719,#N/A,5520.244277,7004,8515,31735,-4066,-1663,-20062,-154,33419,27669,30072,11673,31581
40111,OK,6120,#N/A,5540,8554,4910,3916,3636,#N/A,5480.530289,7004,8399,30919,-4274,-1871,-20402,-362,32676,26645,29048,10517,30557
40113,OK,6804,#N/A,5540,8554,4910,3916,3722,#N/A,5698.957221,7004,8408,31831,-4066,-1663,-20062,-154,33446,27765,30168,11769,31677
40115,OK,5556,#N/A,5540,8554,4910,3916,3565,#N/A,5182.675382,7004,7701,29360,-4483,-2080,-20743,-571,32041,24877,27280,8617,28789
40117,OK,6072,#N/A,5540,8554,4910,3916,3630,#N/A,5599.672252,7004,8403,30994,-4274,-1871,-20402,-362,32622,26720,29123,10592,30632
40119,OK,6480,#N/A,5540,8554,4910,3916,3681,#N/A,6115.954091,7004,7643,31159,-4274,-1871,-20402,-362,33081,26885,29288,10757,30797
40121,OK,6012,#N/A,5540,8554,4910,3916,3622,#N/A,5599.672252,7004,7840,30372,-4274,-1871,-20402,-362,32554,26098,28501,9970,30010
40123,OK,6072,#N/A,5540,8554,4910,3916,3630,#N/A,5778.385196,7004,8203,30973,-4274,-1871,-20402,-362,32622,26699,29102,10571,30611
40125,OK,6444,#N/A,5540,8554,4910,3916,3676,#N/A,6016.669122,7004,8170,31550,-4066,-1663,-20062,-154,33040,27484,29887,11488,31396
40127,OK,5316,#N/A,5540,8554,4910,3916,3535,#N/A,5619.529246,7004,8554,30410,-4274,-1871,-20402,-362,31771,26136,28539,10008,30048
40129,OK,5520,#N/A,5540,8554,4910,3916,3561,#N/A,5917.384153,7004,8554,30911,-4274,-1871,-20402,-362,32001,26637,29040,10509,30549
40131,OK,6804,#N/A,5540,8554,4910,3916,3722,#N/A,5758.528202,7004,8401,31883,-4066,-1663,-20062,-154,33446,27817,30220,11821,31729
40133,OK,5712,#N/A,5540,8554,4910,3916,3585,#N/A,5559.958264,7004,8554,30746,-4274,-1871,-20402,-362,32217,26472,28875,10344,30384
40135,OK,5496,#N/A,5540,8554,4910,3916,3558,#N/A,5341.531333,7004,7849,29606,-4483,-2080,-20743,-571,31974,25123,27526,8863,29035
40137,OK,5316,#N/A,5540,8554,4910,3916,3535,#N/A,5818.099184,7004,8125,30179,-4483,-2080,-20743,-571,31771,25696,28099,9436,29608
40139,OK,6216,#N/A,5540,8554,4910,3916,3648,#N/A,5540.101271,7004,8885,31561,-4066,-1663,-20062,-154,32784,27495,29898,11499,31407
40141,OK,5412,#N/A,5540,8554,4910,3916,3547,#N/A,5401.102314,7004,8554,30287,-4274,-1871,-20402,-362,31879,26013,28416,9885,29925
40143,OK,6804,#N/A,5540,8554,4910,3916,3722,#N/A,5480.530289,7004,8393,31598,-4066,-1663,-20062,-154,33446,27532,29935,11536,31444
40145,OK,6804,#N/A,5540,8554,4910,3916,3722,#N/A,5778.385196,7004,8407,31909,-4066,-1663,-20062,-154,33446,27843,30246,11847,31755
40147,OK,6516,#N/A,5540,8554,4910,3916,3685,#N/A,5202.532376,7004,8164,30802,-4066,-1663,-20062,-154,33121,26736,29139,10740,30648
40149,OK,6072,#N/A,5540,8554,4910,3916,3630,#N/A,5837.956178,7004,8554,31384,-4066,-1663,-20062,-154,32622,27318,29721,11322,31230
40151,OK,5340,#N/A,5540,8554,4910,3916,3538,#N/A,5361.388326,7004,8554,30175,-4274,-1871,-20402,-362,31798,25901,28304,9773,29813
40153,OK,6072,#N/A,5540,8554,4910,3916,3630,#N/A,5818.099184,7004,8623,31434,-4066,-1663,-20062,-154,32622,27368,29771,11372,31280
41001,OR,6168,#N/A,6612,7382,4839,3971,5366,#N/A,6825.415088,6290,7382,30636,-217,-814,-19345,695,34338,30419,29822,11291,31331
41003,OR,7548,#N/A,6612,7382,4839,3971,5621,#N/A,7346.800963,6290,7068,32224,49,-548,-18947,961,35973,32273,31676,13277,33185
41005,OR,9288,#N/A,6612,7382,4839,3971,5943,#N/A,7157.206099,6290,7417,34123,3890,3293,-14842,4802,38035,38013,37416,19281,38925
41007,OR,6816,#N/A,6612,7382,4839,3971,5486,#N/A,6706.918299,6290,6959,30743,-217,-814,-19345,695,35106,30526,29929,11398,31438
41009,OR,9288,#N/A,6612,7382,4839,3971,5943,#N/A,7370.500321,6290,7422,34341,3890,3293,-14842,4802,38035,38231,37634,19499,39143
41011,OR,6360,#N/A,6612,7382,4839,3971,5401,#N/A,7038.70931,6290,6501,30161,-484,-1081,-19744,428,34565,29677,29080,10417,30589
41013,OR,6600,#N/A,6612,7382,4839,3971,5446,#N/A,11873.37833,6290,6530,35264,-217,-814,-19345,695,34850,35047,34450,15919,35959
41015,OR,7092,#N/A,6612,7382,4839,3971,5537,#N/A,7536.395827,6290,6369,31258,-217,-814,-19345,695,35433,31041,30444,11913,31953
41017,OR,7740,#N/A,6612,7382,4839,3971,5657,#N/A,7109.807384,6290,7086,32197,49,-548,-18947,961,36201,32246,31649,13250,33158
41019,OR,5952,#N/A,6612,7382,4839,3971,5326,#N/A,6469.924719,6290,6748,29431,-484,-1081,-19744,428,34082,28947,28350,9687,29859
41021,OR,5808,#N/A,6612,7382,4839,3971,5299,#N/A,6920.21252,6290,7382,30371,-217,-814,-19345,695,33911,30154,29557,11026,31066
41023,OR,5940,#N/A,6612,7382,4839,3971,5323,#N/A,6564.722151,6290,7382,30148,-217,-814,-19345,695,34067,29931,29334,10803,30843
41025,OR,5652,#N/A,6612,7382,4839,3971,5270,#N/A,6754.317014,6290,7382,30049,-484,-1081,-19744,428,33726,29565,28968,10305,30477
41027,OR,8448,#N/A,6612,7382,4839,3971,5788,#N/A,7797.088764,6290,7498,34004,3624,3027,-15240,4536,37040,37628,37031,18764,38540
41029,OR,7392,#N/A,6612,7382,4839,3971,5592,#N/A,6612.120867,6290,6873,31139,49,-548,-18947,961,35788,31188,30591,12192,32100
41031,OR,6072,#N/A,6612,7382,4839,3971,5348,#N/A,7204.604815,6290,7382,30920,-217,-814,-19345,695,34224,30703,30106,11575,31615
41033,OR,7416,#N/A,6612,7382,4839,3971,5597,#N/A,7015.009952,6290,6395,31087,-217,-814,-19345,695,35817,30870,30273,11742,31782
41035,OR,6732,#N/A,6612,7382,4839,3971,5470,#N/A,7204.604815,6290,6565,30763,-217,-814,-19345,695,35006,30546,29949,11418,31458
41037,OR,6444,#N/A,6612,7382,4839,3971,5417,#N/A,6754.317014,6290,7382,30841,-217,-814,-19345,695,34665,30624,30027,11496,31536
41039,OR,7452,#N/A,6612,7382,4839,3971,5603,#N/A,6778.016372,6290,6858,31349,49,-548,-18947,961,35859,31398,30801,12402,32310
41041,OR,7212,#N/A,6612,7382,4839,3971,5559,#N/A,7702.291332,6290,6783,31958,-217,-814,-19345,695,35575,31741,31144,12613,32653
41043,OR,6672,#N/A,6612,7382,4839,3971,5459,#N/A,6517.323435,6290,7107,30557,-217,-814,-19345,695,34935,30340,29743,11212,31252
41045,OR,5868,#N/A,6612,7382,4839,3971,5310,#N/A,5995.93756,6290,6690,28815,-484,-1081,-19744,428,33982,28331,27734,9071,29243
41047,OR,6936,#N/A,6612,7382,4839,3971,5508,#N/A,6446.225361,6290,7231,30874,49,-548,-18947,961,35248,30923,30326,11927,31835
41049,OR,5652,#N/A,6612,7382,4839,3971,5270,#N/A,6588.421509,6290,7292,29793,-484,-1081,-19744,428,33726,29309,28712,10049,30221
41051,OR,9288,#N/A,6612,7382,4839,3971,5943,#N/A,7252.003531,6290,7422,34223,3890,3293,-14842,4802,38035,38113,37516,19381,39025
41053,OR,6936,#N/A,6612,7382,4839,3971,5508,#N/A,7038.70931,6290,7242,31477,49,-548,-18947,961,35248,31526,30929,12530,32438
41055,OR,6444,#N/A,6612,7382,4839,3971,5417,#N/A,6730.617656,6290,7382,30818,-217,-814,-19345,695,34665,30601,30004,11473,31513
41057,OR,7284,#N/A,6612,7382,4839,3971,5572,#N/A,7417.899037,6290,7382,32345,49,-548,-18947,961,35660,32394,31797,13398,33306
41059,OR,6312,#N/A,6612,7382,4839,3971,5392,#N/A,6872.813804,6290,7302,30748,-217,-814,-19345,695,34508,30531,29934,11403,31443
41061,OR,5736,#N/A,6612,7382,4839,3971,5286,#N/A,7180.905457,6290,6937,30115,-484,-1081,-19744,428,33826,29631,29034,10371,30543
41063,OR,6120,#N/A,6612,7382,4839,3971,5357,#N/A,6754.317014,6290,7382,30517,-217,-814,-19345,695,34281,30300,29703,11172,31212
41065,OR,6924,#N/A,6612,7382,4839,3971,5506,#N/A,7346.800963,6290,6842,31374,-217,-814,-19345,695,35234,31157,30560,12029,32069
41067,OR,9288,#N/A,6612,7382,4839,3971,5943,#N/A,6778.016372,6290,7419,33746,3890,3293,-14842,4802,38035,37636,37039,18904,38548
41069,OR,5652,#N/A,6612,7382,4839,3971,5270,#N/A,6778.016372,6290,7382,30073,-484,-1081,-19744,428,33726,29589,28992,10329,30501
41071,OR,9288,#N/A,6612,7382,4839,3971,5943,#N/A,6872.813804,6290,7414,33836,3890,3293,-14842,4802,38035,37726,37129,18994,38638
42001,PA,7680,#N/A,6434,6855,4549,3644,4255,#N/A,7679.430699,6616,7022,32641,-2057,-765,-19164,744,33417,30584,31876,13477,33385
42003,PA,7596,#N/A,6434,6855,4549,3644,4243,#N/A,6595.547087,6616,6577,31028,-2263,-972,-19503,537,33321,28765,30056,11525,31565
42005,PA,5652,#N/A,6434,6855,4549,3644,3959,#N/A,6687.792501,6616,6623,29222,-2678,-1386,-20181,123,31093,26544,27836,9041,29345
42007,PA,7596,#N/A,6434,6855,4549,3644,4243,#N/A,6065.135958,6616,6612,30533,-2263,-972,-19503,537,33321,28270,29561,11030,31070
42009,PA,6360,#N/A,6434,6855,4549,3644,4062,#N/A,7195.142277,6616,6855,30670,-2471,-1180,-19843,329,31904,28199,29490,10827,30999
42011,PA,7788,#N/A,6434,6855,4549,3644,4271,#N/A,6549.42438,6616,6908,31505,-2057,-765,-19164,744,33541,29448,30740,12341,32249
42013,PA,6852,#N/A,6434,6855,4549,3644,4134,#N/A,6295.749492,6616,6465,29873,-2263,-972,-19503,537,32468,27610,28901,10370,30410
42015,PA,5772,#N/A,6434,6855,4549,3644,3976,#N/A,5949.82919,6616,6637,28619,-2471,-1180,-19843,329,31230,26148,27439,8776,28948
42017,PA,11304,#N/A,6434,6855,4549,3644,4784,#N/A,7125.958216,6616,7238,35928,2371,3662,-14209,5171,37570,38299,39590,21719,41099
42019,PA,7596,#N/A,6434,6855,4549,3644,4243,#N/A,6595.547087,6616,6617,31068,-2263,-972,-19503,537,33321,28805,30096,11565,31605
42021,PA,6444,#N/A,6434,6855,4549,3644,4074,#N/A,6272.688139,6616,6298,29275,-2471,-1180,-19843,329,32000,26804,28095,9432,29604
42023,PA,6444,#N/A,6434,6855,4549,3644,4074,#N/A,6364.933553,6616,6855,29924,-2471,-1180,-19843,329,32000,27453,28744,10081,30253
42025,PA,9252,#N/A,6434,6855,4549,3644,4484,#N/A,5880.64513,6616,6902,32295,1750,3041,-15226,4550,35218,34045,35336,17069,36845
42027,PA,8916,#N/A,6434,6855,4549,3644,4435,#N/A,7195.142277,6616,6644,33015,1750,3041,-15226,4550,34833,34765,36056,17789,37565
42029,PA,11304,#N/A,6434,6855,4549,3644,4784,#N/A,7956.166941,6616,7230,36750,2371,3662,-14209,5171,37570,39121,40412,22541,41921
42031,PA,6444,#N/A,6434,6855,4549,3644,4074,#N/A,5511.663475,6616,6855,29071,-2471,-1180,-19843,329,32000,26600,27891,9228,29400
42033,PA,5940,#N/A,6434,6855,4549,3644,4001,#N/A,6042.074604,6616,6361,28603,-2678,-1386,-20181,123,31423,25925,27217,8422,28726
42035,PA,6420,#N/A,6434,6855,4549,3644,4071,#N/A,6572.485734,6616,6440,29692,-2471,-1180,-19843,329,31973,27221,28512,9849,30021
42037,PA,6300,#N/A,6434,6855,4549,3644,4053,#N/A,6387.994906,6616,6564,29512,-2471,-1180,-19843,329,31835,27041,28332,9669,29841
42039,PA,6240,#N/A,6434,6855,4549,3644,4045,#N/A,6088.197311,6616,6420,29008,-2471,-1180,-19843,329,31767,26537,27828,9165,29337
42041,PA,7944,#N/A,6434,6855,4549,3644,4293,#N/A,6849.221975,6616,6818,31872,-2057,-765,-19164,744,33719,29815,31107,12708,32616
42043,PA,7944,#N/A,6434,6855,4549,3644,4293,#N/A,6480.24032,6616,6816,31501,-2057,-765,-19164,744,33719,29444,30736,12337,32245
42045,PA,11304,#N/A,6434,6855,4549,3644,4784,#N/A,7241.264984,6616,7267,36072,2371,3662,-14209,5171,37570,38443,39734,21863,41243
42047,PA,6168,#N/A,6434,6855,4549,3644,4034,#N/A,6664.731147,6616,6855,29948,-2471,-1180,-19843,329,31684,27477,28768,10105,30277
42049,PA,6336,#N/A,6434,6855,4549,3644,4059,#N/A,6411.056259,6616,6573,29580,-2471,-1180,-19843,329,31877,27109,28400,9737,29909
42051,PA,7596,#N/A,6434,6855,4549,3644,4243,#N/A,6134.320018,6616,6622,30613,-2263,-972,-19503,537,33321,28350,29641,11110,31150
42053,PA,7032,#N/A,6434,6855,4549,3644,4160,#N/A,5857.583777,6616,6855,30005,-2263,-972,-19503,537,32674,27742,29033,10502,30542
42055,PA,6960,#N/A,6434,6855,4549,3644,4150,#N/A,6434.117613,6616,6798,30452,-2263,-972,-19503,537,32592,28189,29480,10949,30989
42057,PA,6444,#N/A,6434,6855,4549,3644,4074,#N/A,6503.301673,6616,6855,30062,-2471,-1180,-19843,329,32000,27591,28882,10219,30391
42059,PA,6252,#N/A,6434,6855,4549,3644,4046,#N/A,5765.338363,6616,6855,29132,-2471,-1180,-19843,329,31780,26661,27952,9289,29461
42061,PA,6372,#N/A,6434,6855,4549,3644,4064,#N/A,6457.178966,6616,6381,29470,-2471,-1180,-19843,329,31918,26999,28290,9627,29799
42063,PA,6936,#N/A,6434,6855,4549,3644,4146,#N/A,6964.528742,6616,6474,30635,-2263,-972,-19503,537,32564,28372,29663,11132,31172
42065,PA,6276,#N/A,6434,6855,4549,3644,4050,#N/A,5396.356708,6616,6855,28787,-2471,-1180,-19843,329,31808,26316,27607,8944,29116
42067,PA,6324,#N/A,6434,6855,4549,3644,4057,#N/A,6987.590096,6616,6855,30427,-2471,-1180,-19843,329,31863,27956,29247,10584,30756
42069,PA,6684,#N/A,6434,6855,4549,3644,4109,#N/A,6595.547087,6616,6514,30053,-2471,-1180,-19843,329,32275,27582,28873,10210,30382
42071,PA,8436,#N/A,6434,6855,4549,3644,4365,#N/A,6756.976561,6616,6967,32420,1750,3041,-15226,4550,34283,34170,35461,17194,36970
42073,PA,6576,#N/A,6434,6855,4549,3644,4094,#N/A,6134.320018,6616,6447,29418,-2471,-1180,-19843,329,32152,26947,28238,9575,29747
42075,PA,6648,#N/A,6434,6855,4549,3644,4104,#N/A,6341.872199,6616,6861,30111,-2263,-972,-19503,537,32234,27848,29139,10608,30648
42077,PA,9252,#N/A,6434,6855,4549,3644,4484,#N/A,6687.792501,6616,6905,33105,1750,3041,-15226,4550,35218,34855,36146,17879,37655
42079,PA,6684,#N/A,6434,6855,4549,3644,4109,#N/A,6318.810846,6616,6516,29779,-2471,-1180,-19843,329,32275,27308,28599,9936,30108
42081,PA,6204,#N/A,6434,6855,4549,3644,4039,#N/A,6226.565432,6616,6562,29253,-2471,-1180,-19843,329,31725,26782,28073,9410,29582
42083,PA,6120,#N/A,6434,6855,4549,3644,4027,#N/A,6826.160622,6616,6312,29518,-2471,-1180,-19843,329,31629,27047,28338,9675,29847
42085,PA,5976,#N/A,6434,6855,4549,3644,4006,#N/A,5626.970242,6616,6368,28231,-2471,-1180,-19843,329,31464,25760,27051,8388,28560
42087,PA,5952,#N/A,6434,6855,4549,3644,4003,#N/A,5696.154302,6616,6380,28288,-2471,-1180,-19843,329,31437,25817,27108,8445,28617
42089,PA,7992,#N/A,6434,6855,4549,3644,4300,#N/A,6411.056259,6616,7026,31689,-2057,-765,-19164,744,33774,29632,30924,12525,32433
42091,PA,11304,#N/A,6434,6855,4549,3644,4784,#N/A,6872.283328,6616,7249,35685,2371,3662,-14209,5171,37570,38056,39347,21476,40856
42093,PA,7008,#N/A,6434,6855,4549,3644,4157,#N/A,6387.994906,6616,6566,30222,-2263,-972,-19503,537,32647,27959,29250,10719,30759
42095,PA,9252,#N/A,6434,6855,4549,3644,4484,#N/A,6756.976561,6616,6903,33172,1750,3041,-15226,4550,35218,34922,36213,17946,37722
42097,PA,6300,#N/A,6434,6855,4549,3644,4053,#N/A,6618.608441,6616,6258,29437,-2471,-1180,-19843,329,31835,26966,28257,9594,29766
42099,PA,7944,#N/A,6434,6855,4549,3644,4293,#N/A,6803.099268,6616,6826,31833,-2057,-765,-19164,744,33719,29776,31068,12669,32577
42101,PA,11304,#N/A,6434,6855,4549,3644,4784,#N/A,6618.608441,6616,7330,35513,2371,3662,-14209,5171,37570,37884,39175,21304,40684
42103,PA,10956,#N/A,6434,6855,4549,3644,4733,#N/A,7218.20363,6616,7360,35794,2371,3662,-14209,5171,37171,38165,39456,21585,40965
42105,PA,6444,#N/A,6434,6855,4549,3644,4074,#N/A,6065.135958,6616,6855,29624,-2471,-1180,-19843,329,32000,27153,28444,9781,29953
42107,PA,5868,#N/A,6434,6855,4549,3644,3990,#N/A,6157.381371,6616,6416,28702,-2678,-1386,-20181,123,31340,26024,27316,8521,28825
42109,PA,6528,#N/A,6434,6855,4549,3644,4087,#N/A,5995.951897,6616,6715,29499,-2471,-1180,-19843,329,32097,27028,28319,9656,29828
42111,PA,6288,#N/A,6434,6855,4549,3644,4052,#N/A,5880.64513,6616,6477,28906,-2471,-1180,-19843,329,31822,26435,27726,9063,29235
42113,PA,6156,#N/A,6434,6855,4549,3644,4032,#N/A,6434.117613,6616,6855,29705,-2471,-1180,-19843,329,31670,27234,28525,9862,30034
42115,PA,6852,#N/A,6434,6855,4549,3644,4134,#N/A,7656.369346,6616,6855,31623,-2263,-972,-19503,537,32468,29360,30651,12120,32160
42117,PA,6552,#N/A,6434,6855,4549,3644,4090,#N/A,6618.608441,6616,6855,30286,-2263,-972,-19503,537,32124,28023,29314,10783,30823
42119,PA,6228,#N/A,6434,6855,4549,3644,4043,#N/A,7125.958216,6616,6325,29939,-2471,-1180,-19843,329,31753,27468,28759,10096,30268
42121,PA,5760,#N/A,6434,6855,4549,3644,3975,#N/A,5742.277009,6616,6408,28170,-2678,-1386,-20181,123,31217,25492,26784,7989,28293
42123,PA,6348,#N/A,6434,6855,4549,3644,4060,#N/A,5442.479414,6616,6464,28514,-2471,-1180,-19843,329,31890,26043,27334,8671,28843
42125,PA,7596,#N/A,6434,6855,4549,3644,4243,#N/A,6895.344682,6616,6612,31364,-2263,-972,-19503,537,33321,29101,30392,11861,31901
42127,PA,7176,#N/A,6434,6855,4549,3644,4181,#N/A,6987.590096,6616,6855,31279,-2263,-972,-19503,537,32839,29016,30307,11776,31816
42129,PA,7596,#N/A,6434,6855,4549,3644,4243,#N/A,6457.178966,6616,6615,30929,-2263,-972,-19503,537,33321,28666,29957,11426,31466
42131,PA,6684,#N/A,6434,6855,4549,3644,4109,#N/A,6710.853854,6616,6552,30207,-2471,-1180,-19843,329,32275,27736,29027,10364,30536
42133,PA,7560,#N/A,6434,6855,4549,3644,4237,#N/A,6710.853854,6616,6988,31518,-2057,-765,-19164,744,33279,29461,30753,12354,32262
44001,RI,8976,#N/A,6434,6855,5003,3644,4720,#N/A,9109.234613,6352,6855,34936,3540,2371,-15896,3880,35632,38476,37307,19040,38816
44003,RI,8976,#N/A,6434,6855,5003,3644,4720,#N/A,6803.099268,6352,6855,32630,3540,2371,-15896,3880,35632,36170,35001,16734,36510
44005,RI,10265,#N/A,6434,6855,5003,3644,4917,#N/A,7172.080923,6352,6855,34288,3753,2585,-15550,4094,37118,38041,36873,18738,38382
44007,RI,8976,#N/A,6434,6855,5003,3644,4720,#N/A,6457.178966,6352,6855,32284,3540,2371,-15896,3880,35632,35824,34655,16388,36164
44009,RI,8861,#N/A,6434,6855,5003,3644,4703,#N/A,8163.719122,6352,6855,33876,3540,2371,-15896,3880,35500,37416,36247,17980,37756
45001,SC,5700,#N/A,5540,8554,4618,3916,4397,#N/A,5440.816302,7412,7612,30081,-1911,-2709,-21240,-1200,32725,28170,27372,8841,28881
45003,SC,7344,#N/A,5540,8554,4618,3916,4652,#N/A,5321.674339,7412,8334,32328,2041,1243,-17024,2752,34624,34369,33571,15304,35080
45005,SC,6120,#N/A,5540,8554,4618,3916,4462,#N/A,5301.817345,7412,8554,31304,-1735,-2533,-20932,-1024,33210,29569,28771,10372,30280
45007,SC,6420,#N/A,5540,8554,4618,3916,4508,#N/A,5182.675382,7412,8265,31196,-1735,-2533,-20932,-1024,33556,29461,28663,10264,30172
45009,SC,5628,#N/A,5540,8554,4618,3916,4385,#N/A,5381.24532,7412,8554,30891,-1735,-2533,-20932,-1024,32641,29156,28358,9959,29867
45011,SC,5628,#N/A,5540,8554,4618,3916,4385,#N/A,5301.817345,7412,8554,30812,-1735,-2533,-20932,-1024,32641,29077,28279,9880,29788
45013,SC,8940,#N/A,5540,8554,4618,3916,4899,#N/A,6215.23906,7412,8386,34869,2394,1596,-16407,3105,36467,37263,36465,18462,37974
45015,SC,9048,#N/A,5540,8554,4618,3916,4916,#N/A,5639.38624,7412,8532,34547,2394,1596,-16407,3105,36592,36941,36143,18140,37652
45017,SC,8028,#N/A,5540,8554,4618,3916,4758,#N/A,5301.817345,7412,8421,33079,2217,1419,-16716,2928,35414,35296,34498,16363,36007
45019,SC,9048,#N/A,5540,8554,4618,3916,4916,#N/A,5877.670165,7412,8531,34785,2394,1596,-16407,3105,36592,37179,36381,18378,37890
45021,SC,6420,#N/A,5540,8554,4618,3916,4508,#N/A,4686.250537,7412,7603,30037,-1911,-2709,-21240,-1200,33556,28126,27328,8797,28837
45023,SC,6420,#N/A,5540,8554,4618,3916,4508,#N/A,5480.530289,7412,8538,31767,-1735,-2533,-20932,-1024,33556,30032,29234,10835,30743
45025,SC,6420,#N/A,5540,8554,4618,3916,4508,#N/A,5281.960351,7412,8554,31584,-1735,-2533,-20932,-1024,33556,29849,29051,10652,30560
45027,SC,5628,#N/A,5540,8554,4618,3916,4385,#N/A,5262.103357,7412,8554,30772,-1735,-2533,-20932,-1024,32641,29037,28239,9840,29748
45029,SC,6744,#N/A,5540,8554,4618,3916,4559,#N/A,5520.244277,7412,8554,32146,2041,1243,-17024,2752,33931,34187,33389,15122,34898
45031,SC,6564,#N/A,5540,8554,4618,3916,4531,#N/A,5401.102314,7412,8112,31405,-1735,-2533,-20932,-1024,33723,29670,28872,10473,30381
45033,SC,5628,#N/A,5540,8554,4618,3916,4385,#N/A,5321.674339,7412,8554,30832,-1735,-2533,-20932,-1024,32641,29097,28299,9900,29808
45035,SC,9048,#N/A,5540,8554,4618,3916,4916,#N/A,5559.958264,7412,8531,34467,2394,1596,-16407,3105,36592,36861,36063,18060,37572
45037,SC,7344,#N/A,5540,8554,4618,3916,4652,#N/A,5599.672252,7412,8344,32616,2041,1243,-17024,2752,34624,34657,33859,15592,35368
45039,SC,8028,#N/A,5540,8554,4618,3916,4758,#N/A,5222.38937,7412,8417,32996,2217,1419,-16716,2928,35414,35213,34415,16280,35924
45041,SC,6276,#N/A,5540,8554,4618,3916,4486,#N/A,5202.532376,7412,8097,30904,-1735,-2533,-20932,-1024,33390,29169,28371,9972,29880
45043,SC,6408,#N/A,5540,8554,4618,3916,4506,#N/A,5798.24219,7412,7932,31466,-1735,-2533,-20932,-1024,33542,29731,28933,10534,30442
45045,SC,7440,#N/A,5540,8554,4618,3916,4667,#N/A,5281.960351,7412,8255,32305,2041,1243,-17024,2752,34735,34346,33548,15281,35057
45047,SC,5856,#N/A,5540,8554,4618,3916,4421,#N/A,5043.676426,7412,7561,29788,-1911,-2709,-21240,-1200,32905,27877,27079,8548,28588
45049,SC,5628,#N/A,5540,8554,4618,3916,4385,#N/A,5142.961395,7412,8554,30653,-1735,-2533,-20932,-1024,32641,28918,28120,9721,29629
45051,SC,7776,#N/A,5540,8554,4618,3916,4719,#N/A,5659.243233,7412,8010,32773,2041,1243,-17024,2752,35123,34814,34016,15749,35525
45053,SC,6516,#N/A,5540,8554,4618,3916,4523,#N/A,5857.813171,7412,8400,32102,-1735,-2533,-20932,-1024,33667,30367,29569,11170,31078
45055,SC,6468,#N/A,5540,8554,4618,3916,4516,#N/A,5520.244277,7412,8414,31730,-1735,-2533,-20932,-1024,33612,29995,29197,10798,30706
45057,SC,6168,#N/A,5540,8554,4618,3916,4469,#N/A,5202.532376,7412,8538,31236,-1735,-2533,-20932,-1024,33265,29501,28703,10304,30212
45059,SC,5988,#N/A,5540,8554,4618,3916,4441,#N/A,4666.393543,7412,8253,30236,-1735,-2533,-20932,-1024,33057,28501,27703,9304,29212
45061,SC,6420,#N/A,5540,8554,4618,3916,4508,#N/A,5202.532376,7412,8554,31505,-1735,-2533,-20932,-1024,33556,29770,28972,10573,30481
45063,SC,8028,#N/A,5540,8554,4618,3916,4758,#N/A,5301.817345,7412,8413,33070,2217,1419,-16716,2928,35414,35287,34489,16354,35998
45065,SC,5976,#N/A,5540,8554,4618,3916,4439,#N/A,5321.674339,7412,8554,31180,-1735,-2533,-20932,-1024,33043,29445,28647,10248,30156
45067,SC,6420,#N/A,5540,8554,4618,3916,4508,#N/A,5142.961395,7412,8554,31445,-1735,-2533,-20932,-1024,33556,29710,28912,10513,30421
45069,SC,5628,#N/A,5540,8554,4618,3916,4385,#N/A,5123.104401,7412,7329,29409,-2088,-2886,-21549,-1377,32641,27321,26523,7860,28032
45071,SC,6252,#N/A,5540,8554,4618,3916,4482,#N/A,5182.675382,7412,8167,30929,-1735,-2533,-20932,-1024,33362,29194,28396,9997,29905
45073,SC,6012,#N/A,5540,8554,4618,3916,4445,#N/A,4984.105444,7412,7911,30235,-1911,-2709,-21240,-1200,33085,28324,27526,8995,29035
45075,SC,6408,#N/A,5540,8554,4618,3916,4506,#N/A,5361.388326,7412,7537,30635,-1911,-2709,-21240,-1200,33542,28724,27926,9395,29435
45077,SC,7440,#N/A,5540,8554,4618,3916,4667,#N/A,5619.529246,7412,8259,32647,2041,1243,-17024,2752,34735,34688,33890,15623,35399
45079,SC,8028,#N/A,5540,8554,4618,3916,4758,#N/A,5321.674339,7412,8410,33087,2217,1419,-16716,2928,35414,35304,34506,16371,36015
45081,SC,8028,#N/A,5540,8554,4618,3916,4758,#N/A,5301.817345,7412,8419,33077,2217,1419,-16716,2928,35414,35294,34496,16361,36005
45083,SC,6864,#N/A,5540,8554,4618,3916,4577,#N/A,5162.818388,7412,8180,31534,-1735,-2533,-20932,-1024,34069,29799,29001,10602,30510
45085,SC,7188,#N/A,5540,8554,4618,3916,4628,#N/A,5123.104401,7412,8175,31814,2041,1243,-17024,2752,34444,33855,33057,14790,34566
45087,SC,5688,#N/A,5540,8554,4618,3916,4395,#N/A,5401.102314,7412,8167,30584,-1911,-2709,-21240,-1200,32711,28673,27875,9344,29384
45089,SC,6420,#N/A,5540,8554,4618,3916,4508,#N/A,5242.246364,7412,8554,31544,-1735,-2533,-20932,-1024,33556,29809,29011,10612,30520
45091,SC,8232,#N/A,5540,8554,4618,3916,4790,#N/A,5679.100227,7412,8539,33778,2217,1419,-16716,2928,35650,35995,35197,17062,36706
46003,SD,5748,#N/A,5659,8320,5608,3699,3345,#N/A,5760.52107,7524,8320,31052,-9437,-2613,-21144,-1104,32379,21615,28439,9908,29948
46005,SD,5268,#N/A,5659,8320,5608,3699,3289,#N/A,5902.505745,7524,7943,30336,-9437,-2613,-21144,-1104,31843,20899,27723,9192,29232
46007,SD,6012,#N/A,5659,8320,5608,3699,3375,#N/A,5882.22222,7524,8320,31437,-9261,-2437,-20836,-928,32673,22176,29000,10601,30509
46009,SD,5748,#N/A,5659,8320,5608,3699,3345,#N/A,5963.356319,7524,8320,31254,-9437,-2613,-21144,-1104,32379,21817,28641,10110,30150
46011,SD,5532,#N/A,5659,8320,5608,3699,3320,#N/A,6186.475093,7524,8222,31163,-9437,-2613,-21144,-1104,32138,21726,28550,10019,30059
46013,SD,5520,#N/A,5659,8320,5608,3699,3318,#N/A,5983.639844,7524,8194,30920,-9437,-2613,-21144,-1104,32124,21483,28307,9776,29816
46015,SD,6012,#N/A,5659,8320,5608,3699,3375,#N/A,5780.804595,7524,8320,31336,-9261,-2437,-20836,-928,32673,22075,28899,10500,30408
46017,SD,6132,#N/A,5659,8320,5608,3699,3389,#N/A,5861.938695,7524,8320,31537,-9261,-2437,-20836,-928,32807,22276,29100,10701,30609
46019,SD,5832,#N/A,5659,8320,5608,3699,3354,#N/A,6085.057469,7524,8320,31460,-9261,-2437,-20836,-928,32472,22199,29023,10624,30532
46021,SD,5568,#N/A,5659,8320,5608,3699,3324,#N/A,5496.835247,7524,8320,30608,-9437,-2613,-21144,-1104,32178,21171,27995,9464,29504
46023,SD,6012,#N/A,5659,8320,5608,3699,3375,#N/A,5760.52107,7524,8320,31316,-9261,-2437,-20836,-928,32673,22055,28879,10480,30388
46025,SD,5268,#N/A,5659,8320,5608,3699,3289,#N/A,5922.78927,7524,8320,30734,-9437,-2613,-21144,-1104,31843,21297,28121,9590,29630
46027,SD,6072,#N/A,5659,8320,5608,3699,3382,#N/A,5638.819921,7524,7488,30422,-9437,-2613,-21144,-1104,32740,20985,27809,9278,29318
46029,SD,5508,#N/A,5659,8320,5608,3699,3317,#N/A,5841.65517,7524,8153,30725,-9437,-2613,-21144,-1104,32111,21288,28112,9581,29621
46031,SD,5280,#N/A,5659,8320,5608,3699,3291,#N/A,5496.835247,7524,8320,30320,-9437,-2613,-21144,-1104,31857,20883,27707,9176,29216
46033,SD,6252,#N/A,5659,8320,5608,3699,3403,#N/A,6064.773944,7524,8235,31775,-9261,-2437,-20836,-928,32941,22514,29338,10939,30847
46035,SD,5700,#N/A,5659,8320,5608,3699,3339,#N/A,5719.954021,7524,8077,30720,-9437,-2613,-21144,-1104,32325,21283,28107,9576,29616
46037,SD,5268,#N/A,5659,8320,5608,3699,3289,#N/A,5861.938695,7524,8320,30673,-9437,-2613,-21144,-1104,31843,21236,28060,9529,29569
46039,SD,6012,#N/A,5659,8320,5608,3699,3375,#N/A,5983.639844,7524,8320,31539,-9261,-2437,-20836,-928,32673,22278,29102,10703,30611
46041,SD,5268,#N/A,5659,8320,5608,3699,3289,#N/A,5902.505745,7524,8320,30714,-9437,-2613,-21144,-1104,31843,21277,28101,9570,29610
46043,SD,5268,#N/A,5659,8320,5608,3699,3289,#N/A,5821.371645,7524,8320,30632,-9437,-2613,-21144,-1104,31843,21195,28019,9488,29528
46045,SD,5820,#N/A,5659,8320,5608,3699,3353,#N/A,5943.072795,7524,8216,31202,-9437,-2613,-21144,-1104,32459,21765,28589,10058,30098
46047,SD,6576,#N/A,5659,8320,5608,3699,3440,#N/A,5983.639844,7524,8320,32103,-9261,-2437,-20836,-928,33302,22842,29666,11267,31175
46049,SD,6012,#N/A,5659,8320,5608,3699,3375,#N/A,5841.65517,7524,8320,31397,-9261,-2437,-20836,-928,32673,22136,28960,10561,30469
46051,SD,5604,#N/A,5659,8320,5608,3699,3328,#N/A,5963.356319,7524,8320,31110,-9437,-2613,-21144,-1104,32218,21673,28497,9966,30006
46053,SD,6012,#N/A,5659,8320,5608,3699,3375,#N/A,5517.118772,7524,8320,31072,-9261,-2437,-20836,-928,32673,21811,28635,10236,30144
46055,SD,5280,#N/A,5659,8320,5608,3699,3291,#N/A,5963.356319,7524,8320,30786,-9437,-2613,-21144,-1104,31857,21349,28173,9642,29682
46057,SD,5688,#N/A,5659,8320,5608,3699,3338,#N/A,5983.639844,7524,8320,31215,-9437,-2613,-21144,-1104,32312,21778,28602,10071,30111
46059,SD,5412,#N/A,5659,8320,5608,3699,3306,#N/A,5841.65517,7524,8320,30797,-9437,-2613,-21144,-1104,32004,21360,28184,9653,29693
46061,SD,5328,#N/A,5659,8320,5608,3699,3296,#N/A,5780.804595,7524,8117,30449,-9437,-2613,-21144,-1104,31910,21012,27836,9305,29345
46063,SD,5280,#N/A,5659,8320,5608,3699,3291,#N/A,6389.310342,7524,8320,31212,-9437,-2613,-21144,-1104,31857,21775,28599,10068,30108
46065,SD,5676,#N/A,5659,8320,5608,3699,3336,#N/A,5801.08812,7524,8420,31120,-9437,-2613,-21144,-1104,32298,21683,28507,9976,30016
46067,SD,5952,#N/A,5659,8320,5608,3699,3368,#N/A,5740.237546,7524,8320,31235,-9261,-2437,-20836,-928,32606,21974,28798,10399,30307
46069,SD,5280,#N/A,5659,8320,5608,3699,3291,#N/A,5861.938695,7524,8320,30685,-9437,-2613,-21144,-1104,31857,21248,28072,9541,29581
46071,SD,6012,#N/A,5659,8320,5608,3699,3375,#N/A,5983.639844,7524,8320,31539,-9261,-2437,-20836,-928,32673,22278,29102,10703,30611
46073,SD,5592,#N/A,5659,8320,5608,3699,3327,#N/A,5760.52107,7524,8320,30896,-9437,-2613,-21144,-1104,32205,21459,28283,9752,29792
46075,SD,5280,#N/A,5659,8320,5608,3699,3291,#N/A,5841.65517,7524,8320,30665,-9437,-2613,-21144,-1104,31857,21228,28052,9521,29561
46077,SD,5484,#N/A,5659,8320,5608,3699,3314,#N/A,5902.505745,7524,8320,30930,-9437,-2613,-21144,-1104,32084,21493,28317,9786,29826
46079,SD,6012,#N/A,5659,8320,5608,3699,3375,#N/A,5740.237546,7524,8320,31295,-9261,-2437,-20836,-928,32673,22034,28858,10459,30367
46081,SD,5784,#N/A,5659,8320,5608,3699,3349,#N/A,6673.279691,7524,7786,31466,-9437,-2613,-21144,-1104,32419,22029,28853,10322,30362
46083,SD,7248,#N/A,5659,8320,5608,3699,3517,#N/A,6835.54789,7524,8569,33875,-5485,1339,-16928,2848,34051,28390,35214,16947,36723
46085,SD,5760,#N/A,5659,8320,5608,3699,3346,#N/A,5841.65517,7524,8320,31145,-9437,-2613,-21144,-1104,32392,21708,28532,10001,30041
46087,SD,7248,#N/A,5659,8320,5608,3699,3517,#N/A,5760.52107,7524,8547,32778,-5485,1339,-16928,2848,34051,27293,34117,15850,35626
46089,SD,5268,#N/A,5659,8320,5608,3699,3289,#N/A,6044.490419,7524,8320,30855,-9437,-2613,-21144,-1104,31843,21418,28242,9711,29751
46091,SD,5268,#N/A,5659,8320,5608,3699,3289,#N/A,5963.356319,7524,8320,30774,-9437,-2613,-21144,-1104,31843,21337,28161,9630,29670
46093,SD,6348,#N/A,5659,8320,5608,3699,3414,#N/A,5070.881224,7524,8228,30870,-9261,-2437,-20836,-928,33048,21609,28433,10034,29942
46095,SD,5280,#N/A,5659,8320,5608,3699,3291,#N/A,6064.773944,7524,8320,30888,-9437,-2613,-21144,-1104,31857,21451,28275,9744,29784
46097,SD,6012,#N/A,5659,8320,5608,3699,3375,#N/A,5922.78927,7524,8320,31478,-9261,-2437,-20836,-928,32673,22217,29041,10642,30550
46099,SD,7248,#N/A,5659,8320,5608,3699,3517,#N/A,5699.670496,7524,8593,32764,-5485,1339,-16928,2848,34051,27279,34103,15836,35612
46101,SD,5268,#N/A,5659,8320,5608,3699,3289,#N/A,5740.237546,7524,8320,30551,-9437,-2613,-21144,-1104,31843,21114,27938,9407,29447
46103,SD,6972,#N/A,5659,8320,5608,3699,3486,#N/A,6003.923369,7524,8219,32418,-5485,1339,-16928,2848,33744,26933,33757,15490,35266
46105,SD,5676,#N/A,5659,8320,5608,3699,3336,#N/A,5861.938695,7524,8320,31081,-9437,-2613,-21144,-1104,32298,21644,28468,9937,29977
46107,SD,6012,#N/A,5659,8320,5608,3699,3375,#N/A,5841.65517,7524,8320,31397,-9261,-2437,-20836,-928,32673,22136,28960,10561,30469
46109,SD,5964,#N/A,5659,8320,5608,3699,3370,#N/A,5841.65517,7524,8320,31349,-9261,-2437,-20836,-928,32620,22088,28912,10513,30421
46111,SD,6012,#N/A,5659,8320,5608,3699,3375,#N/A,5760.52107,7524,8320,31316,-9261,-2437,-20836,-928,32673,22055,28879,10480,30388
46113,SD,5796,#N/A,5659,8320,5608,3699,3350,#N/A,5983.639844,7524,8320,31323,-9437,-2613,-21144,-1104,32432,21886,28710,10179,30219
46115,SD,6012,#N/A,5659,8320,5608,3699,3375,#N/A,5821.371645,7524,8320,31376,-9261,-2437,-20836,-928,32673,22115,28939,10540,30448
46117,SD,6264,#N/A,5659,8320,5608,3699,3404,#N/A,5902.505745,7524,8412,31801,-9261,-2437,-20836,-928,32954,22540,29364,10965,30873
46119,SD,6060,#N/A,5659,8320,5608,3699,3381,#N/A,5841.65517,7524,8403,31528,-9261,-2437,-20836,-928,32727,22267,29091,10692,30600
46121,SD,5280,#N/A,5659,8320,5608,3699,3291,#N/A,5740.237546,7524,8320,30563,-9437,-2613,-21144,-1104,31857,21126,27950,9419,29459
46123,SD,5268,#N/A,5659,8320,5608,3699,3289,#N/A,5801.08812,7524,8320,30612,-9437,-2613,-21144,-1104,31843,21175,27999,9468,29508
46125,SD,7248,#N/A,5659,8320,5608,3699,3517,#N/A,5740.237546,7524,8547,32758,-5485,1339,-16928,2848,34051,27273,34097,15830,35606
46127,SD,6492,#N/A,5659,8320,5608,3699,3430,#N/A,5618.536396,7524,8363,31697,-9261,-2437,-20836,-928,33208,22436,29260,10861,30769
46129,SD,6012,#N/A,5659,8320,5608,3699,3375,#N/A,5861.938695,7524,8320,31417,-9261,-2437,-20836,-928,32673,22156,28980,10581,30489
46135,SD,5268,#N/A,5659,8320,5608,3699,3289,#N/A,5801.08812,7524,8147,30439,-9437,-2613,-21144,-1104,31843,21002,27826,9295,29335
46137,SD,5544,#N/A,5659,8320,5608,3699,3321,#N/A,5963.356319,7524,8320,31050,-9437,-2613,-21144,-1104,32151,21613,28437,9906,29946
47001,TN,7536,#N/A,5540,8554,4775,3916,5312,#N/A,6155.668079,6716,8107,32431,463,-127,-18526,1382,35633,32894,32304,13905,33813
47003,TN,6240,#N/A,5540,8554,4775,3916,5085,#N/A,5679.100227,6716,8265,30817,227,-363,-18894,1146,34110,31044,30454,11923,31963
47005,TN,4992,#N/A,5540,8554,4775,3916,4867,#N/A,5718.814215,6716,8554,29897,-10,-600,-19263,909,32644,29887,29297,10634,30806
47007,TN,5160,#N/A,5540,8554,4775,3916,4896,#N/A,5818.099184,6716,8554,30164,-10,-600,-19263,909,32841,30154,29564,10901,31073
47009,TN,7536,#N/A,5540,8554,4775,3916,5312,#N/A,6135.811085,6716,8107,32411,463,-127,-18526,1382,35633,32874,32284,13885,33793
47011,TN,5760,#N/A,5540,8554,4775,3916,5001,#N/A,5599.672252,6716,8072,30064,227,-363,-18894,1146,33546,30291,29701,11170,31210
47013,TN,5412,#N/A,5540,8554,4775,3916,4940,#N/A,5778.385196,6716,8119,29941,-10,-600,-19263,909,33137,29931,29341,10678,30850
47015,TN,8532,#N/A,5540,8554,4775,3916,5487,#N/A,5559.958264,6716,8565,33289,4535,3945,-14190,5454,36804,37824,37234,19099,38743
47017,TN,4992,#N/A,5540,8554,4775,3916,4867,#N/A,5679.100227,6716,8554,29857,-10,-600,-19263,909,32644,29847,29257,10594,30766
47019,TN,6168,#N/A,5540,8554,4775,3916,5073,#N/A,5897.527159,6716,7588,30285,-10,-600,-19263,909,34026,30275,29685,11022,31194
47021,TN,8532,#N/A,5540,8554,4775,3916,5487,#N/A,5857.813171,6716,8565,33587,4535,3945,-14190,5454,36804,38122,37532,19397,39041
47023,TN,6444,#N/A,5540,8554,4775,3916,5121,#N/A,5659.243233,6716,8188,30924,227,-363,-18894,1146,34350,31151,30561,12030,32070
47025,TN,5640,#N/A,5540,8554,4775,3916,4980,#N/A,5440.816302,6716,8554,30267,227,-363,-18894,1146,33405,30494,29904,11373,31413
47027,TN,4992,#N/A,5540,8554,4775,3916,4867,#N/A,5480.530289,6716,8554,29659,-10,-600,-19263,909,32644,29649,29059,10396,30568
47029,TN,5544,#N/A,5540,8554,4775,3916,4963,#N/A,5659.243233,6716,7216,29051,-246,-836,-19631,673,33292,28805,28215,9420,29724
47031,TN,5568,#N/A,5540,8554,4775,3916,4968,#N/A,5837.956178,6716,7942,29980,-10,-600,-19263,909,33321,29970,29380,10717,30889
47033,TN,5892,#N/A,5540,8554,4775,3916,5024,#N/A,5659.243233,6716,8193,30376,227,-363,-18894,1146,33701,30603,30013,11482,31522
47035,TN,5904,#N/A,5540,8554,4775,3916,5026,#N/A,5976.955134,6716,7358,29871,-10,-600,-19263,909,33715,29861,29271,10608,30780
47037,TN,8532,#N/A,5540,8554,4775,3916,5487,#N/A,5778.385196,6716,8569,33511,4535,3945,-14190,5454,36804,38046,37456,19321,38965
47039,TN,5700,#N/A,5540,8554,4775,3916,4991,#N/A,5718.814215,6716,8554,30605,227,-363,-18894,1146,33476,30832,30242,11711,31751
47041,TN,4992,#N/A,5540,8554,4775,3916,4867,#N/A,5460.673295,6716,8554,29639,-10,-600,-19263,909,32644,29629,29039,10376,30548
47043,TN,8532,#N/A,5540,8554,4775,3916,5487,#N/A,5242.246364,6716,8566,32972,4535,3945,-14190,5454,36804,37507,36917,18782,38426
47045,TN,5112,#N/A,5540,8554,4775,3916,4888,#N/A,5639.38624,6716,7763,29146,-10,-600,-19263,909,32785,29136,28546,9883,30055
47047,TN,7896,#N/A,5540,8554,4775,3916,5375,#N/A,5976.955134,6716,8480,32985,4299,3709,-14558,5218,36056,37284,36694,18427,38203
47049,TN,4992,#N/A,5540,8554,4775,3916,4867,#N/A,5579.815258,6716,8554,29758,-10,-600,-19263,909,32644,29748,29158,10495,30667
47051,TN,5172,#N/A,5540,8554,4775,3916,4898,#N/A,5738.671209,6716,7969,29511,-10,-600,-19263,909,32855,29501,28911,10248,30420
47053,TN,5448,#N/A,5540,8554,4775,3916,4947,#N/A,5798.24219,6716,8554,30432,227,-363,-18894,1146,33180,30659,30069,11538,31578
47055,TN,6264,#N/A,5540,8554,4775,3916,5090,#N/A,5698.957221,6716,8554,31149,227,-363,-18894,1146,34139,31376,30786,12255,32295
47057,TN,5820,#N/A,5540,8554,4775,3916,5012,#N/A,6195.382066,6716,8129,30777,227,-363,-18894,1146,33617,31004,30414,11883,31923
47059,TN,5844,#N/A,5540,8554,4775,3916,5016,#N/A,5679.100227,6716,7418,29573,-10,-600,-19263,909,33645,29563,28973,10310,30482
47061,TN,5196,#N/A,5540,8554,4775,3916,4902,#N/A,5837.956178,6716,8554,30220,-10,-600,-19263,909,32883,30210,29620,10957,31129
47063,TN,5820,#N/A,5540,8554,4775,3916,5012,#N/A,5639.38624,6716,7761,29852,-10,-600,-19263,909,33617,29842,29252,10589,30761
47065,TN,6552,#N/A,5540,8554,4775,3916,5140,#N/A,5917.384153,6716,8230,31332,227,-363,-18894,1146,34477,31559,30969,12438,32478
47067,TN,5076,#N/A,5540,8554,4775,3916,4881,#N/A,5639.38624,6716,8554,29901,-10,-600,-19263,909,32742,29891,29301,10638,30810
47069,TN,5700,#N/A,5540,8554,4775,3916,4991,#N/A,5698.957221,6716,8554,30585,227,-363,-18894,1146,33476,30812,30222,11691,31731
47071,TN,4992,#N/A,5540,8554,4775,3916,4867,#N/A,5639.38624,6716,8554,29817,-10,-600,-19263,909,32644,29807,29217,10554,30726
47073,TN,5760,#N/A,5540,8554,4775,3916,5001,#N/A,5679.100227,6716,7612,29684,-10,-600,-19263,909,33546,29674,29084,10421,30593
47075,TN,6456,#N/A,5540,8554,4775,3916,5123,#N/A,5698.957221,6716,8554,31341,463,-127,-18526,1382,34364,31804,31214,12815,32723
47077,TN,5016,#N/A,5540,8554,4775,3916,4871,#N/A,5778.385196,6716,8554,29980,-10,-600,-19263,909,32672,29970,29380,10717,30889
47079,TN,5856,#N/A,5540,8554,4775,3916,5018,#N/A,5599.672252,6716,7460,29548,-10,-600,-19263,909,33659,29538,28948,10285,30457
47081,TN,5604,#N/A,5540,8554,4775,3916,4974,#N/A,6056.38311,6716,8565,30857,227,-363,-18894,1146,33363,31084,30494,11963,32003
47083,TN,4992,#N/A,5540,8554,4775,3916,4867,#N/A,5559.958264,6716,8554,29738,-10,-600,-19263,909,32644,29728,29138,10475,30647
47085,TN,5700,#N/A,5540,8554,4775,3916,4991,#N/A,5440.816302,6716,8554,30327,227,-363,-18894,1146,33476,30554,29964,11433,31473
47087,TN,4992,#N/A,5540,8554,4775,3916,4867,#N/A,5520.244277,6716,7517,28661,-246,-836,-19631,673,32644,28415,27825,9030,29334
47089,TN,5820,#N/A,5540,8554,4775,3916,5012,#N/A,5957.098141,6716,7782,30191,-10,-600,-19263,909,33617,30181,29591,10928,31100
47091,TN,4992,#N/A,5540,8554,4775,3916,4867,#N/A,5937.241147,6716,8554,30115,-10,-600,-19263,909,32644,30105,29515,10852,31024
47093,TN,7536,#N/A,5540,8554,4775,3916,5312,#N/A,5877.670165,6716,8106,32152,463,-127,-18526,1382,35633,32615,32025,13626,33534
47095,TN,5304,#N/A,5540,8554,4775,3916,4921,#N/A,5162.818388,6716,8554,29653,227,-363,-18894,1146,33010,29880,29290,10759,30799
47097,TN,4992,#N/A,5540,8554,4775,3916,4867,#N/A,5520.244277,6716,8554,29698,-10,-600,-19263,909,32644,29688,29098,10435,30607
47099,TN,5220,#N/A,5540,8554,4775,3916,4907,#N/A,5480.530289,6716,7775,29108,-10,-600,-19263,909,32912,29098,28508,9845,30017
47101,TN,5700,#N/A,5540,8554,4775,3916,4991,#N/A,5540.101271,6716,8554,30426,227,-363,-18894,1146,33476,30653,30063,11532,31572
47103,TN,5160,#N/A,5540,8554,4775,3916,4896,#N/A,5778.385196,6716,8554,30124,-10,-600,-19263,909,32841,30114,29524,10861,31033
47105,TN,7536,#N/A,5540,8554,4775,3916,5312,#N/A,6016.669122,6716,8119,32303,463,-127,-18526,1382,35633,32766,32176,13777,33685
47107,TN,5844,#N/A,5540,8554,4775,3916,5016,#N/A,5877.670165,6716,7731,30085,-10,-600,-19263,909,33645,30075,29485,10822,30994
47109,TN,4992,#N/A,5540,8554,4775,3916,4867,#N/A,5540.101271,6716,8554,29718,-10,-600,-19263,909,32644,29708,29118,10455,30627
47111,TN,4992,#N/A,5540,8554,4775,3916,4867,#N/A,5679.100227,6716,8565,29868,-10,-600,-19263,909,32644,29858,29268,10605,30777
47113,TN,6444,#N/A,5540,8554,4775,3916,5121,#N/A,5639.38624,6716,8156,30872,227,-363,-18894,1146,34350,31099,30509,11978,32018
47115,TN,6552,#N/A,5540,8554,4775,3916,5140,#N/A,5798.24219,6716,8249,31231,227,-363,-18894,1146,34477,31458,30868,12337,32377
47117,TN,5772,#N/A,5540,8554,4775,3916,5003,#N/A,5579.815258,6716,8270,30254,227,-363,-18894,1146,33560,30481,29891,11360,31400
47119,TN,5580,#N/A,5540,8554,4775,3916,4970,#N/A,5559.958264,6716,8566,30338,227,-363,-18894,1146,33335,30565,29975,11444,31484
47121,TN,5160,#N/A,5540,8554,4775,3916,4896,#N/A,5837.956178,6716,8554,30184,-10,-600,-19263,909,32841,30174,29584,10921,31093
47123,TN,5124,#N/A,5540,8554,4775,3916,4890,#N/A,5976.955134,6716,8554,30287,-10,-600,-19263,909,32799,30277,29687,11024,31196
47125,TN,7056,#N/A,5540,8554,4775,3916,5228,#N/A,5619.529246,6716,8427,31735,463,-127,-18526,1382,35069,32198,31608,13209,33117
47127,TN,5508,#N/A,5540,8554,4775,3916,4957,#N/A,5738.671209,6716,7995,29873,-10,-600,-19263,909,33250,29863,29273,10610,30782
47129,TN,5328,#N/A,5540,8554,4775,3916,4926,#N/A,6175.525072,6716,8143,30279,-10,-600,-19263,909,33039,30269,29679,11016,31188
47131,TN,4992,#N/A,5540,8554,4775,3916,4867,#N/A,5659.243233,6716,7605,28889,-246,-836,-19631,673,32644,28643,28053,9258,29562
47133,TN,5028,#N/A,5540,8554,4775,3916,4873,#N/A,6215.23906,6716,7500,29375,-246,-836,-19631,673,32686,29129,28539,9744,30048
47135,TN,5700,#N/A,5540,8554,4775,3916,4991,#N/A,5778.385196,6716,8554,30664,227,-363,-18894,1146,33476,30891,30301,11770,31810
47137,TN,5160,#N/A,5540,8554,4775,3916,4896,#N/A,5480.530289,6716,8554,29827,-10,-600,-19263,909,32841,29817,29227,10564,30736
47139,TN,5760,#N/A,5540,8554,4775,3916,5001,#N/A,5639.38624,6716,8116,30148,227,-363,-18894,1146,33546,30375,29785,11254,31294
47141,TN,5496,#N/A,5540,8554,4775,3916,4955,#N/A,5420.959308,6716,7422,28970,-10,-600,-19263,909,33236,28960,28370,9707,29879
47143,TN,5508,#N/A,5540,8554,4775,3916,4957,#N/A,5917.384153,6716,7635,29692,-10,-600,-19263,909,33250,29682,29092,10429,30601
47145,TN,5388,#N/A,5540,8554,4775,3916,4936,#N/A,5897.527159,6716,8115,30032,-10,-600,-19263,909,33109,30022,29432,10769,30941
47147,TN,8532,#N/A,5540,8554,4775,3916,5487,#N/A,5361.388326,6716,8566,33091,4535,3945,-14190,5454,36804,37626,37036,18901,38545
47149,TN,8532,#N/A,5540,8554,4775,3916,5487,#N/A,5639.38624,6716,8566,33370,4535,3945,-14190,5454,36804,37905,37315,19180,38824
47151,TN,5700,#N/A,5540,8554,4775,3916,4991,#N/A,5818.099184,6716,8554,30704,227,-363,-18894,1146,33476,30931,30341,11810,31850
47153,TN,6552,#N/A,5540,8554,4775,3916,5140,#N/A,5738.671209,6716,8246,31169,227,-363,-18894,1146,34477,31396,30806,12275,32315
47155,TN,6492,#N/A,5540,8554,4775,3916,5129,#N/A,6175.525072,6716,8245,31545,227,-363,-18894,1146,34406,31772,31182,12651,32691
47157,TN,7896,#N/A,5540,8554,4775,3916,5375,#N/A,5540.101271,6716,8483,32552,4299,3709,-14558,5218,36056,36851,36261,17994,37770
47159,TN,5112,#N/A,5540,8554,4775,3916,4888,#N/A,5440.816302,6716,8565,29750,-10,-600,-19263,909,32785,29740,29150,10487,30659
47161,TN,5196,#N/A,5540,8554,4775,3916,4902,#N/A,5579.815258,6716,8554,29962,-10,-600,-19263,909,32883,29952,29362,10699,30871
47163,TN,5760,#N/A,5540,8554,4775,3916,5001,#N/A,6036.526116,6716,7604,30032,-10,-600,-19263,909,33546,30022,29432,10769,30941
47165,TN,8532,#N/A,5540,8554,4775,3916,5487,#N/A,5440.816302,6716,8567,33171,4535,3945,-14190,5454,36804,37706,37116,18981,38625
47167,TN,7896,#N/A,5540,8554,4775,3916,5375,#N/A,5758.528202,6716,8479,32766,4299,3709,-14558,5218,36056,37065,36475,18208,37984
47169,TN,8532,#N/A,5540,8554,4775,3916,5487,#N/A,5420.959308,6716,8565,33150,4535,3945,-14190,5454,36804,37685,37095,18960,38604
47171,TN,6168,#N/A,5540,8554,4775,3916,5073,#N/A,5818.099184,6716,7592,30210,-10,-600,-19263,909,34026,30200,29610,10947,31119
47173,TN,7536,#N/A,5540,8554,4775,3916,5312,#N/A,5897.527159,6716,8127,32192,463,-127,-18526,1382,35633,32655,32065,13666,33574
47175,TN,5160,#N/A,5540,8554,4775,3916,4896,#N/A,5639.38624,6716,8554,29985,-10,-600,-19263,909,32841,29975,29385,10722,30894
47177,TN,4992,#N/A,5540,8554,4775,3916,4867,#N/A,5619.529246,6716,7610,28854,-246,-836,-19631,673,32644,28608,28018,9223,29527
47179,TN,6168,#N/A,5540,8554,4775,3916,5073,#N/A,5837.956178,6716,7577,30215,-10,-600,-19263,909,34026,30205,29615,10952,31124
47181,TN,4992,#N/A,5540,8554,4775,3916,4867,#N/A,5520.244277,6716,8554,29698,-10,-600,-19263,909,32644,29688,29098,10435,30607
47183,TN,5340,#N/A,5540,8554,4775,3916,4928,#N/A,5957.098141,6716,7501,29430,-10,-600,-19263,909,33053,29420,28830,10167,30339
47185,TN,5268,#N/A,5540,8554,4775,3916,4915,#N/A,5540.101271,6716,8554,29994,-10,-600,-19263,909,32968,29984,29394,10731,30903
47187,TN,8532,#N/A,5540,8554,4775,3916,5487,#N/A,5917.384153,6716,8567,33648,4535,3945,-14190,5454,36804,38183,37593,19458,39102
47189,TN,8532,#N/A,5540,8554,4775,3916,5487,#N/A,5361.388326,6716,8566,33092,4535,3945,-14190,5454,36804,37627,37037,18902,38546
48001,TX,6780,#N/A,5540,8554,4962,3916,3428,#N/A,5242.246364,6164,8124,30226,-1018,-1461,-19992,48,33180,29208,28765,10234,30274
48003,TX,5916,#N/A,5540,8554,4962,3916,3328,#N/A,5142.961395,6164,8995,30134,-1018,-1461,-19992,48,32216,29116,28673,10142,30182
48005,TX,7068,#N/A,5540,8554,4962,3916,3461,#N/A,5083.390413,6164,8282,30514,-1018,-1461,-19992,48,33501,29496,29053,10522,30562
48007,TX,6228,#N/A,5540,8554,4962,3916,3364,#N/A,4964.24845,6164,8523,29795,-1018,-1461,-19992,48,32564,28777,28334,9803,29843
48009,TX,6840,#N/A,5540,8554,4962,3916,3434,#N/A,5083.390413,6164,8317,30320,-1018,-1461,-19992,48,33246,29302,28859,10328,30368
48011,TX,6720,#N/A,5540,8554,4962,3916,3421,#N/A,5440.816302,6164,8529,30769,-1018,-1461,-19992,48,33113,29751,29308,10777,30817
48013,TX,6312,#N/A,5540,8554,4962,3916,3374,#N/A,4984.105444,6164,8739,30115,-1018,-1461,-19992,48,32658,29097,28654,10123,30163
48015,TX,6396,#N/A,5540,8554,4962,3916,3383,#N/A,5599.672252,6164,8948,31024,-1018,-1461,-19992,48,32751,30006,29563,11032,31072
48017,TX,6096,#N/A,5540,8554,4962,3916,3349,#N/A,5559.958264,6164,8554,30290,-1018,-1461,-19992,48,32417,29272,28829,10298,30338
48019,TX,8196,#N/A,5540,8554,4962,3916,3591,#N/A,5659.243233,6164,8738,32673,2524,2080,-16187,3589,34759,35197,34753,16486,36262
48021,TX,10236,#N/A,5540,8554,4962,3916,3826,#N/A,4706.107531,6164,9096,34118,2877,2433,-15570,3942,37034,36995,36551,18548,38060
48023,TX,5652,#N/A,5540,8554,4962,3916,3298,#N/A,5043.676426,6164,8554,29330,-1195,-1638,-20301,-129,31922,28135,27692,9029,29201
48025,TX,6564,#N/A,5540,8554,4962,3916,3403,#N/A,4428.109618,6164,8066,29138,-1018,-1461,-19992,48,32939,28120,27677,9146,29186
48027,TX,6612,#N/A,5540,8554,4962,3916,3408,#N/A,4706.107531,6164,8833,30231,-842,-1285,-19684,224,32992,29389,28946,10547,30455
48029,TX,8196,#N/A,5540,8554,4962,3916,3591,#N/A,4884.820475,6164,8776,31936,2524,2080,-16187,3589,34759,34460,34016,15749,35525
48031,TX,7140,#N/A,5540,8554,4962,3916,3469,#N/A,5142.961395,6164,8554,30917,-842,-1285,-19684,224,33581,30075,29632,11233,31141
48033,TX,6084,#N/A,5540,8554,4962,3916,3347,#N/A,4864.963481,6164,8554,29583,-1018,-1461,-19992,48,32403,28565,28122,9591,29631
48035,TX,5892,#N/A,5540,8554,4962,3916,3325,#N/A,4785.535506,6164,8554,29312,-1018,-1461,-19992,48,32189,28294,27851,9320,29360
48037,TX,6876,#N/A,5540,8554,4962,3916,3439,#N/A,5003.962438,6164,8129,30089,-1018,-1461,-19992,48,33287,29071,28628,10097,30137
48039,TX,7728,#N/A,5540,8554,4962,3916,3537,#N/A,5281.960351,6164,8983,32073,2524,2080,-16187,3589,34237,34597,34153,15886,35662
48041,TX,8448,#N/A,5540,8554,4962,3916,3620,#N/A,5103.247407,6164,8015,31646,2524,2080,-16187,3589,35040,34170,33726,15459,35235
48043,TX,6588,#N/A,5540,8554,4962,3916,3405,#N/A,5619.529246,6164,8554,30842,-1018,-1461,-19992,48,32965,29824,29381,10850,30890
48045,TX,5940,#N/A,5540,8554,4962,3916,3331,#N/A,5361.388326,6164,8554,29935,-1018,-1461,-19992,48,32243,28917,28474,9943,29983
48047,TX,6444,#N/A,5540,8554,4962,3916,3389,#N/A,4388.39563,6164,8554,29466,-1018,-1461,-19992,48,32805,28448,28005,9474,29514
48049,TX,5928,#N/A,5540,8554,4962,3916,3329,#N/A,5301.817345,6164,7900,29210,-1195,-1638,-20301,-129,32229,28015,27572,8909,29081
48051,TX,8448,#N/A,5540,8554,4962,3916,3620,#N/A,5123.104401,6164,8029,31680,2524,2080,-16187,3589,35040,34204,33760,15493,35269
48053,TX,6048,#N/A,5540,8554,4962,3916,3343,#N/A,4904.677469,6164,8554,29587,-1018,-1461,-19992,48,32363,28569,28126,9595,29635
48055,TX,10236,#N/A,5540,8554,4962,3916,3826,#N/A,4388.39563,6164,9117,33821,2877,2433,-15570,3942,37034,36698,36254,18251,37763
48057,TX,6300,#N/A,5540,8554,4962,3916,3372,#N/A,4606.822562,6164,8364,29351,-1018,-1461,-19992,48,32644,28333,27890,9359,29399
48059,TX,7032,#N/A,5540,8554,4962,3916,3457,#N/A,4984.105444,6164,8285,30381,-1018,-1461,-19992,48,33461,29363,28920,10389,30429
48061,TX,6504,#N/A,5540,8554,4962,3916,3396,#N/A,4189.825692,6164,8226,29000,-1018,-1461,-19992,48,32872,27982,27539,9008,29048
48063,TX,6444,#N/A,5540,8554,4962,3916,3389,#N/A,5281.960351,6164,8554,30360,-1018,-1461,-19992,48,32805,29342,28899,10368,30408
48065,TX,6720,#N/A,5540,8554,4962,3916,3421,#N/A,5440.816302,6164,8529,30770,-1018,-1461,-19992,48,33113,29752,29309,10778,30818
48067,TX,5988,#N/A,5540,8554,4962,3916,3336,#N/A,5301.817345,6164,8554,29924,-1018,-1461,-19992,48,32296,28906,28463,9932,29972
48069,TX,6444,#N/A,5540,8554,4962,3916,3389,#N/A,5659.243233,6164,8554,30737,-1018,-1461,-19992,48,32805,29719,29276,10745,30785
48071,TX,9000,#N/A,5540,8554,4962,3916,3683,#N/A,6135.811085,6164,8952,34168,2700,2256,-15879,3765,35655,36868,36424,18289,37933
48073,TX,6360,#N/A,5540,8554,4962,3916,3379,#N/A,5222.38937,6164,7883,29546,-1195,-1638,-20301,-129,32711,28351,27908,9245,29417
48075,TX,6720,#N/A,5540,8554,4962,3916,3421,#N/A,5401.102314,6164,8554,30755,-1018,-1461,-19992,48,33113,29737,29294,10763,30803
48077,TX,6840,#N/A,5540,8554,4962,3916,3434,#N/A,5003.962438,6164,8314,30238,-1018,-1461,-19992,48,33246,29220,28777,10246,30286
48079,TX,5652,#N/A,5540,8554,4962,3916,3298,#N/A,5361.388326,6164,8554,29647,-1195,-1638,-20301,-129,31922,28452,28009,9346,29518
48081,TX,5652,#N/A,5540,8554,4962,3916,3298,#N/A,4864.963481,6164,8554,29151,-1195,-1638,-20301,-129,31922,27956,27513,8850,29022
48083,TX,5652,#N/A,5540,8554,4962,3916,3298,#N/A,4964.24845,6164,8554,29250,-1195,-1638,-20301,-129,31922,28055,27612,8949,29121
48085,TX,8664,#N/A,5540,8554,4962,3916,3645,#N/A,5718.814215,6164,8916,33379,2700,2256,-15879,3765,35281,36079,35635,17500,37144
48087,TX,5940,#N/A,5540,8554,4962,3916,3331,#N/A,5460.673295,6164,8554,30035,-1018,-1461,-19992,48,32243,29017,28574,10043,30083
48089,TX,5652,#N/A,5540,8554,4962,3916,3298,#N/A,4725.964525,6164,8554,29012,-1195,-1638,-20301,-129,31922,27817,27374,8711,28883
48091,TX,8196,#N/A,5540,8554,4962,3916,3591,#N/A,5401.102314,6164,8746,32423,2524,2080,-16187,3589,34759,34947,34503,16236,36012
48093,TX,5652,#N/A,5540,8554,4962,3916,3298,#N/A,5202.532376,6164,8554,29489,-1195,-1638,-20301,-129,31922,28294,27851,9188,29360
48095,TX,9024,#N/A,5540,8554,4962,3916,3686,#N/A,4904.677469,6164,8554,32563,2700,2256,-15879,3765,35682,35263,34819,16684,36328
48097,TX,7212,#N/A,5540,8554,4962,3916,3477,#N/A,5818.099184,6164,8468,31578,-842,-1285,-19684,224,33661,30736,30293,11894,31802
48099,TX,6612,#N/A,5540,8554,4962,3916,3408,#N/A,4884.820475,6164,8814,30390,-842,-1285,-19684,224,32992,29548,29105,10706,30614
48101,TX,6216,#N/A,5540,8554,4962,3916,3363,#N/A,5401.102314,6164,8554,30251,-1018,-1461,-19992,48,32551,29233,28790,10259,30299
48103,TX,6960,#N/A,5540,8554,4962,3916,3448,#N/A,5063.533419,6164,8554,30658,-842,-1285,-19684,224,33380,29816,29373,10974,30882
48105,TX,5652,#N/A,5540,8554,4962,3916,3298,#N/A,4606.822562,6164,8554,28893,-1195,-1638,-20301,-129,31922,27698,27255,8592,28764
48107,TX,7068,#N/A,5540,8554,4962,3916,3461,#N/A,5262.103357,6164,8407,30817,-842,-1285,-19684,224,33501,29975,29532,11133,31041
48109,TX,5940,#N/A,5540,8554,4962,3916,3331,#N/A,5182.675382,6164,8554,29757,-1018,-1461,-19992,48,32243,28739,28296,9765,29805
48111,TX,6444,#N/A,5540,8554,4962,3916,3389,#N/A,5401.102314,6164,8554,30479,-1018,-1461,-19992,48,32805,29461,29018,10487,30527
48113,TX,8664,#N/A,5540,8554,4962,3916,3645,#N/A,5420.959308,6164,8946,33111,2700,2256,-15879,3765,35281,35811,35367,17232,36876
48115,TX,6372,#N/A,5540,8554,4962,3916,3381,#N/A,5162.818388,6164,7613,29228,-1195,-1638,-20301,-129,32725,28033,27590,8927,29099
48117,TX,5664,#N/A,5540,8554,4962,3916,3299,#N/A,5440.816302,6164,8583,29767,-1195,-1638,-20301,-129,31935,28572,28129,9466,29638
48119,TX,8664,#N/A,5540,8554,4962,3916,3645,#N/A,5381.24532,6164,8554,32679,2524,2080,-16187,3589,35281,35203,34759,16492,36268
48121,TX,8664,#N/A,5540,8554,4962,3916,3645,#N/A,5698.957221,6164,8924,33367,2700,2256,-15879,3765,35281,36067,35623,17488,37132
48123,TX,5652,#N/A,5540,8554,4962,3916,3298,#N/A,4229.53968,6164,8554,28516,-1195,-1638,-20301,-129,31922,27321,26878,8215,28387
48125,TX,5940,#N/A,5540,8554,4962,3916,3331,#N/A,5262.103357,6164,8554,29836,-1018,-1461,-19992,48,32243,28818,28375,9844,29884
48127,TX,6444,#N/A,5540,8554,4962,3916,3389,#N/A,4150.111705,6164,8554,29228,-1018,-1461,-19992,48,32805,28210,27767,9236,29276
48129,TX,5652,#N/A,5540,8554,4962,3916,3298,#N/A,5599.672252,6164,8554,29886,-1195,-1638,-20301,-129,31922,28691,28248,9585,29757
48131,TX,7164,#N/A,5540,8554,4962,3916,3472,#N/A,4447.966612,6164,8554,30246,-842,-1285,-19684,224,33608,29404,28961,10562,30470
48133,TX,5652,#N/A,5540,8554,4962,3916,3298,#N/A,5222.38937,6164,8554,29508,-1195,-1638,-20301,-129,31922,28313,27870,9207,29379
48135,TX,9252,#N/A,5540,8554,4962,3916,3712,#N/A,4944.391457,6164,8766,33043,2700,2256,-15879,3765,35936,35743,35299,17164,36808
48137,TX,5940,#N/A,5540,8554,4962,3916,3331,#N/A,4606.822562,6164,8554,29181,-1018,-1461,-19992,48,32243,28163,27720,9189,29229
48139,TX,8664,#N/A,5540,8554,4962,3916,3645,#N/A,5142.961395,6164,8888,32775,2700,2256,-15879,3765,35281,35475,35031,16896,36540
48141,TX,7260,#N/A,5540,8554,4962,3916,3483,#N/A,5043.676426,6164,8636,31019,-842,-1285,-19684,224,33715,30177,29734,11335,31243
48143,TX,6336,#N/A,5540,8554,4962,3916,3376,#N/A,5063.533419,6164,8001,29480,-1195,-1638,-20301,-129,32684,28285,27842,9179,29351
48145,TX,5772,#N/A,5540,8554,4962,3916,3311,#N/A,4686.250537,6164,8332,28870,-1195,-1638,-20301,-129,32055,27675,27232,8569,28741
48147,TX,5784,#N/A,5540,8554,4962,3916,3313,#N/A,5301.817345,6164,8554,29720,-1195,-1638,-20301,-129,32069,28525,28082,9419,29591
48149,TX,5856,#N/A,5540,8554,4962,3916,3321,#N/A,4646.53655,6164,8554,29137,-1018,-1461,-19992,48,32149,28119,27676,9145,29185
48151,TX,5652,#N/A,5540,8554,4962,3916,3298,#N/A,4924.534463,6164,8554,29211,-1195,-1638,-20301,-129,31922,28016,27573,8910,29082
48153,TX,6444,#N/A,5540,8554,4962,3916,3389,#N/A,5262.103357,6164,8554,30340,-1018,-1461,-19992,48,32805,29322,28879,10348,30388
48155,TX,5940,#N/A,5540,8554,4962,3916,3331,#N/A,5540.101271,6164,8554,30114,-1018,-1461,-19992,48,32243,29096,28653,10122,30162
48157,TX,9000,#N/A,5540,8554,4962,3916,3683,#N/A,5341.531333,6164,8975,33397,2700,2256,-15879,3765,35655,36097,35653,17518,37162
48159,TX,5652,#N/A,5540,8554,4962,3916,3298,#N/A,5321.674339,6164,8554,29608,-1195,-1638,-20301,-129,31922,28413,27970,9307,29479
48161,TX,6960,#N/A,5540,8554,4962,3916,3448,#N/A,5063.533419,6164,8554,30658,-842,-1285,-19684,224,33380,29816,29373,10974,30882
48163,TX,6444,#N/A,5540,8554,4962,3916,3389,#N/A,4884.820475,6164,8554,29963,-1018,-1461,-19992,48,32805,28945,28502,9971,30011
48165,TX,5664,#N/A,5540,8554,4962,3916,3299,#N/A,5142.961395,6164,8554,29441,-1195,-1638,-20301,-129,31935,28246,27803,9140,29312
48167,TX,9000,#N/A,5540,8554,4962,3916,3683,#N/A,5579.815258,6164,8991,33651,2700,2256,-15879,3765,35655,36351,35907,17772,37416
48169,TX,6444,#N/A,5540,8554,4962,3916,3389,#N/A,5262.103357,6164,8554,30340,-1018,-1461,-19992,48,32805,29322,28879,10348,30388
48171,TX,7764,#N/A,5540,8554,4962,3916,3541,#N/A,5023.819432,6164,8227,31095,-842,-1285,-19684,224,34277,30253,29810,11411,31319
48173,TX,6084,#N/A,5540,8554,4962,3916,3347,#N/A,5023.819432,6164,8245,29433,-1195,-1638,-20301,-129,32403,28238,27795,9132,29304
48175,TX,6936,#N/A,5540,8554,4962,3916,3446,#N/A,4646.53655,6164,8575,30238,-842,-1285,-19684,224,33354,29396,28953,10554,30462
48177,TX,5652,#N/A,5540,8554,4962,3916,3298,#N/A,4984.105444,6164,8554,29270,-1195,-1638,-20301,-129,31922,28075,27632,8969,29141
48179,TX,5964,#N/A,5540,8554,4962,3916,3334,#N/A,5639.38624,6164,8036,29720,-1195,-1638,-20301,-129,32270,28525,28082,9419,29591
48181,TX,7476,#N/A,5540,8554,4962,3916,3508,#N/A,5162.818388,6164,8250,30969,-842,-1285,-19684,224,33956,30127,29684,11285,31193
48183,TX,7800,#N/A,5540,8554,4962,3916,3545,#N/A,5222.38937,6164,8373,31475,-842,-1285,-19684,224,34317,30633,30190,11791,31699
48185,TX,6108,#N/A,5540,8554,4962,3916,3350,#N/A,5619.529246,6164,8554,30362,-1018,-1461,-19992,48,32430,29344,28901,10370,30410
48187,TX,8196,#N/A,5540,8554,4962,3916,3591,#N/A,5063.533419,6164,8748,32088,2524,2080,-16187,3589,34759,34612,34168,15901,35677
48189,TX,6000,#N/A,5540,8554,4962,3916,3338,#N/A,5321.674339,6164,8308,29709,-1195,-1638,-20301,-129,32310,28514,28071,9408,29580
48191,TX,5940,#N/A,5540,8554,4962,3916,3331,#N/A,5401.102314,6164,8554,29975,-1018,-1461,-19992,48,32243,28957,28514,9983,30023
48193,TX,5652,#N/A,5540,8554,4962,3916,3298,#N/A,4825.249494,6164,8554,29111,-1195,-1638,-20301,-129,31922,27916,27473,8810,28982
48195,TX,6444,#N/A,5540,8554,4962,3916,3389,#N/A,5401.102314,6164,8554,30479,-1018,-1461,-19992,48,32805,29461,29018,10487,30527
48197,TX,6012,#N/A,5540,8554,4962,3916,3339,#N/A,5341.531333,6164,8554,29988,-1018,-1461,-19992,48,32323,28970,28527,9996,30036
48199,TX,7800,#N/A,5540,8554,4962,3916,3545,#N/A,5142.961395,6164,8215,31238,-842,-1285,-19684,224,34317,30396,29953,11554,31462
48201,TX,9000,#N/A,5540,8554,4962,3916,3683,#N/A,5281.960351,6164,9027,33389,2700,2256,-15879,3765,35655,36089,35645,17510,37154
48203,TX,6132,#N/A,5540,8554,4962,3916,3353,#N/A,5242.246364,6164,8447,29901,-1018,-1461,-19992,48,32457,28883,28440,9909,29949
48205,TX,5652,#N/A,5540,8554,4962,3916,3298,#N/A,5381.24532,6164,8554,29667,-1195,-1638,-20301,-129,31922,28472,28029,9366,29538
48207,TX,5940,#N/A,5540,8554,4962,3916,3331,#N/A,5540.101271,6164,8554,30114,-1018,-1461,-19992,48,32243,29096,28653,10122,30162
48209,TX,10236,#N/A,5540,8554,4962,3916,3826,#N/A,5103.247407,6164,9122,34541,2877,2433,-15570,3942,37034,37418,36974,18971,38483
48211,TX,6936,#N/A,5540,8554,4962,3916,3446,#N/A,5559.958264,6164,8554,31130,-842,-1285,-19684,224,33354,30288,29845,11446,31354
48213,TX,6720,#N/A,5540,8554,4962,3916,3421,#N/A,5262.103357,6164,8012,30074,-1018,-1461,-19992,48,33113,29056,28613,10082,30122
48215,TX,6036,#N/A,5540,8554,4962,3916,3342,#N/A,4249.396674,6164,8412,28777,-1018,-1461,-19992,48,32350,27759,27316,8785,28825
48217,TX,6204,#N/A,5540,8554,4962,3916,3361,#N/A,5440.816302,6164,8554,30279,-1018,-1461,-19992,48,32537,29261,28818,10287,30327
48219,TX,6324,#N/A,5540,8554,4962,3916,3375,#N/A,5301.817345,6164,8672,30378,-1018,-1461,-19992,48,32671,29360,28917,10386,30426
48221,TX,7572,#N/A,5540,8554,4962,3916,3519,#N/A,5639.38624,6164,8893,32185,2524,2080,-16187,3589,34063,34709,34265,15998,35774
48223,TX,6252,#N/A,5540,8554,4962,3916,3367,#N/A,5321.674339,6164,8187,29841,-1018,-1461,-19992,48,32591,28823,28380,9849,29889
48225,TX,5808,#N/A,5540,8554,4962,3916,3316,#N/A,4646.53655,6164,8554,29089,-1195,-1638,-20301,-129,32096,27894,27451,8788,28960
48227,TX,5796,#N/A,5540,8554,4962,3916,3314,#N/A,4825.249494,6164,8177,28879,-1195,-1638,-20301,-129,32082,27684,27241,8578,28750
48229,TX,5940,#N/A,5540,8554,4962,3916,3331,#N/A,5162.818388,6164,8578,29761,-1018,-1461,-19992,48,32243,28743,28300,9769,29809
48231,TX,8664,#N/A,5540,8554,4962,3916,3645,#N/A,5381.24532,6164,8893,33018,2700,2256,-15879,3765,35281,35718,35274,17139,36783
48233,TX,6708,#N/A,5540,8554,4962,3916,3419,#N/A,5718.814215,6164,8243,30750,-1018,-1461,-19992,48,33099,29732,29289,10758,30798
48235,TX,6564,#N/A,5540,8554,4962,3916,3403,#N/A,4805.3925,6164,8354,29803,-1018,-1461,-19992,48,32939,28785,28342,9811,29851
48237,TX,6744,#N/A,5540,8554,4962,3916,3423,#N/A,5718.814215,6164,8554,31097,-1018,-1461,-19992,48,33139,30079,29636,11105,31145
48239,TX,7092,#N/A,5540,8554,4962,3916,3463,#N/A,4626.679556,6164,8554,30353,-842,-1285,-19684,224,33527,29511,29068,10669,30577
48241,TX,6780,#N/A,5540,8554,4962,3916,3428,#N/A,5063.533419,6164,8554,30478,-1018,-1461,-19992,48,33180,29460,29017,10486,30526
48243,TX,6444,#N/A,5540,8554,4962,3916,3389,#N/A,5679.100227,6164,8554,30757,-1018,-1461,-19992,48,32805,29739,29296,10765,30805
48245,TX,7800,#N/A,5540,8554,4962,3916,3545,#N/A,4845.106488,6164,8191,30917,-842,-1285,-19684,224,34317,30075,29632,11233,31141
48247,TX,6444,#N/A,5540,8554,4962,3916,3389,#N/A,4249.396674,6164,8554,29327,-1018,-1461,-19992,48,32805,28309,27866,9335,29375
48249,TX,7008,#N/A,5540,8554,4962,3916,3454,#N/A,4428.109618,6164,8435,29951,-842,-1285,-19684,224,33434,29109,28666,10267,30175
48251,TX,8700,#N/A,5540,8554,4962,3916,3649,#N/A,4686.250537,6164,8892,32359,2700,2256,-15879,3765,35321,35059,34615,16480,36124
48253,TX,7032,#N/A,5540,8554,4962,3916,3457,#N/A,5798.24219,6164,8291,31201,-1018,-1461,-19992,48,33461,30183,29740,11209,31249
48255,TX,6444,#N/A,5540,8554,4962,3916,3389,#N/A,4924.534463,6164,8554,30003,-1018,-1461,-19992,48,32805,28985,28542,10011,30051
48257,TX,8664,#N/A,5540,8554,4962,3916,3645,#N/A,5619.529246,6164,8884,33248,2700,2256,-15879,3765,35281,35948,35504,17369,37013
48259,TX,8544,#N/A,5540,8554,4962,3916,3631,#N/A,5381.24532,6164,8739,32744,2524,2080,-16187,3589,35147,35268,34824,16557,36333
48261,TX,6960,#N/A,5540,8554,4962,3916,3448,#N/A,4388.39563,6164,8329,29758,-1018,-1461,-19992,48,33380,28740,28297,9766,29806
48263,TX,7056,#N/A,5540,8554,4962,3916,3459,#N/A,5381.24532,6164,8554,31071,-842,-1285,-19684,224,33487,30229,29786,11387,31295
48265,TX,7476,#N/A,5540,8554,4962,3916,3508,#N/A,5023.819432,6164,7898,30477,-1018,-1461,-19992,48,33956,29459,29016,10485,30525
48267,TX,5976,#N/A,5540,8554,4962,3916,3335,#N/A,5023.819432,6164,8554,29634,-1018,-1461,-19992,48,32283,28616,28173,9642,29682
48269,TX,6084,#N/A,5540,8554,4962,3916,3347,#N/A,5480.530289,6164,8554,30199,-1018,-1461,-19992,48,32403,29181,28738,10207,30247
48271,TX,5856,#N/A,5540,8554,4962,3916,3321,#N/A,4110.397717,6164,8554,28600,-1018,-1461,-19992,48,32149,27582,27139,8608,28648
48273,TX,6240,#N/A,5540,8554,4962,3916,3365,#N/A,4765.678512,6164,8294,29380,-1018,-1461,-19992,48,32577,28362,27919,9388,29428
48275,TX,5940,#N/A,5540,8554,4962,3916,3331,#N/A,5480.530289,6164,8554,30055,-1018,-1461,-19992,48,32243,29037,28594,10063,30103
48277,TX,6444,#N/A,5540,8554,4962,3916,3389,#N/A,5401.102314,6164,8057,29982,-1018,-1461,-19992,48,32805,28964,28521,9990,30030
48279,TX,6444,#N/A,5540,8554,4962,3916,3389,#N/A,5262.103357,6164,8554,30340,-1018,-1461,-19992,48,32805,29322,28879,10348,30388
48281,TX,6444,#N/A,5540,8554,4962,3916,3389,#N/A,5063.533419,6164,8792,30380,-1018,-1461,-19992,48,32805,29362,28919,10388,30428
48283,TX,5652,#N/A,5540,8554,4962,3916,3298,#N/A,4328.824649,6164,8554,28615,-1195,-1638,-20301,-129,31922,27420,26977,8314,28486
48285,TX,5652,#N/A,5540,8554,4962,3916,3298,#N/A,4646.53655,6164,8554,28933,-1195,-1638,-20301,-129,31922,27738,27295,8632,28804
48287,TX,6444,#N/A,5540,8554,4962,3916,3389,#N/A,5321.674339,6164,8554,30400,-1018,-1461,-19992,48,32805,29382,28939,10408,30448
48289,TX,5940,#N/A,5540,8554,4962,3916,3331,#N/A,5063.533419,6164,8554,29638,-1018,-1461,-19992,48,32243,28620,28177,9646,29686
48291,TX,9000,#N/A,5540,8554,4962,3916,3683,#N/A,4984.105444,6164,8942,33006,2700,2256,-15879,3765,35655,35706,35262,17127,36771
48293,TX,6804,#N/A,5540,8554,4962,3916,3430,#N/A,4745.821519,6164,8554,30184,-1018,-1461,-19992,48,33206,29166,28723,10192,30232
48295,TX,5652,#N/A,5540,8554,4962,3916,3298,#N/A,5480.530289,6164,8554,29767,-1195,-1638,-20301,-129,31922,28572,28129,9466,29638
48297,TX,6444,#N/A,5540,8554,4962,3916,3389,#N/A,4686.250537,6164,8554,29764,-1018,-1461,-19992,48,32805,28746,28303,9772,29812
48299,TX,5652,#N/A,5540,8554,4962,3916,3298,#N/A,4864.963481,6164,8554,29151,-1195,-1638,-20301,-129,31922,27956,27513,8850,29022
48301,TX,6084,#N/A,5540,8554,4962,3916,3347,#N/A,5818.099184,6164,8554,30536,-1018,-1461,-19992,48,32403,29518,29075,10544,30584
48303,TX,7068,#N/A,5540,8554,4962,3916,3461,#N/A,5262.103357,6164,8407,30817,-842,-1285,-19684,224,33501,29975,29532,11133,31041
48305,TX,6444,#N/A,5540,8554,4962,3916,3389,#N/A,5262.103357,6164,8409,30195,-1018,-1461,-19992,48,32805,29177,28734,10203,30243
48307,TX,5652,#N/A,5540,8554,4962,3916,3298,#N/A,5281.960351,6164,8554,29568,-1195,-1638,-20301,-129,31922,28373,27930,9267,29439
48309,TX,6696,#N/A,5540,8554,4962,3916,3418,#N/A,4666.393543,6164,8348,29790,-1018,-1461,-19992,48,33086,28772,28329,9798,29838
48311,TX,6084,#N/A,5540,8554,4962,3916,3347,#N/A,4765.678512,6164,8554,29484,-1018,-1461,-19992,48,32403,28466,28023,9492,29532
48313,TX,6444,#N/A,5540,8554,4962,3916,3389,#N/A,5123.104401,6164,8554,30201,-1018,-1461,-19992,48,32805,29183,28740,10209,30249
48315,TX,5652,#N/A,5540,8554,4962,3916,3298,#N/A,5381.24532,6164,8554,29667,-1195,-1638,-20301,-129,31922,28472,28029,9366,29538
48317,TX,6444,#N/A,5540,8554,4962,3916,3389,#N/A,5043.676426,6164,9236,30803,-842,-1285,-19684,224,32805,29961,29518,11119,31027
48319,TX,5940,#N/A,5540,8554,4962,3916,3331,#N/A,4964.24845,6164,8554,29538,-1018,-1461,-19992,48,32243,28520,28077,9546,29586
48321,TX,6360,#N/A,5540,8554,4962,3916,3379,#N/A,4567.108574,6164,8351,29358,-1018,-1461,-19992,48,32711,28340,27897,9366,29406
48323,TX,6444,#N/A,5540,8554,4962,3916,3389,#N/A,3911.827779,6164,8142,28578,-1018,-1461,-19992,48,32805,27560,27117,8586,28626
48325,TX,6144,#N/A,5540,8554,4962,3916,3354,#N/A,4447.966612,6164,8741,29413,-1018,-1461,-19992,48,32470,28395,27952,9421,29461
48327,TX,5700,#N/A,5540,8554,4962,3916,3303,#N/A,4825.249494,6164,8554,29159,-1195,-1638,-20301,-129,31975,27964,27521,8858,29030
48329,TX,8604,#N/A,5540,8554,4962,3916,3638,#N/A,5182.675382,6164,9333,33200,2700,2256,-15879,3765,35214,35900,35456,17321,36965
48331,TX,6024,#N/A,5540,8554,4962,3916,3340,#N/A,5162.818388,6164,8554,29821,-1018,-1461,-19992,48,32336,28803,28360,9829,29869
48333,TX,5952,#N/A,5540,8554,4962,3916,3332,#N/A,4964.24845,6164,8554,29550,-1018,-1461,-19992,48,32256,28532,28089,9558,29598
48335,TX,6444,#N/A,5540,8554,4962,3916,3389,#N/A,5003.962438,6164,8554,30082,-1018,-1461,-19992,48,32805,29064,28621,10090,30130
48337,TX,5868,#N/A,5540,8554,4962,3916,3322,#N/A,5182.675382,6164,8554,29685,-1018,-1461,-19992,48,32162,28667,28224,9693,29733
48339,TX,9000,#N/A,5540,8554,4962,3916,3683,#N/A,5559.958264,6164,8975,33615,2700,2256,-15879,3765,35655,36315,35871,17736,37380
48341,TX,6648,#N/A,5540,8554,4962,3916,3412,#N/A,5401.102314,6164,9235,31365,-842,-1285,-19684,224,33032,30523,30080,11681,31589
48343,TX,5736,#N/A,5540,8554,4962,3916,3307,#N/A,5182.675382,6164,8554,29553,-1195,-1638,-20301,-129,32015,28358,27915,9252,29424
48345,TX,5940,#N/A,5540,8554,4962,3916,3331,#N/A,5361.388326,6164,8554,29935,-1018,-1461,-19992,48,32243,28917,28474,9943,29983
48347,TX,6852,#N/A,5540,8554,4962,3916,3436,#N/A,5460.673295,6164,7740,30133,-1018,-1461,-19992,48,33260,29115,28672,10141,30181
48349,TX,6696,#N/A,5540,8554,4962,3916,3418,#N/A,4686.250537,6164,8207,29669,-1018,-1461,-19992,48,33086,28651,28208,9677,29717
48351,TX,6336,#N/A,5540,8554,4962,3916,3376,#N/A,5083.390413,6164,8239,29738,-1018,-1461,-19992,48,32684,28720,28277,9746,29786
48353,TX,6444,#N/A,5540,8554,4962,3916,3389,#N/A,4924.534463,6164,7859,29308,-1195,-1638,-20301,-129,32805,28113,27670,9007,29179
48355,TX,7848,#N/A,5540,8554,4962,3916,3551,#N/A,4745.821519,6164,8531,31205,-842,-1285,-19684,224,34371,30363,29920,11521,31429
48357,TX,6516,#N/A,5540,8554,4962,3916,3397,#N/A,5262.103357,6164,8554,30412,-1018,-1461,-19992,48,32885,29394,28951,10420,30460
48359,TX,6912,#N/A,5540,8554,4962,3916,3443,#N/A,5401.102314,6164,8530,30923,-842,-1285,-19684,224,33327,30081,29638,11239,31147
48361,TX,7800,#N/A,5540,8554,4962,3916,3545,#N/A,5083.390413,6164,8207,31171,-842,-1285,-19684,224,34317,30329,29886,11487,31395
48363,TX,6372,#N/A,5540,8554,4962,3916,3381,#N/A,5262.103357,6164,8182,29897,-1018,-1461,-19992,48,32725,28879,28436,9905,29945
48365,TX,5652,#N/A,5540,8554,4962,3916,3298,#N/A,4944.391457,6164,8554,29230,-1195,-1638,-20301,-129,31922,28035,27592,8929,29101
48367,TX,8700,#N/A,5540,8554,4962,3916,3649,#N/A,5957.098141,6164,8886,33623,2700,2256,-15879,3765,35321,36323,35879,17744,37388
48369,TX,6444,#N/A,5540,8554,4962,3916,3389,#N/A,5599.672252,6164,8554,30678,-1018,-1461,-19992,48,32805,29660,29217,10686,30726
48371,TX,6396,#N/A,5540,8554,4962,3916,3383,#N/A,5083.390413,6164,8554,30113,-1018,-1461,-19992,48,32751,29095,28652,10121,30161
48373,TX,5688,#N/A,5540,8554,4962,3916,3302,#N/A,4944.391457,6164,8554,29266,-1195,-1638,-20301,-129,31962,28071,27628,8965,29137
48375,TX,6720,#N/A,5540,8554,4962,3916,3421,#N/A,5162.818388,6164,8537,30500,-1018,-1461,-19992,48,33113,29482,29039,10508,30548
48377,TX,6444,#N/A,5540,8554,4962,3916,3389,#N/A,5897.527159,6164,8554,30976,-1018,-1461,-19992,48,32805,29958,29515,10984,31024
48379,TX,5652,#N/A,5540,8554,4962,3916,3298,#N/A,5480.530289,6164,8554,29767,-1195,-1638,-20301,-129,31922,28572,28129,9466,29638
48381,TX,6720,#N/A,5540,8554,4962,3916,3421,#N/A,5857.813171,6164,8535,31193,-1018,-1461,-19992,48,33113,30175,29732,11201,31241
48383,TX,6204,#N/A,5540,8554,4962,3916,3361,#N/A,4964.24845,6164,8554,29802,-1018,-1461,-19992,48,32537,28784,28341,9810,29850
48385,TX,5652,#N/A,5540,8554,4962,3916,3298,#N/A,4884.820475,6164,8554,29171,-1195,-1638,-20301,-129,31922,27976,27533,8870,29042
48387,TX,5652,#N/A,5540,8554,4962,3916,3298,#N/A,5162.818388,6164,8554,29449,-1195,-1638,-20301,-129,31922,28254,27811,9148,29320
48389,TX,6072,#N/A,5540,8554,4962,3916,3346,#N/A,5142.961395,6164,8464,29759,-1018,-1461,-19992,48,32390,28741,28298,9767,29807
48391,TX,5760,#N/A,5540,8554,4962,3916,3310,#N/A,4686.250537,6164,8554,29080,-1195,-1638,-20301,-129,32042,27885,27442,8779,28951
48393,TX,6084,#N/A,5540,8554,4962,3916,3347,#N/A,5599.672252,6164,8554,30318,-1018,-1461,-19992,48,32403,29300,28857,10326,30366
48395,TX,8448,#N/A,5540,8554,4962,3916,3620,#N/A,4884.820475,6164,8029,31441,2524,2080,-16187,3589,35040,33965,33521,15254,35030
48397,TX,8664,#N/A,5540,8554,4962,3916,3645,#N/A,5579.815258,6164,8884,33208,2700,2256,-15879,3765,35281,35908,35464,17329,36973
48399,TX,6444,#N/A,5540,8554,4962,3916,3389,#N/A,4864.963481,6164,8554,29943,-1018,-1461,-19992,48,32805,28925,28482,9951,29991
48401,TX,6072,#N/A,5540,8554,4962,3916,3346,#N/A,5262.103357,6164,8372,29786,-1018,-1461,-19992,48,32390,28768,28325,9794,29834
48403,TX,6444,#N/A,5540,8554,4962,3916,3389,#N/A,5222.38937,6164,8554,30300,-1018,-1461,-19992,48,32805,29282,28839,10308,30348
48405,TX,5652,#N/A,5540,8554,4962,3916,3298,#N/A,5222.38937,6164,8554,29508,-1195,-1638,-20301,-129,31922,28313,27870,9207,29379
48407,TX,9000,#N/A,5540,8554,4962,3916,3683,#N/A,5778.385196,6164,8554,33412,2700,2256,-15879,3765,35655,36112,35668,17533,37177
48409,TX,7848,#N/A,5540,8554,4962,3916,3551,#N/A,4586.965568,6164,8528,31043,-842,-1285,-19684,224,34371,30201,29758,11359,31267
48411,TX,5652,#N/A,5540,8554,4962,3916,3298,#N/A,4944.391457,6164,8554,29230,-1195,-1638,-20301,-129,31922,28035,27592,8929,29101
48413,TX,5652,#N/A,5540,8554,4962,3916,3298,#N/A,4805.3925,6164,8554,29091,-1195,-1638,-20301,-129,31922,27896,27453,8790,28962
48415,TX,5652,#N/A,5540,8554,4962,3916,3298,#N/A,4984.105444,6164,8356,29072,-1195,-1638,-20301,-129,31922,27877,27434,8771,28943
48417,TX,5940,#N/A,5540,8554,4962,3916,3331,#N/A,4924.534463,6164,8554,29499,-1018,-1461,-19992,48,32243,28481,28038,9507,29547
48419,TX,5652,#N/A,5540,8554,4962,3916,3298,#N/A,5301.817345,6164,8554,29588,-1195,-1638,-20301,-129,31922,28393,27950,9287,29459
48421,TX,6444,#N/A,5540,8554,4962,3916,3389,#N/A,5321.674339,6164,8554,30400,-1018,-1461,-19992,48,32805,29382,28939,10408,30448
48423,TX,8856,#N/A,5540,8554,4962,3916,3667,#N/A,5460.673295,6164,8419,32816,2524,2080,-16187,3589,35495,35340,34896,16629,36405
48425,TX,6444,#N/A,5540,8554,4962,3916,3389,#N/A,4944.391457,6164,8878,30347,-1018,-1461,-19992,48,32805,29329,28886,10355,30395
48427,TX,5652,#N/A,5540,8554,4962,3916,3298,#N/A,4606.822562,6164,8045,28383,-1195,-1638,-20301,-129,31922,27188,26745,8082,28254
48429,TX,5868,#N/A,5540,8554,4962,3916,3322,#N/A,5361.388326,6164,8554,29863,-1018,-1461,-19992,48,32162,28845,28402,9871,29911
48431,TX,7020,#N/A,5540,8554,4962,3916,3455,#N/A,5003.962438,6164,8554,30658,-842,-1285,-19684,224,33447,29816,29373,10974,30882
48433,TX,6072,#N/A,5540,8554,4962,3916,3346,#N/A,5401.102314,6164,8554,30107,-1018,-1461,-19992,48,32390,29089,28646,10115,30155
48435,TX,6228,#N/A,5540,8554,4962,3916,3364,#N/A,4547.251581,6164,8554,29409,-1018,-1461,-19992,48,32564,28391,27948,9417,29457
48437,TX,5652,#N/A,5540,8554,4962,3916,3298,#N/A,5381.24532,6164,8554,29667,-1195,-1638,-20301,-129,31922,28472,28029,9366,29538
48439,TX,8700,#N/A,5540,8554,4962,3916,3649,#N/A,5401.102314,6164,8920,33101,2700,2256,-15879,3765,35321,35801,35357,17222,36866
48441,TX,7032,#N/A,5540,8554,4962,3916,3457,#N/A,4864.963481,6164,8246,30223,-1018,-1461,-19992,48,33461,29205,28762,10231,30271
48443,TX,6444,#N/A,5540,8554,4962,3916,3389,#N/A,4428.109618,6164,8554,29506,-1018,-1461,-19992,48,32805,28488,28045,9514,29554
48445,TX,5832,#N/A,5540,8554,4962,3916,3318,#N/A,5262.103357,6164,8554,29728,-1018,-1461,-19992,48,32122,28710,28267,9736,29776
48447,TX,5940,#N/A,5540,8554,4962,3916,3331,#N/A,5500.387283,6164,8554,30074,-1018,-1461,-19992,48,32243,29056,28613,10082,30122
48449,TX,5976,#N/A,5540,8554,4962,3916,3335,#N/A,5083.390413,6164,8550,29689,-1018,-1461,-19992,48,32283,28671,28228,9697,29737
48451,TX,6564,#N/A,5540,8554,4962,3916,3403,#N/A,4805.3925,6164,8315,29765,-1018,-1461,-19992,48,32939,28747,28304,9773,29813
48453,TX,10236,#N/A,5540,8554,4962,3916,3826,#N/A,5440.816302,6164,9157,34913,3053,2609,-15262,4118,37034,37966,37522,19651,39031
48455,TX,6372,#N/A,5540,8554,4962,3916,3381,#N/A,5043.676426,6164,7304,28799,-1195,-1638,-20301,-129,32725,27604,27161,8498,28670
48457,TX,5916,#N/A,5540,8554,4962,3916,3328,#N/A,5162.818388,6164,8554,29713,-1018,-1461,-19992,48,32216,28695,28252,9721,29761
48459,TX,7800,#N/A,5540,8554,4962,3916,3545,#N/A,5162.818388,6164,8375,31418,-842,-1285,-19684,224,34317,30576,30133,11734,31642
48461,TX,6444,#N/A,5540,8554,4962,3916,3389,#N/A,5083.390413,6164,8554,30161,-1018,-1461,-19992,48,32805,29143,28700,10169,30209
48463,TX,6444,#N/A,5540,8554,4962,3916,3389,#N/A,4507.537593,6164,7948,28980,-1018,-1461,-19992,48,32805,27962,27519,8988,29028
48465,TX,5652,#N/A,5540,8554,4962,3916,3298,#N/A,4189.825692,6164,8615,28536,-1195,-1638,-20301,-129,31922,27341,26898,8235,28407
48467,TX,6420,#N/A,5540,8554,4962,3916,3386,#N/A,5381.24532,6164,8554,30435,-1018,-1461,-19992,48,32778,29417,28974,10443,30483
48469,TX,6936,#N/A,5540,8554,4962,3916,3446,#N/A,4765.678512,6164,8579,30361,-842,-1285,-19684,224,33354,29519,29076,10677,30585
48471,TX,7224,#N/A,5540,8554,4962,3916,3479,#N/A,5222.38937,6164,7199,29725,-1018,-1461,-19992,48,33675,28707,28264,9733,29773
48473,TX,9000,#N/A,5540,8554,4962,3916,3683,#N/A,5937.241147,6164,8958,33976,2700,2256,-15879,3765,35655,36676,36232,18097,37741
48475,TX,6444,#N/A,5540,8554,4962,3916,3389,#N/A,4984.105444,6164,8554,30062,-1018,-1461,-19992,48,32805,29044,28601,10070,30110
48477,TX,7344,#N/A,5540,8554,4962,3916,3493,#N/A,5083.390413,6164,8276,30783,-842,-1285,-19684,224,33809,29941,29498,11099,31007
48479,TX,7416,#N/A,5540,8554,4962,3916,3501,#N/A,4130.254711,6164,8746,30373,-842,-1285,-19684,224,33889,29531,29088,10689,30597
48481,TX,6240,#N/A,5540,8554,4962,3916,3365,#N/A,4666.393543,6164,8389,29376,-1018,-1461,-19992,48,32577,28358,27915,9384,29424
48483,TX,6444,#N/A,5540,8554,4962,3916,3389,#N/A,5559.958264,6164,8554,30638,-1018,-1461,-19992,48,32805,29620,29177,10646,30686
48485,TX,6840,#N/A,5540,8554,4962,3916,3434,#N/A,4964.24845,6164,8280,30164,-1018,-1461,-19992,48,33246,29146,28703,10172,30212
48487,TX,5952,#N/A,5540,8554,4962,3916,3332,#N/A,5043.676426,6164,8060,29136,-1195,-1638,-20301,-129,32256,27941,27498,8835,29007
48489,TX,5700,#N/A,5540,8554,4962,3916,3303,#N/A,3971.39876,6164,7644,27396,-1371,-1814,-20609,-305,31975,26025,25582,6787,27091
48491,TX,10236,#N/A,5540,8554,4962,3916,3826,#N/A,5341.531333,6164,9125,34782,2877,2433,-15570,3942,37034,37659,37215,19212,38724
48493,TX,8196,#N/A,5540,8554,4962,3916,3591,#N/A,5023.819432,6164,8735,32035,2524,2080,-16187,3589,34759,34559,34115,15848,35624
48495,TX,5652,#N/A,5540,8554,4962,3916,3298,#N/A,5142.961395,6164,8554,29429,-1195,-1638,-20301,-129,31922,28234,27791,9128,29300
48497,TX,7056,#N/A,5540,8554,4962,3916,3459,#N/A,5639.38624,6164,8883,31658,-842,-1285,-19684,224,33487,30816,30373,11974,31882
48499,TX,5880,#N/A,5540,8554,4962,3916,3324,#N/A,5440.816302,6164,8554,29955,-1018,-1461,-19992,48,32176,28937,28494,9963,30003
48501,TX,6084,#N/A,5540,8554,4962,3916,3347,#N/A,5718.814215,6164,8554,30437,-1018,-1461,-19992,48,32403,29419,28976,10445,30485
48503,TX,6504,#N/A,5540,8554,4962,3916,3396,#N/A,5043.676426,6164,8554,30182,-1018,-1461,-19992,48,32872,29164,28721,10190,30230
48505,TX,5652,#N/A,5540,8554,4962,3916,3298,#N/A,4229.53968,6164,7928,27889,-1195,-1638,-20301,-129,31922,26694,26251,7588,27760
48507,TX,6444,#N/A,5540,8554,4962,3916,3389,#N/A,4229.53968,6164,8554,29308,-1018,-1461,-19992,48,32805,28290,27847,9316,29356
49001,UT,6312,#N/A,6612,7382,4123,3971,4692,#N/A,6541.022793,5930,7382,30136,-3410,-21,-18552,1488,33092,26726,30115,11584,31624
49003,UT,6300,#N/A,6612,7382,4123,3971,4690,#N/A,6896.513162,5930,8139,31236,-3410,-21,-18552,1488,33078,27826,31215,12684,32724
49005,UT,5772,#N/A,6612,7382,4123,3971,4603,#N/A,6493.624077,5930,7752,29919,-3410,-21,-18552,1488,32463,26509,29898,11367,31407
49007,UT,5700,#N/A,6612,7382,4123,3971,4591,#N/A,6730.617656,5930,7167,29498,-3637,-248,-18911,1261,32379,25861,29250,10587,30759
49009,UT,7812,#N/A,6612,7382,4123,3971,4940,#N/A,7346.800963,5930,7382,32442,-3184,205,-18194,1714,34840,29258,32647,14248,34156
49011,UT,7068,#N/A,6612,7382,4123,3971,4817,#N/A,6469.924719,5930,8213,31652,-3184,205,-18194,1714,33973,28468,31857,13458,33366
49013,UT,6804,#N/A,6612,7382,4123,3971,4773,#N/A,6398.826645,5930,7382,30486,-3410,-21,-18552,1488,33665,27076,30465,11934,31974
49015,UT,6300,#N/A,6612,7382,4123,3971,4690,#N/A,6446.225361,5930,7382,30029,-3410,-21,-18552,1488,33078,26619,30008,11477,31517
49017,UT,5856,#N/A,6612,7382,4123,3971,4616,#N/A,6541.022793,5930,7382,29680,-3637,-248,-18911,1261,32560,26043,29432,10769,30941
49019,UT,7080,#N/A,6612,7382,4123,3971,4819,#N/A,7275.702889,5930,7382,31639,-3410,-21,-18552,1488,33987,28229,31618,13087,33127
49021,UT,6300,#N/A,6612,7382,4123,3971,4690,#N/A,6659.519583,5930,7290,30150,-3410,-21,-18552,1488,33078,26740,30129,11598,31638
49023,UT,7320,#N/A,6612,7382,4123,3971,4858,#N/A,6398.826645,5930,8084,31704,-3184,205,-18194,1714,34266,28520,31909,13510,33418
49025,UT,7992,#N/A,6612,7382,4123,3971,4969,#N/A,6943.911878,5930,7382,32219,-3184,205,-18194,1714,35049,29035,32424,14025,33933
49027,UT,6300,#N/A,6612,7382,4123,3971,4690,#N/A,6375.127287,5930,7382,29958,-3410,-21,-18552,1488,33078,26548,29937,11406,31446
49029,UT,7068,#N/A,6612,7382,4123,3971,4817,#N/A,6375.127287,5930,8099,31443,-3184,205,-18194,1714,33973,28259,31648,13249,33157
49031,UT,7884,#N/A,6612,7382,4123,3971,4951,#N/A,6493.624077,5930,7382,31661,-3184,205,-18194,1714,34923,28477,31866,13467,33375
49033,UT,7968,#N/A,6612,7382,4123,3971,4965,#N/A,6422.526003,5930,7382,31674,-3184,205,-18194,1714,35021,28490,31879,13480,33388
49035,UT,8484,#N/A,6612,7382,4123,3971,5051,#N/A,6351.427929,5930,8260,32997,217,3607,-14528,5116,35623,33214,36604,18469,38113
49037,UT,6300,#N/A,6612,7382,4123,3971,4690,#N/A,7133.506742,5930,7382,30717,-3410,-21,-18552,1488,33078,27307,30696,12165,32205
49039,UT,5808,#N/A,6612,7382,4123,3971,4608,#N/A,6517.323435,5930,7382,29608,-3637,-248,-18911,1261,32504,25971,29360,10697,30869
49041,UT,6300,#N/A,6612,7382,4123,3971,4690,#N/A,6446.225361,5930,7382,30029,-3410,-21,-18552,1488,33078,26619,30008,11477,31517
49043,UT,8112,#N/A,6612,7382,4123,3971,4989,#N/A,8389.572713,5930,8172,34574,-9,3381,-14886,4890,35189,34565,37955,19688,39464
49045,UT,6900,#N/A,6612,7382,4123,3971,4789,#N/A,6612.120867,5930,8144,31557,-3184,205,-18194,1714,33777,28373,31762,13363,33271
49047,UT,8052,#N/A,6612,7382,4123,3971,4979,#N/A,6920.21252,5930,8019,32892,-9,3381,-14886,4890,35119,32883,36273,18006,37782
49049,UT,7320,#N/A,6612,7382,4123,3971,4858,#N/A,6280.329855,5930,8216,31717,-9,3381,-14886,4890,34266,31708,35098,16831,36607
49051,UT,8508,#N/A,6612,7382,4123,3971,5054,#N/A,7370.500321,5930,8222,34001,217,3607,-14528,5116,35650,34218,37608,19473,39117
49053,UT,6876,#N/A,6612,7382,4123,3971,4785,#N/A,6517.323435,5930,7373,30667,-3410,-21,-18552,1488,33749,27257,30646,12115,32155
49055,UT,6300,#N/A,6612,7382,4123,3971,4690,#N/A,6920.21252,5930,7382,30503,-3410,-21,-18552,1488,33078,27093,30482,11951,31991
49057,UT,7068,#N/A,6612,7382,4123,3971,4817,#N/A,6161.833066,5930,8217,31348,-3184,205,-18194,1714,33973,28164,31553,13154,33062
50001,VT,8808,#N/A,6434,6855,4844,3644,4609,#N/A,8671.068898,10696,6855,38674,4733,4042,-13697,5551,35194,43407,42716,24977,44225
50003,VT,7992,#N/A,6434,6855,4844,3644,4486,#N/A,6918.406035,10696,6551,35801,4506,3815,-14056,5324,34255,40307,39616,21745,41125
50005,VT,6864,#N/A,6434,6855,4844,3644,4316,#N/A,7979.228294,10696,6855,36038,4280,3589,-14414,5098,32957,40318,39627,21624,41136
50007,VT,12036,#N/A,6434,6855,4844,3644,5096,#N/A,7541.062579,10696,7177,41094,5412,4721,-12622,6230,38909,46506,45815,28472,47324
50009,VT,6816,#N/A,6434,6855,4844,3644,4309,#N/A,7725.553406,10696,6289,35170,4053,3362,-14773,4871,32902,39223,38532,20397,40041
50011,VT,12036,#N/A,6434,6855,4844,3644,5096,#N/A,8071.473708,10696,7158,41605,5412,4721,-12622,6230,38909,47017,46326,28983,47835
50013,VT,12036,#N/A,6434,6855,4844,3644,5096,#N/A,7149.01957,10696,7167,40692,5412,4721,-12622,6230,38909,46104,45413,28070,46922
50015,VT,9072,#N/A,6434,6855,4844,3644,4649,#N/A,8578.823484,10696,6855,38846,4733,4042,-13697,5551,35498,43579,42888,25149,44397
50017,VT,8160,#N/A,6434,6855,4844,3644,4511,#N/A,8348.209949,10696,6721,37570,4506,3815,-14056,5324,34448,42076,41385,23514,42894
50019,VT,7092,#N/A,6434,6855,4844,3644,4351,#N/A,7587.185285,10696,6855,35874,4280,3589,-14414,5098,33220,40154,39463,21460,40972
50021,VT,7812,#N/A,6434,6855,4844,3644,4459,#N/A,6918.406035,10696,6574,35644,4506,3815,-14056,5324,34048,40150,39459,21588,40968
50023,VT,8712,#N/A,6434,6855,4844,3644,4595,#N/A,8486.57807,10696,6782,38320,4733,4042,-13697,5551,35084,43053,42362,24623,43871
50025,VT,7764,#N/A,6434,6855,4844,3644,4452,#N/A,8163.719122,10696,6855,37123,4506,3815,-14056,5324,33993,41629,40938,23067,42447
50027,VT,8184,#N/A,6434,6855,4844,3644,4515,#N/A,8694.130251,10696,6715,37933,4506,3815,-14056,5324,34476,42439,41748,23877,43257
51001,VA,7428,#N/A,5540,8554,4790,3916,4389,#N/A,5460.673295,6596,8554,31955,-1141,-2021,-20288,-512,34617,30814,29934,11667,31443
51003,VA,10200,#N/A,5540,8554,4790,3916,4792,#N/A,6175.525072,6596,8423,35310,-740,-1620,-19623,-111,37792,34570,33690,15687,35199
51005,VA,6024,#N/A,5540,8554,4790,3916,4185,#N/A,5758.528202,6596,8554,30849,-5093,-5973,-24504,-4464,33009,25756,24876,6345,26385
51007,VA,9960,#N/A,5540,8554,4790,3916,4757,#N/A,5778.385196,6596,8675,34926,-740,-1620,-19623,-111,37517,34186,33306,15303,34815
51009,VA,6456,#N/A,5540,8554,4790,3916,4248,#N/A,5500.387283,6596,8262,30730,-5093,-5973,-24504,-4464,33504,25637,24757,6226,26266
51011,VA,6456,#N/A,5540,8554,4790,3916,4248,#N/A,5599.672252,6596,8257,30825,-5093,-5973,-24504,-4464,33504,25732,24852,6321,26361
51013,VA,14868,#N/A,5540,8554,4790,3916,5469,#N/A,7307.373719,6596,10265,42952,842,-39,-17118,1470,43137,43794,42913,25834,44422
51015,VA,6828,#N/A,5540,8554,4790,3916,4302,#N/A,5679.100227,6596,8238,31257,-4917,-5797,-24196,-4288,33930,26340,25460,7061,26969
51017,VA,6240,#N/A,5540,8554,4790,3916,4217,#N/A,5718.814215,6596,8554,31025,-5093,-5973,-24504,-4464,33257,25932,25052,6521,26561
51019,VA,6456,#N/A,5540,8554,4790,3916,4248,#N/A,6016.669122,6596,8256,31240,-5093,-5973,-24504,-4464,33504,26147,25267,6736,26776
51021,VA,6240,#N/A,5540,8554,4790,3916,4217,#N/A,5500.387283,6596,8554,30806,-5093,-5973,-24504,-4464,33257,25713,24833,6302,26342
51023,VA,6936,#N/A,5540,8554,4790,3916,4318,#N/A,6036.526116,6596,8251,31736,-4917,-5797,-24196,-4288,34054,26819,25939,7540,27448
51025,VA,5472,#N/A,5540,8554,4790,3916,4105,#N/A,5262.103357,6596,8554,29800,-5093,-5973,-24504,-4464,32377,24707,23827,5296,25336
51027,VA,6240,#N/A,5540,8554,4790,3916,4217,#N/A,5341.531333,6596,8554,30648,-5093,-5973,-24504,-4464,33257,25555,24675,6144,26184
51029,VA,6552,#N/A,5540,8554,4790,3916,4262,#N/A,5857.813171,6596,8444,31365,-4917,-5797,-24196,-4288,33614,26448,25568,7169,27077
51031,VA,6456,#N/A,5540,8554,4790,3916,4248,#N/A,5440.816302,6596,8251,30660,-5093,-5973,-24504,-4464,33504,25567,24687,6156,26196
51033,VA,9960,#N/A,5540,8554,4790,3916,4757,#N/A,5619.529246,6596,8663,34755,-740,-1620,-19623,-111,37517,34015,33135,15132,34644
51035,VA,6240,#N/A,5540,8554,4790,3916,4217,#N/A,5341.531333,6596,8554,30648,-5093,-5973,-24504,-4464,33257,25555,24675,6144,26184
51036,VA,9960,#N/A,5540,8554,4790,3916,4757,#N/A,5957.098141,6596,8671,35100,-740,-1620,-19623,-111,37517,34360,33480,15477,34989
51037,VA,5784,#N/A,5540,8554,4790,3916,4150,#N/A,5460.673295,6596,8554,30311,-5093,-5973,-24504,-4464,32734,25218,24338,5807,25847
51041,VA,9960,#N/A,5540,8554,4790,3916,4757,#N/A,5877.670165,6596,8677,35026,-740,-1620,-19623,-111,37517,34286,33406,15403,34915
51043,VA,14868,#N/A,5540,8554,4790,3916,5469,#N/A,6135.811085,6596,9702,41218,579,-301,-17512,1208,43137,41797,40917,23706,42426
51045,VA,6936,#N/A,5540,8554,4790,3916,4318,#N/A,5818.099184,6596,8265,31531,-4917,-5797,-24196,-4288,34054,26614,25734,7335,27243
51047,VA,7704,#N/A,5540,8554,4790,3916,4429,#N/A,5420.959308,6596,9730,33367,-952,-1833,-19968,-324,34933,32415,31534,13399,33043
51049,VA,9960,#N/A,5540,8554,4790,3916,4757,#N/A,5579.815258,6596,8554,34606,-740,-1620,-19623,-111,37517,33866,32986,14983,34495
51051,VA,5472,#N/A,5540,8554,4790,3916,4105,#N/A,5460.673295,6596,7413,28857,-6249,-6326,-25121,-4817,32377,22608,22531,3736,24040
51053,VA,9960,#N/A,5540,8554,4790,3916,4757,#N/A,5420.959308,6596,8670,34563,-740,-1620,-19623,-111,37517,33823,32943,14940,34452
51057,VA,8424,#N/A,5540,8554,4790,3916,4534,#N/A,5679.100227,6596,8554,33169,-952,-1833,-19968,-324,35758,32217,31336,13201,32845
51059,VA,14868,#N/A,5540,8554,4790,3916,5469,#N/A,6810.948874,6596,9951,42142,579,-301,-17512,1208,43137,42721,41841,24630,43350
51061,VA,14868,#N/A,5540,8554,4790,3916,5469,#N/A,6830.805868,6596,9712,41923,579,-301,-17512,1208,43137,42502,41622,24411,43131
51063,VA,5472,#N/A,5540,8554,4790,3916,4105,#N/A,5698.957221,6596,8161,29844,-5377,-6150,-24813,-4641,32377,24467,23694,5031,25203
51065,VA,10200,#N/A,5540,8554,4790,3916,4792,#N/A,6175.525072,6596,8441,35329,-740,-1620,-19623,-111,37792,34589,33709,15706,35218
51067,VA,5856,#N/A,5540,8554,4790,3916,4161,#N/A,5639.38624,6596,8249,30256,-5093,-5973,-24504,-4464,32817,25163,24283,5752,25792
51069,VA,7452,#N/A,5540,8554,4790,3916,4393,#N/A,5520.244277,6596,8481,31965,-4917,-5797,-24196,-4288,34645,27048,26168,7769,27677
51071,VA,6240,#N/A,5540,8554,4790,3916,4217,#N/A,5897.527159,6596,8148,30797,-5093,-5973,-24504,-4464,33257,25704,24824,6293,26333
51073,VA,11268,#N/A,5540,8554,4790,3916,4947,#N/A,5857.813171,6596,8770,36408,-316,-1196,-18935,313,39015,36092,35212,17473,36721
51075,VA,9960,#N/A,5540,8554,4790,3916,4757,#N/A,5996.812128,6596,8671,35140,-740,-1620,-19623,-111,37517,34400,33520,15517,35029
51077,VA,6240,#N/A,5540,8554,4790,3916,4217,#N/A,5579.815258,6596,8554,30886,-5093,-5973,-24504,-4464,33257,25793,24913,6382,26422
51079,VA,10200,#N/A,5540,8554,4790,3916,4792,#N/A,6076.240103,6596,8441,35229,-740,-1620,-19623,-111,37792,34489,33609,15606,35118
51081,VA,6240,#N/A,5540,8554,4790,3916,4217,#N/A,5281.960351,6596,8554,30588,-5093,-5973,-24504,-4464,33257,25495,24615,6084,26124
51083,VA,5772,#N/A,5540,8554,4790,3916,4149,#N/A,5321.674339,6596,8554,30160,-5093,-5973,-24504,-4464,32721,25067,24187,5656,25696
51085,VA,9960,#N/A,5540,8554,4790,3916,4757,#N/A,5877.670165,6596,8673,35022,-740,-1620,-19623,-111,37517,34282,33402,15399,34911
51087,VA,9960,#N/A,5540,8554,4790,3916,4757,#N/A,5877.670165,6596,8685,35035,-740,-1620,-19623,-111,37517,34295,33415,15412,34924
51089,VA,6216,#N/A,5540,8554,4790,3916,4213,#N/A,5401.102314,6596,7336,29465,-5377,-6150,-24813,-4641,33229,24088,23315,4652,24824
51091,VA,6240,#N/A,5540,8554,4790,3916,4217,#N/A,5639.38624,6596,8554,30945,-5093,-5973,-24504,-4464,33257,25852,24972,6441,26481
51093,VA,11268,#N/A,5540,8554,4790,3916,4947,#N/A,5937.241147,6596,8763,36480,-316,-1196,-18935,313,39015,36164,35284,17545,36793
51095,VA,11268,#N/A,5540,8554,4790,3916,4947,#N/A,7227.945744,6596,8774,37782,-316,-1196,-18935,313,39015,37466,36586,18847,38095
51097,VA,9960,#N/A,5540,8554,4790,3916,4757,#N/A,6056.38311,6596,8554,35082,-740,-1620,-19623,-111,37517,34342,33462,15459,34971
51099,VA,8556,#N/A,5540,8554,4790,3916,4553,#N/A,5877.670165,6596,8554,33500,-952,-1833,-19968,-324,35909,32548,31667,13532,33176
51101,VA,9960,#N/A,5540,8554,4790,3916,4757,#N/A,5996.812128,6596,8677,35146,-740,-1620,-19623,-111,37517,34406,33526,15523,35035
51103,VA,7116,#N/A,5540,8554,4790,3916,4344,#N/A,5877.670165,6596,8554,32060,-4917,-5797,-24196,-4288,34260,27143,26263,7864,27772
51105,VA,6096,#N/A,5540,8554,4790,3916,4196,#N/A,5301.817345,6596,8554,30464,-5093,-5973,-24504,-4464,33092,25371,24491,5960,26000
51107,VA,14868,#N/A,5540,8554,4790,3916,5469,#N/A,6632.23593,6596,9840,41852,579,-301,-17512,1208,43137,42431,41551,24340,43060
51109,VA,7260,#N/A,5540,8554,4790,3916,4365,#N/A,5738.671209,6596,8554,32065,-4917,-5797,-24196,-4288,34425,27148,26268,7869,27777
51111,VA,5472,#N/A,5540,8554,4790,3916,4105,#N/A,5262.103357,6596,8554,29800,-5093,-5973,-24504,-4464,32377,24707,23827,5296,25336
51113,VA,6924,#N/A,5540,8554,4790,3916,4316,#N/A,5559.958264,6596,8554,31550,-4917,-5797,-24196,-4288,34040,26633,25753,7354,27262
51115,VA,11268,#N/A,5540,8554,4790,3916,4947,#N/A,6076.240103,6596,8771,36627,-316,-1196,-18935,313,39015,36311,35431,17692,36940
51117,VA,6240,#N/A,5540,8554,4790,3916,4217,#N/A,5281.960351,6596,8554,30588,-5093,-5973,-24504,-4464,33257,25495,24615,6084,26124
51119,VA,6372,#N/A,5540,8554,4790,3916,4236,#N/A,6215.23906,6596,8554,31653,-5093,-5973,-24504,-4464,33408,26560,25680,7149,27189
51121,VA,7248,#N/A,5540,8554,4790,3916,4363,#N/A,6334.381023,6596,8120,32214,-4917,-5797,-24196,-4288,34411,27297,26417,8018,27926
51125,VA,10200,#N/A,5540,8554,4790,3916,4792,#N/A,5937.241147,6596,8441,35090,-740,-1620,-19623,-111,37792,34350,33470,15467,34979
51127,VA,9960,#N/A,5540,8554,4790,3916,4757,#N/A,5996.812128,6596,8669,35138,-740,-1620,-19623,-111,37517,34398,33518,15515,35027
51131,VA,6276,#N/A,5540,8554,4790,3916,4222,#N/A,5798.24219,6596,8554,31140,-5093,-5973,-24504,-4464,33298,26047,25167,6636,26676
51133,VA,6096,#N/A,5540,8554,4790,3916,4196,#N/A,5917.384153,6596,8554,31079,-5093,-5973,-24504,-4464,33092,25986,25106,6575,26615
51135,VA,7248,#N/A,5540,8554,4790,3916,4363,#N/A,5281.960351,6596,8554,31596,-4917,-5797,-24196,-4288,34411,26679,25799,7400,27308
51137,VA,7332,#N/A,5540,8554,4790,3916,4375,#N/A,5818.099184,6596,8554,32216,-4917,-5797,-24196,-4288,34507,27299,26419,8020,27928
51139,VA,6480,#N/A,5540,8554,4790,3916,4251,#N/A,5500.387283,6596,8554,31046,-4917,-5797,-24196,-4288,33531,26129,25249,6850,26758
51141,VA,6240,#N/A,5540,8554,4790,3916,4217,#N/A,5599.672252,6596,8554,30906,-5093,-5973,-24504,-4464,33257,25813,24933,6402,26442
51143,VA,6024,#N/A,5540,8554,4790,3916,4185,#N/A,5579.815258,6596,7520,29636,-5377,-6150,-24813,-4641,33009,24259,23486,4823,24995
51145,VA,9960,#N/A,5540,8554,4790,3916,4757,#N/A,5758.528202,6596,8675,34906,-740,-1620,-19623,-111,37517,34166,33286,15283,34795
51147,VA,6396,#N/A,5540,8554,4790,3916,4239,#N/A,5321.674339,6596,8554,30784,-4917,-5797,-24196,-4288,33435,25867,24987,6588,26496
51149,VA,9960,#N/A,5540,8554,4790,3916,4757,#N/A,5281.960351,6596,8667,34421,-740,-1620,-19623,-111,37517,33681,32801,14798,34310
51153,VA,14868,#N/A,5540,8554,4790,3916,5469,#N/A,5937.241147,6596,9840,41158,579,-301,-17512,1208,43137,41737,40857,23646,42366
51155,VA,6240,#N/A,5540,8554,4790,3916,4217,#N/A,5639.38624,6596,8119,30511,-5093,-5973,-24504,-4464,33257,25418,24538,6007,26047
51157,VA,10020,#N/A,5540,8554,4790,3916,4765,#N/A,5937.241147,6596,9651,36121,-528,-1409,-19280,100,37585,35593,34712,16841,36221
51159,VA,6372,#N/A,5540,8554,4790,3916,4236,#N/A,5659.243233,6596,8554,31097,-5093,-5973,-24504,-4464,33408,26004,25124,6593,26633
51161,VA,6936,#N/A,5540,8554,4790,3916,4318,#N/A,6056.38311,6596,8218,31723,-4917,-5797,-24196,-4288,34054,26806,25926,7527,27435
51163,VA,6456,#N/A,5540,8554,4790,3916,4248,#N/A,5619.529246,6596,8554,31142,-4917,-5797,-24196,-4288,33504,26225,25345,6946,26854
51165,VA,6816,#N/A,5540,8554,4790,3916,4300,#N/A,5420.959308,6596,8455,31204,-4917,-5797,-24196,-4288,33916,26287,25407,7008,26916
51167,VA,6240,#N/A,5540,8554,4790,3916,4217,#N/A,5500.387283,6596,8554,30806,-5093,-5973,-24504,-4464,33257,25713,24833,6302,26342
51169,VA,5760,#N/A,5540,8554,4790,3916,4147,#N/A,5619.529246,6596,7655,29547,-5377,-6150,-24813,-4641,32707,24170,23397,4734,24906
51171,VA,7116,#N/A,5540,8554,4790,3916,4344,#N/A,5659.243233,6596,8554,31841,-4917,-5797,-24196,-4288,34260,26924,26044,7645,27553
51173,VA,6240,#N/A,5540,8554,4790,3916,4217,#N/A,5341.531333,6596,8554,30648,-5093,-5973,-24504,-4464,33257,25555,24675,6144,26184
51175,VA,6804,#N/A,5540,8554,4790,3916,4299,#N/A,5679.100227,6596,8554,31549,-4917,-5797,-24196,-4288,33903,26632,25752,7353,27261
51177,VA,14868,#N/A,5540,8554,4790,3916,5469,#N/A,5361.388326,6596,9720,40461,579,-301,-17512,1208,43137,41040,40160,22949,41669
51179,VA,14868,#N/A,5540,8554,4790,3916,5469,#N/A,5679.100227,6596,9736,40795,579,-301,-17512,1208,43137,41374,40494,23283,42003
51181,VA,11268,#N/A,5540,8554,4790,3916,4947,#N/A,5718.814215,6596,8554,36053,-528,-1409,-19280,100,39015,35525,34644,16773,36153
51183,VA,9960,#N/A,5540,8554,4790,3916,4757,#N/A,5798.24219,6596,8676,34946,-740,-1620,-19623,-111,37517,34206,33326,15323,34835
51185,VA,6240,#N/A,5540,8554,4790,3916,4217,#N/A,5341.531333,6596,7386,29479,-5377,-6150,-24813,-4641,33257,24102,23329,4666,24838
51187,VA,8244,#N/A,5540,8554,4790,3916,4508,#N/A,6135.811085,6596,9749,34641,-740,-1620,-19623,-111,35552,33901,33021,15018,34530
51191,VA,5760,#N/A,5540,8554,4790,3916,4147,#N/A,5401.102314,6596,7607,29280,-5377,-6150,-24813,-4641,32707,23903,23130,4467,24639
51193,VA,6720,#N/A,5540,8554,4790,3916,4286,#N/A,5897.527159,6596,8554,31684,-4917,-5797,-24196,-4288,33806,26767,25887,7488,27396
51195,VA,6240,#N/A,5540,8554,4790,3916,4217,#N/A,5540.101271,6596,7392,29684,-5377,-6150,-24813,-4641,33257,24307,23534,4871,25043
51197,VA,5628,#N/A,5540,8554,4790,3916,4128,#N/A,5798.24219,6596,8554,30492,-5093,-5973,-24504,-4464,32556,25399,24519,5988,26028
51199,VA,11268,#N/A,5540,8554,4790,3916,4947,#N/A,6056.38311,6596,8777,36614,-316,-1196,-18935,313,39015,36298,35418,17679,36927
51510,VA,14868,#N/A,5540,8554,4790,3916,5469,#N/A,7466.229669,6596,10231,43077,842,-39,-17118,1470,43137,43919,43038,25959,44547
51515,VA,6456,#N/A,5540,8554,4790,3916,4248,#N/A,5778.385196,6596,8210,30957,-5093,-5973,-24504,-4464,33504,25864,24984,6453,26493
51520,VA,5760,#N/A,5540,8554,4790,3916,4147,#N/A,5599.672252,6596,7554,29426,-5377,-6150,-24813,-4641,32707,24049,23276,4613,24785
51530,VA,6456,#N/A,5540,8554,4790,3916,4248,#N/A,5679.100227,6596,8554,31201,-4917,-5797,-24196,-4288,33504,26284,25404,7005,26913
51540,VA,10200,#N/A,5540,8554,4790,3916,4792,#N/A,7108.803781,6596,8394,36215,-740,-1620,-19623,-111,37792,35475,34595,16592,36104
51550,VA,11268,#N/A,5540,8554,4790,3916,4947,#N/A,5718.814215,6596,8790,36288,-316,-1196,-18935,313,39015,35972,35092,17353,36601
51560,VA,6024,#N/A,5540,8554,4790,3916,4185,#N/A,5540,6596,8554,30630,-5093,-5973,-24504,-4464,33009,25537,24657,6126,26166
51570,VA,9960,#N/A,5540,8554,4790,3916,4757,#N/A,5718.814215,6596,8679,34870,-740,-1620,-19623,-111,37517,34130,33250,15247,34759
51580,VA,6024,#N/A,5540,8554,4790,3916,4185,#N/A,5361.388326,6596,8554,30451,-5093,-5973,-24504,-4464,33009,25358,24478,5947,25987
51590,VA,6024,#N/A,5540,8554,4790,3916,4185,#N/A,4964.24845,6596,7414,28915,-5377,-6150,-24813,-4641,33009,23538,22765,4102,24274
51595,VA,6240,#N/A,5540,8554,4790,3916,4217,#N/A,5222.38937,6596,8554,30528,-5093,-5973,-24504,-4464,33257,25435,24555,6024,26064
51600,VA,14868,#N/A,5540,8554,4790,3916,5469,#N/A,7684.656601,6596,9948,43013,579,-301,-17512,1208,43137,43592,42712,25501,44221
51610,VA,14868,#N/A,5540,8554,4790,3916,5469,#N/A,6930.090837,6596,10080,42390,579,-301,-17512,1208,43137,42969,42089,24878,43598
51620,VA,6804,#N/A,5540,8554,4790,3916,4299,#N/A,5639.38624,6596,8554,31509,-4917,-5797,-24196,-4288,33903,26592,25712,7313,27221
51630,VA,14868,#N/A,5540,8554,4790,3916,5469,#N/A,6592.521942,6596,9897,41870,579,-301,-17512,1208,43137,42449,41569,24358,43078
51640,VA,6240,#N/A,5540,8554,4790,3916,4217,#N/A,5500.387283,6596,8554,30806,-5093,-5973,-24504,-4464,33257,25713,24833,6302,26342
51650,VA,11268,#N/A,5540,8554,4790,3916,4947,#N/A,5659.243233,6596,8801,36240,-316,-1196,-18935,313,39015,35924,35044,17305,36553
51660,VA,6816,#N/A,5540,8554,4790,3916,4300,#N/A,5639.38624,6596,8438,31406,-4917,-5797,-24196,-4288,33916,26489,25609,7210,27118
51670,VA,9960,#N/A,5540,8554,4790,3916,4757,#N/A,5718.814215,6596,8684,34875,-740,-1620,-19623,-111,37517,34135,33255,15252,34764
51678,VA,6456,#N/A,5540,8554,4790,3916,4248,#N/A,5718.814215,6596,8554,31241,-4917,-5797,-24196,-4288,33504,26324,25444,7045,26953
51680,VA,6456,#N/A,5540,8554,4790,3916,4248,#N/A,5679.100227,6596,8214,30861,-5093,-5973,-24504,-4464,33504,25768,24888,6357,26397
51683,VA,14868,#N/A,5540,8554,4790,3916,5469,#N/A,5401.102314,6596,9927,40708,579,-301,-17512,1208,43137,41287,40407,23196,41916
51685,VA,14868,#N/A,5540,8554,4790,3916,5469,#N/A,5957.098141,6596,9905,41243,579,-301,-17512,1208,43137,41822,40942,23731,42451
51690,VA,6216,#N/A,5540,8554,4790,3916,4213,#N/A,5301.817345,6596,7251,29281,-5377,-6150,-24813,-4641,33229,23904,23131,4468,24640
51700,VA,11268,#N/A,5540,8554,4790,3916,4947,#N/A,5480.530289,6596,8805,36066,-316,-1196,-18935,313,39015,35750,34870,17131,36379
51710,VA,11268,#N/A,5540,8554,4790,3916,4947,#N/A,5698.957221,6596,8830,36309,-316,-1196,-18935,313,39015,35993,35113,17374,36622
51720,VA,6240,#N/A,5540,8554,4790,3916,4217,#N/A,5520.244277,6596,7303,29575,-5377,-6150,-24813,-4641,33257,24198,23425,4762,24934
51730,VA,9960,#N/A,5540,8554,4790,3916,4757,#N/A,5540.101271,6596,8686,34698,-740,-1620,-19623,-111,37517,33958,33078,15075,34587
51735,VA,11268,#N/A,5540,8554,4790,3916,4947,#N/A,5639.38624,6596,8768,36188,-316,-1196,-18935,313,39015,35872,34992,17253,36501
51740,VA,11268,#N/A,5540,8554,4790,3916,4947,#N/A,5798.24219,6596,8807,36385,-316,-1196,-18935,313,39015,36069,35189,17450,36698
51750,VA,7248,#N/A,5540,8554,4790,3916,4363,#N/A,6056.38311,6596,8077,31894,-4917,-5797,-24196,-4288,34411,26977,26097,7698,27606
51760,VA,9960,#N/A,5540,8554,4790,3916,4757,#N/A,6711.663905,6596,8708,35891,-740,-1620,-19623,-111,37517,35151,34271,16268,35780
51770,VA,6936,#N/A,5540,8554,4790,3916,4318,#N/A,5480.530289,6596,8178,31107,-4917,-5797,-24196,-4288,34054,26190,25310,6911,26819
51775,VA,6936,#N/A,5540,8554,4790,3916,4318,#N/A,5837.956178,6596,8202,31488,-4917,-5797,-24196,-4288,34054,26571,25691,7292,27200
51790,VA,6828,#N/A,5540,8554,4790,3916,4302,#N/A,5917.384153,6596,8190,31447,-4917,-5797,-24196,-4288,33930,26530,25650,7251,27159
51800,VA,11268,#N/A,5540,8554,4790,3916,4947,#N/A,5897.527159,6596,8781,36459,-316,-1196,-18935,313,39015,36143,35263,17524,36772
51810,VA,11268,#N/A,5540,8554,4790,3916,4947,#N/A,6056.38311,6596,8805,36641,-316,-1196,-18935,313,39015,36325,35445,17706,36954
51820,VA,6828,#N/A,5540,8554,4790,3916,4302,#N/A,5857.813171,6596,8187,31385,-4917,-5797,-24196,-4288,33930,26468,25588,7189,27097
51830,VA,11268,#N/A,5540,8554,4790,3916,4947,#N/A,6393.952004,6596,8802,36976,-316,-1196,-18935,313,39015,36660,35780,18041,37289
51840,VA,7452,#N/A,5540,8554,4790,3916,4393,#N/A,5877.670165,6596,8469,32311,-4917,-5797,-24196,-4288,34645,27394,26514,8115,28023
53001,WA,6444,#N/A,6612,7382,4326,3971,3310,#N/A,6683.218941,5570,7503,30171,-1944,-861,-19392,648,32045,28227,29310,10779,30819
53003,WA,6120,#N/A,6612,7382,4326,3971,3273,#N/A,6209.231782,5570,6989,28859,-2121,-1038,-19701,471,31684,26738,27821,9158,29330
53005,WA,7068,#N/A,6612,7382,4326,3971,3382,#N/A,6375.127287,5570,7672,30656,-1944,-861,-19392,648,32741,28712,29795,11264,31304
53007,WA,7176,#N/A,6612,7382,4326,3971,3395,#N/A,7678.591974,5570,7369,31765,-1944,-861,-19392,648,32862,29821,30904,12373,32413
53009,WA,6696,#N/A,6612,7382,4326,3971,3339,#N/A,6825.415088,5570,6733,29795,-2121,-1038,-19701,471,32326,27674,28757,10094,30266
53011,WA,9288,#N/A,6612,7382,4326,3971,3638,#N/A,6659.519583,5570,7418,32906,998,2080,-16187,3589,35217,33904,34986,16719,36495
53013,WA,5652,#N/A,6612,7382,4326,3971,3219,#N/A,6564.722151,5570,7063,28820,-2297,-1214,-20009,295,31162,26523,27606,8811,29115
53015,WA,6660,#N/A,6612,7382,4326,3971,3335,#N/A,6825.415088,5570,7002,30029,-2121,-1038,-19701,471,32286,27908,28991,10328,30500
53017,WA,7176,#N/A,6612,7382,4326,3971,3395,#N/A,6446.225361,5570,7369,30532,-1944,-861,-19392,648,32862,28588,29671,11140,31180
53019,WA,6444,#N/A,6612,7382,4326,3971,3310,#N/A,6778.016372,5570,7382,30145,-2121,-1038,-19701,471,32045,28024,29107,10444,30616
53021,WA,7068,#N/A,6612,7382,4326,3971,3382,#N/A,6541.022793,5570,7662,30812,-1944,-861,-19392,648,32741,28868,29951,11420,31460
53023,WA,6444,#N/A,6612,7382,4326,3971,3310,#N/A,6683.218941,5570,7382,30050,-2121,-1038,-19701,471,32045,27929,29012,10349,30521
53025,WA,5988,#N/A,6612,7382,4326,3971,3258,#N/A,7038.70931,5570,7353,29921,-2121,-1038,-19701,471,31537,27800,28883,10220,30392
53027,WA,6372,#N/A,6612,7382,4326,3971,3302,#N/A,7631.193258,5570,6811,30356,-2121,-1038,-19701,471,31965,28235,29318,10655,30827
53029,WA,8232,#N/A,6612,7382,4326,3971,3516,#N/A,7749.690048,5570,7147,32669,-1768,-685,-19084,824,34039,30901,31984,13585,33493
53031,WA,8028,#N/A,6612,7382,4326,3971,3493,#N/A,8792.461798,5570,7382,33743,-1768,-685,-19084,824,33812,31975,33058,14659,34567
53033,WA,10956,#N/A,6612,7382,4326,3971,3830,#N/A,7631.193258,5570,7873,36001,1351,2433,-15570,3942,37077,37352,38434,20431,39943
53035,WA,8700,#N/A,6612,7382,4326,3971,3570,#N/A,7015.009952,5570,7637,32893,998,2080,-16187,3589,34561,33891,34973,16706,36482
53037,WA,7056,#N/A,6612,7382,4326,3971,3381,#N/A,8271.075923,5570,6941,31809,-1944,-861,-19392,648,32728,29865,30948,12417,32457
53039,WA,6696,#N/A,6612,7382,4326,3971,3339,#N/A,6872.813804,5570,7382,30492,-1944,-861,-19392,648,32326,28548,29631,11100,31140
53041,WA,6600,#N/A,6612,7382,4326,3971,3328,#N/A,7086.108026,5570,6879,30106,-2121,-1038,-19701,471,32219,27985,29068,10405,30577
53043,WA,5760,#N/A,6612,7382,4326,3971,3232,#N/A,6683.218941,5570,7382,29366,-2121,-1038,-19701,471,31283,27245,28328,9665,29837
53045,WA,7308,#N/A,6612,7382,4326,3971,3410,#N/A,7109.807384,5570,6965,30924,-1944,-861,-19392,648,33009,28980,30063,11532,31572
53047,WA,6132,#N/A,6612,7382,4326,3971,3274,#N/A,6564.722151,5570,7382,29620,-2121,-1038,-19701,471,31697,27499,28582,9919,30091
53049,WA,6732,#N/A,6612,7382,4326,3971,3344,#N/A,6849.114446,5570,7382,30504,-1944,-861,-19392,648,32367,28560,29643,11112,31152
53051,WA,5652,#N/A,6612,7382,4326,3971,3219,#N/A,6612.120867,5570,7087,28892,-2297,-1214,-20009,295,31162,26595,27678,8883,29187
53053,WA,9204,#N/A,6612,7382,4326,3971,3628,#N/A,6967.611236,5570,7841,33553,1174,2256,-15879,3765,35123,34727,35809,17674,37318
53055,WA,8028,#N/A,6612,7382,4326,3971,3493,#N/A,6825.415088,5570,7382,31776,-1768,-685,-19084,824,33812,30008,31091,12692,32600
53057,WA,8100,#N/A,6612,7382,4326,3971,3501,#N/A,6778.016372,5570,7299,31718,-1768,-685,-19084,824,33892,29950,31033,12634,32542
53059,WA,9288,#N/A,6612,7382,4326,3971,3638,#N/A,6825.415088,5570,7417,33071,998,2080,-16187,3589,35217,34069,35151,16884,36660
53061,WA,10956,#N/A,6612,7382,4326,3971,3830,#N/A,7133.506742,5570,7842,35473,1351,2433,-15570,3942,37077,36824,37906,19903,39415
53063,WA,6552,#N/A,6612,7382,4326,3971,3323,#N/A,6612.120867,5570,7036,29741,-2121,-1038,-19701,471,32166,27620,28703,10040,30212
53065,WA,5652,#N/A,6612,7382,4326,3971,3219,#N/A,6730.617656,5570,7085,29009,-2297,-1214,-20009,295,31162,26712,27795,9000,29304
53067,WA,9240,#N/A,6612,7382,4326,3971,3632,#N/A,6872.813804,5570,7650,33304,1174,2256,-15879,3765,35163,34478,35560,17425,37069
53069,WA,5652,#N/A,6612,7382,4326,3971,3219,#N/A,6825.415088,5570,7382,29400,-2121,-1038,-19701,471,31162,27279,28362,9699,29871
53071,WA,6324,#N/A,6612,7382,4326,3971,3297,#N/A,7465.297753,5570,7040,30370,-2121,-1038,-19701,471,31912,28249,29332,10669,30841
53073,WA,8076,#N/A,6612,7382,4326,3971,3498,#N/A,6564.722151,5570,7268,31450,-1768,-685,-19084,824,33865,29682,30765,12366,32274
53075,WA,6468,#N/A,6612,7382,4326,3971,3313,#N/A,7820.788122,5570,6520,30350,-2121,-1038,-19701,471,32072,28229,29312,10649,30821
53077,WA,6816,#N/A,6612,7382,4326,3971,3353,#N/A,6588.421509,5570,7383,30328,-1944,-861,-19392,648,32460,28384,29467,10936,30976
54001,WV,5640,#N/A,5540,8554,4303,3916,4338,#N/A,5242.246364,7988,8554,31340,-6226,-2331,-20730,-822,32291,25114,29009,10610,30518
54003,WV,6696,#N/A,5540,8554,4303,3916,4502,#N/A,5301.817345,7988,8503,32405,-2411,1484,-16783,2993,33511,29994,33889,15622,35398
54005,WV,5112,#N/A,5540,8554,4303,3916,4256,#N/A,5262.103357,7988,8049,30327,-6442,-2547,-21078,-1038,31681,23885,27780,9249,29289
54007,WV,5088,#N/A,5540,8554,4303,3916,4253,#N/A,5281.960351,7988,8554,30828,-6226,-2331,-20730,-822,31654,24602,28497,10098,30006
54009,WV,5988,#N/A,5540,8554,4303,3916,4392,#N/A,5480.530289,7988,7883,31256,-6226,-2331,-20730,-822,32693,25030,28925,10526,30434
54011,WV,6276,#N/A,5540,8554,4303,3916,4437,#N/A,5301.817345,7988,7952,31434,-6226,-2331,-20730,-822,33026,25208,29103,10704,30612
54013,WV,5712,#N/A,5540,8554,4303,3916,4350,#N/A,5162.818388,7988,8554,31333,-6226,-2331,-20730,-822,32375,25107,29002,10603,30511
54015,WV,7260,#N/A,5540,8554,4303,3916,4590,#N/A,5301.817345,7988,8068,32534,-2411,1484,-16783,2993,34163,30123,34018,15751,35527
54017,WV,5184,#N/A,5540,8554,4303,3916,4268,#N/A,5103.247407,7988,8082,30273,-6442,-2547,-21078,-1038,31765,23831,27726,9195,29235
54019,WV,5316,#N/A,5540,8554,4303,3916,4288,#N/A,5301.817345,7988,7529,30051,-6442,-2547,-21078,-1038,31917,23609,27504,8973,29013
54021,WV,5544,#N/A,5540,8554,4303,3916,4323,#N/A,5321.674339,7988,8554,31324,-6226,-2331,-20730,-822,32180,25098,28993,10594,30502
54023,WV,6144,#N/A,5540,8554,4303,3916,4417,#N/A,5361.388326,7988,8554,31963,-2411,1484,-16783,2993,32874,29552,33447,15180,34956
54025,WV,6228,#N/A,5540,8554,4303,3916,4430,#N/A,5401.102314,7988,8554,32087,-2411,1484,-16783,2993,32971,29676,33571,15304,35080
54027,WV,7452,#N/A,5540,8554,4303,3916,4620,#N/A,5301.817345,7988,8486,33144,-2195,1700,-16435,3209,34385,30949,34844,16709,36353
54029,WV,5988,#N/A,5540,8554,4303,3916,4392,#N/A,5718.814215,7988,7868,31479,-6226,-2331,-20730,-822,32693,25253,29148,10749,30657
54031,WV,5400,#N/A,5540,8554,4303,3916,4301,#N/A,5500.387283,7988,8554,31358,-6226,-2331,-20730,-822,32014,25132,29027,10628,30536
54033,WV,7008,#N/A,5540,8554,4303,3916,4551,#N/A,5023.819432,7988,8057,31993,-2411,1484,-16783,2993,33872,29582,33477,15210,34986
54035,WV,5088,#N/A,5540,8554,4303,3916,4253,#N/A,5262.103357,7988,8554,30808,-6226,-2331,-20730,-822,31654,24582,28477,10078,29986
54037,WV,7932,#N/A,5540,8554,4303,3916,4694,#N/A,5401.102314,7988,9695,34932,-1757,2138,-15733,3647,34939,33175,37070,19199,38579
54039,WV,7260,#N/A,5540,8554,4303,3916,4590,#N/A,5321.674339,7988,8007,32493,-2411,1484,-16783,2993,34163,30082,33977,15710,35486
54041,WV,5652,#N/A,5540,8554,4303,3916,4340,#N/A,5222.38937,7988,8554,31332,-6226,-2331,-20730,-822,32305,25106,29001,10602,30510
54043,WV,7260,#N/A,5540,8554,4303,3916,4590,#N/A,6175.525072,7988,8003,33342,-2411,1484,-16783,2993,34163,30931,34826,16559,36335
54045,WV,5796,#N/A,5540,8554,4303,3916,4363,#N/A,5182.675382,7988,7309,30191,-6442,-2547,-21078,-1038,32472,23749,27644,9113,29153
54047,WV,5796,#N/A,5540,8554,4303,3916,4363,#N/A,5123.104401,7988,8554,31377,-6226,-2331,-20730,-822,32472,25151,29046,10647,30555
54049,WV,6360,#N/A,5540,8554,4303,3916,4450,#N/A,5818.099184,7988,8162,32245,-6226,-2331,-20730,-822,33123,26019,29914,11515,31423
54051,WV,5916,#N/A,5540,8554,4303,3916,4381,#N/A,5520.244277,7988,7940,31280,-6226,-2331,-20730,-822,32610,25054,28949,10550,30458
54053,WV,5232,#N/A,5540,8554,4303,3916,4275,#N/A,5222.38937,7988,7667,30026,-6442,-2547,-21078,-1038,31820,23584,27479,8948,28988
54055,WV,5376,#N/A,5540,8554,4303,3916,4297,#N/A,5301.817345,7988,7345,29927,-6442,-2547,-21078,-1038,31986,23485,27380,8849,28889
54057,WV,6444,#N/A,5540,8554,4303,3916,4463,#N/A,5341.531333,7988,7578,31268,-6226,-2331,-20730,-822,33220,25042,28937,10538,30446
54059,WV,5772,#N/A,5540,8554,4303,3916,4359,#N/A,5937.241147,7988,8554,32167,-6226,-2331,-20730,-822,32444,25941,29836,11437,31345
54061,WV,7608,#N/A,5540,8554,4303,3916,4644,#N/A,5559.958264,7988,8268,33340,-2195,1700,-16435,3209,34565,31145,35040,16905,36549
54063,WV,5796,#N/A,5540,8554,4303,3916,4363,#N/A,5559.958264,7988,8554,31814,-6226,-2331,-20730,-822,32472,25588,29483,11084,30992
54065,WV,6696,#N/A,5540,8554,4303,3916,4502,#N/A,5480.530289,7988,8554,32635,-2411,1484,-16783,2993,33511,30224,34119,15852,35628
54067,WV,5796,#N/A,5540,8554,4303,3916,4363,#N/A,5281.960351,7988,8554,31536,-6226,-2331,-20730,-822,32472,25310,29205,10806,30714
54069,WV,5916,#N/A,5540,8554,4303,3916,4381,#N/A,5917.384153,7988,7887,31625,-6226,-2331,-20730,-822,32610,25399,29294,10895,30803
54071,WV,5796,#N/A,5540,8554,4303,3916,4363,#N/A,5480.530289,7988,8554,31735,-6226,-2331,-20730,-822,32472,25509,29404,11005,30913
54073,WV,5640,#N/A,5540,8554,4303,3916,4338,#N/A,5083.390413,7988,8554,31181,-6226,-2331,-20730,-822,32291,24955,28850,10451,30359
54075,WV,5088,#N/A,5540,8554,4303,3916,4253,#N/A,5301.817345,7988,8554,30848,-6226,-2331,-20730,-822,31654,24622,28517,10118,30026
54077,WV,7608,#N/A,5540,8554,4303,3916,4644,#N/A,5401.102314,7988,8311,33224,-2195,1700,-16435,3209,34565,31029,34924,16789,36433
54079,WV,7260,#N/A,5540,8554,4303,3916,4590,#N/A,5857.813171,7988,7993,33014,-2411,1484,-16783,2993,34163,30603,34498,16231,36007
54081,WV,6060,#N/A,5540,8554,4303,3916,4404,#N/A,5103.247407,7988,7475,30542,-6442,-2547,-21078,-1038,32777,24100,27995,9464,29504
54083,WV,6120,#N/A,5540,8554,4303,3916,4413,#N/A,5321.674339,7988,7582,30928,-6226,-2331,-20730,-822,32846,24702,28597,10198,30106
54085,WV,5796,#N/A,5540,8554,4303,3916,4363,#N/A,5043.676426,7988,8554,31298,-6226,-2331,-20730,-822,32472,25072,28967,10568,30476
54087,WV,5796,#N/A,5540,8554,4303,3916,4363,#N/A,5301.817345,7988,8554,31556,-6226,-2331,-20730,-822,32472,25330,29225,10826,30734
54089,WV,5568,#N/A,5540,8554,4303,3916,4327,#N/A,5222.38937,7988,8554,31248,-6226,-2331,-20730,-822,32208,25022,28917,10518,30426
54091,WV,5772,#N/A,5540,8554,4303,3916,4359,#N/A,5381.24532,7988,8070,31127,-6226,-2331,-20730,-822,32444,24901,28796,10397,30305
54093,WV,5796,#N/A,5540,8554,4303,3916,4363,#N/A,5420.959308,7988,8554,31675,-6226,-2331,-20730,-822,32472,25449,29344,10945,30853
54095,WV,5664,#N/A,5540,8554,4303,3916,4342,#N/A,5281.960351,7988,8554,31404,-6226,-2331,-20730,-822,32319,25178,29073,10674,30582
54097,WV,5316,#N/A,5540,8554,4303,3916,4288,#N/A,5262.103357,7988,8554,31036,-6226,-2331,-20730,-822,31917,24810,28705,10306,30214
54099,WV,6276,#N/A,5540,8554,4303,3916,4437,#N/A,5103.247407,7988,7994,31278,-6226,-2331,-20730,-822,33026,25052,28947,10548,30456
54101,WV,5760,#N/A,5540,8554,4303,3916,4357,#N/A,5321.674339,7988,8554,31540,-6226,-2331,-20730,-822,32430,25314,29209,10810,30718
54103,WV,5532,#N/A,5540,8554,4303,3916,4322,#N/A,5262.103357,7988,8554,31252,-6226,-2331,-20730,-822,32167,25026,28921,10522,30430
54105,WV,5640,#N/A,5540,8554,4303,3916,4338,#N/A,5063.533419,7988,8032,30639,-6226,-2331,-20730,-822,32291,24413,28308,9909,29817
54107,WV,5640,#N/A,5540,8554,4303,3916,4338,#N/A,4964.24845,7988,8008,30516,-6226,-2331,-20730,-822,32291,24290,28185,9786,29694
54109,WV,5436,#N/A,5540,8554,4303,3916,4307,#N/A,6115.954091,7988,8554,32010,-6226,-2331,-20730,-822,32056,25784,29679,11280,31188
55001,WI,6444,#N/A,5659,8320,4542,3699,4976,#N/A,5253.432948,7860,8320,31576,-2714,-2118,-20517,-609,33640,28862,29458,11059,30967
55003,WI,5952,#N/A,5659,8320,4542,3699,4891,#N/A,5699.670496,7860,8320,31531,-2714,-2118,-20517,-609,33063,28817,29413,11014,30922
55005,WI,6228,#N/A,5659,8320,4542,3699,4939,#N/A,4786.911875,7860,8320,30894,-2714,-2118,-20517,-609,33387,28180,28776,10377,30285
55007,WI,6552,#N/A,5659,8320,4542,3699,4995,#N/A,5699.670496,7860,8320,32131,1107,1703,-16564,3212,33767,33238,33834,15567,35343
55009,WI,6168,#N/A,5659,8320,4542,3699,4928,#N/A,5273.716473,7860,8292,31293,-2714,-2118,-20517,-609,33316,28579,29175,10776,30684
55011,WI,6336,#N/A,5659,8320,4542,3699,4957,#N/A,5395.417622,7860,8320,31610,-2714,-2118,-20517,-609,33513,28896,29492,11093,31001
55013,WI,6192,#N/A,5659,8320,4542,3699,4932,#N/A,5496.835247,7860,8320,31568,-2714,-2118,-20517,-609,33344,28854,29450,11051,30959
55015,WI,6252,#N/A,5659,8320,4542,3699,4943,#N/A,5050.597699,7860,8591,31452,1107,1703,-16564,3212,33415,32559,33155,14888,34664
55017,WI,6936,#N/A,5659,8320,4542,3699,5061,#N/A,4827.478925,7860,8212,31534,1107,1703,-16564,3212,34217,32641,33237,14970,34746
55019,WI,5652,#N/A,5659,8320,4542,3699,4839,#N/A,5577.969346,7860,8320,31109,-2714,-2118,-20517,-609,32711,28395,28991,10592,30500
55021,WI,6456,#N/A,5659,8320,4542,3699,4978,#N/A,5740.237546,7860,8718,32473,1107,1703,-16564,3212,33654,33580,34176,15909,35685
55023,WI,5652,#N/A,5659,8320,4542,3699,4839,#N/A,5091.164749,7860,8320,30622,-2714,-2118,-20517,-609,32711,27908,28504,10105,30013
55025,WI,8904,#N/A,5659,8320,4542,3699,5403,#N/A,5719.954021,7860,8730,34913,1550,2146,-15857,3655,36527,36463,37059,19056,38568
55027,WI,6744,#N/A,5659,8320,4542,3699,5028,#N/A,5172.298848,7860,8295,31770,1107,1703,-16564,3212,33992,32877,33473,15206,34982
55029,WI,6768,#N/A,5659,8320,4542,3699,5032,#N/A,6571.862066,7860,8320,33219,1107,1703,-16564,3212,34020,34326,34922,16655,36431
55031,WI,6324,#N/A,5659,8320,4542,3699,4955,#N/A,5821.371645,7860,7896,31600,-2714,-2118,-20517,-609,33499,28886,29482,11083,30991
55033,WI,5940,#N/A,5659,8320,4542,3699,4889,#N/A,4807.1954,7860,8229,30535,-2714,-2118,-20517,-609,33049,27821,28417,10018,29926
55035,WI,6936,#N/A,5659,8320,4542,3699,5061,#N/A,5070.881224,7860,8204,31770,1107,1703,-16564,3212,34217,32877,33473,15206,34982
55037,WI,5796,#N/A,5659,8320,4542,3699,4864,#N/A,5050.597699,7860,7815,30221,-2935,-2339,-20870,-830,32880,27286,27882,9351,29391
55039,WI,6108,#N/A,5659,8320,4542,3699,4918,#N/A,5314.283523,7860,8280,31262,-2714,-2118,-20517,-609,33246,28548,29144,10745,30653
55041,WI,5652,#N/A,5659,8320,4542,3699,4839,#N/A,5091.164749,7860,8320,30622,-2714,-2118,-20517,-609,32711,27908,28504,10105,30013
55043,WI,5808,#N/A,5659,8320,4542,3699,4866,#N/A,4989.747124,7860,8119,30475,-2714,-2118,-20517,-609,32894,27761,28357,9958,29866
55045,WI,5856,#N/A,5659,8320,4542,3699,4874,#N/A,5030.314174,7860,8722,31168,-2714,-2118,-20517,-609,32950,28454,29050,10651,30559
55047,WI,5928,#N/A,5659,8320,4542,3699,4886,#N/A,5415.701147,7860,8320,31223,-2714,-2118,-20517,-609,33034,28509,29105,10706,30614
55049,WI,6720,#N/A,5659,8320,4542,3699,5024,#N/A,5943.072795,7860,8712,32934,1107,1703,-16564,3212,33964,34041,34637,16370,36146
55051,WI,5652,#N/A,5659,8320,4542,3699,4839,#N/A,5719.954021,7860,8320,31251,-2714,-2118,-20517,-609,32711,28537,29133,10734,30642
55053,WI,6000,#N/A,5659,8320,4542,3699,4899,#N/A,5557.685821,7860,8320,31437,-2714,-2118,-20517,-609,33119,28723,29319,10920,30828
55055,WI,7260,#N/A,5659,8320,4542,3699,5118,#N/A,5273.716473,7860,8396,32489,1107,1703,-16564,3212,34598,33596,34192,15925,35701
55057,WI,5928,#N/A,5659,8320,4542,3699,4886,#N/A,6085.057469,7860,8320,31892,-2714,-2118,-20517,-609,33034,29178,29774,11375,31283
55059,WI,9072,#N/A,5659,8320,4542,3699,5432,#N/A,5395.417622,7860,8888,34914,1771,2367,-15504,3876,36724,36685,37281,19410,38790
55061,WI,6168,#N/A,5659,8320,4542,3699,4928,#N/A,5659.103446,7860,8297,31683,-2714,-2118,-20517,-609,33316,28969,29565,11166,31074
55063,WI,6240,#N/A,5659,8320,4542,3699,4941,#N/A,5111.448274,7860,8287,31198,-2714,-2118,-20517,-609,33401,28484,29080,10681,30589
55065,WI,5856,#N/A,5659,8320,4542,3699,4874,#N/A,5273.716473,7860,8320,31009,-2714,-2118,-20517,-609,32950,28295,28891,10492,30400
55067,WI,5964,#N/A,5659,8320,4542,3699,4893,#N/A,5152.015324,7860,8320,30995,-2714,-2118,-20517,-609,33077,28281,28877,10478,30386
55069,WI,5652,#N/A,5659,8320,4542,3699,4839,#N/A,5577.969346,7860,7952,30741,-2935,-2339,-20870,-830,32711,27806,28402,9871,29911
55071,WI,5736,#N/A,5659,8320,4542,3699,4853,#N/A,5212.865898,7860,8106,30614,-2714,-2118,-20517,-609,32809,27900,28496,10097,30005
55073,WI,5940,#N/A,5659,8320,4542,3699,4889,#N/A,5172.298848,7860,8378,31049,-2714,-2118,-20517,-609,33049,28335,28931,10532,30440
55075,WI,5904,#N/A,5659,8320,4542,3699,4882,#N/A,4827.478925,7860,7573,29864,-2935,-2339,-20870,-830,33006,26929,27525,8994,29034
55077,WI,6108,#N/A,5659,8320,4542,3699,4918,#N/A,5415.701147,7860,8320,31403,-2714,-2118,-20517,-609,33246,28689,29285,10886,30794
55078,WI,5916,#N/A,5659,8320,4542,3699,4884,#N/A,5030.314174,7860,8010,30515,-2714,-2118,-20517,-609,33020,27801,28397,9998,29906
55079,WI,7752,#N/A,5659,8320,4542,3699,5203,#N/A,5273.716473,7860,8258,32842,1328,1924,-16211,3433,35175,34170,34766,16631,36275
55081,WI,6444,#N/A,5659,8320,4542,3699,4976,#N/A,4868.045975,7860,8320,31191,-2714,-2118,-20517,-609,33640,28477,29073,10674,30582
55083,WI,6168,#N/A,5659,8320,4542,3699,4928,#N/A,5435.984672,7860,8297,31460,-2714,-2118,-20517,-609,33316,28746,29342,10943,30851
55085,WI,6804,#N/A,5659,8320,4542,3699,5039,#N/A,5070.881224,7860,8320,31754,1107,1703,-16564,3212,34063,32861,33457,15190,34966
55087,WI,6252,#N/A,5659,8320,4542,3699,4943,#N/A,5435.984672,7860,8601,31848,1107,1703,-16564,3212,33415,32955,33551,15284,35060
55089,WI,7752,#N/A,5659,8320,4542,3699,5203,#N/A,5537.402297,7860,8272,33120,1328,1924,-16211,3433,35175,34448,35044,16909,36553
55091,WI,6444,#N/A,5659,8320,4542,3699,4976,#N/A,5314.283523,7860,8320,31637,-2714,-2118,-20517,-609,33640,28923,29519,11120,31028
55093,WI,9072,#N/A,5659,8320,4542,3699,5432,#N/A,6957.249039,7860,8923,36511,1771,2367,-15504,3876,36724,38282,38878,21007,40387
55095,WI,6720,#N/A,5659,8320,4542,3699,5024,#N/A,5760.52107,7860,8320,32360,1107,1703,-16564,3212,33964,33467,34063,15796,35572
55097,WI,6192,#N/A,5659,8320,4542,3699,4932,#N/A,5415.701147,7860,8191,31358,-2714,-2118,-20517,-609,33344,28644,29240,10841,30749
55099,WI,5652,#N/A,5659,8320,4542,3699,4839,#N/A,5172.298848,7860,8320,30703,-2714,-2118,-20517,-609,32711,27989,28585,10186,30094
55101,WI,6540,#N/A,5659,8320,4542,3699,4993,#N/A,5334.567048,7860,8273,31706,1107,1703,-16564,3212,33753,32813,33409,15142,34918
55103,WI,6288,#N/A,5659,8320,4542,3699,4949,#N/A,5517.118772,7860,8320,31684,-2714,-2118,-20517,-609,33457,28970,29566,11167,31075
55105,WI,7008,#N/A,5659,8320,4542,3699,5074,#N/A,4989.747124,7860,8123,31680,1107,1703,-16564,3212,34302,32787,33383,15116,34892
55107,WI,5652,#N/A,5659,8320,4542,3699,4839,#N/A,5010.030649,7860,8320,30541,-2714,-2118,-20517,-609,32711,27827,28423,10024,29932
55109,WI,9072,#N/A,5659,8320,4542,3699,5432,#N/A,5375.134097,7860,8924,34930,1771,2367,-15504,3876,36724,36701,37297,19426,38806
55111,WI,7056,#N/A,5659,8320,4542,3699,5082,#N/A,5172.298848,7860,8310,32097,1107,1703,-16564,3212,34358,33204,33800,15533,35309
55113,WI,6504,#N/A,5659,8320,4542,3699,4986,#N/A,5273.716473,7860,8320,31657,1107,1703,-16564,3212,33710,32764,33360,15093,34869
55115,WI,5652,#N/A,5659,8320,4542,3699,4839,#N/A,4746.344826,7860,7999,29956,-2935,-2339,-20870,-830,32711,27021,27617,9086,29126
55117,WI,6948,#N/A,5659,8320,4542,3699,5064,#N/A,5577.969346,7860,8278,32363,1107,1703,-16564,3212,34232,33470,34066,15799,35575
55119,WI,5652,#N/A,5659,8320,4542,3699,4839,#N/A,5618.536396,7860,8320,31150,-2714,-2118,-20517,-609,32711,28436,29032,10633,30541
55121,WI,5652,#N/A,5659,8320,4542,3699,4839,#N/A,5699.670496,7860,8320,31231,-2714,-2118,-20517,-609,32711,28517,29113,10714,30622
55123,WI,5652,#N/A,5659,8320,4542,3699,4839,#N/A,5618.536396,7860,8320,31150,-2714,-2118,-20517,-609,32711,28436,29032,10633,30541
55125,WI,6312,#N/A,5659,8320,4542,3699,4953,#N/A,5922.78927,7860,8320,32114,-2714,-2118,-20517,-609,33485,29400,29996,11597,31505
55127,WI,7104,#N/A,5659,8320,4542,3699,5091,#N/A,5577.969346,7860,8360,32601,1107,1703,-16564,3212,34415,33708,34304,16037,35813
55129,WI,6408,#N/A,5659,8320,4542,3699,4970,#N/A,5354.850573,7860,8320,31642,-2714,-2118,-20517,-609,33598,28928,29524,11125,31033
55131,WI,7752,#N/A,5659,8320,4542,3699,5203,#N/A,5476.551722,7860,8272,33060,1328,1924,-16211,3433,35175,34388,34984,16849,36493
55133,WI,7752,#N/A,5659,8320,4542,3699,5203,#N/A,5699.670496,7860,8270,33281,1328,1924,-16211,3433,35175,34609,35205,17070,36714
55135,WI,5844,#N/A,5659,8320,4542,3699,4872,#N/A,4888.3295,7860,8320,30611,-2714,-2118,-20517,-609,32936,27897,28493,10094,30002
55137,WI,5724,#N/A,5659,8320,4542,3699,4851,#N/A,5638.819921,7860,8320,31242,-2714,-2118,-20517,-609,32795,28528,29124,10725,30633
55139,WI,6036,#N/A,5659,8320,4542,3699,4905,#N/A,5659.103446,7860,8114,31369,-2714,-2118,-20517,-609,33161,28655,29251,10852,30760
55141,WI,5904,#N/A,5659,8320,4542,3699,4882,#N/A,5172.298848,7860,7958,30593,-2714,-2118,-20517,-609,33006,27879,28475,10076,29984
56001,WY,6936,#N/A,6612,7382,4432,3971,3379,#N/A,7868.186838,9794,6999,35568,-8476,-780,-18783,729,32712,27092,34788,16785,36297
56003,WY,5652,#N/A,6612,7382,4432,3971,3231,#N/A,6659.519583,9794,7382,33459,-8653,-957,-19092,552,31280,24806,32502,14367,34011
56005,WY,8520,#N/A,6612,7382,4432,3971,3562,#N/A,7157.206099,9794,8401,37843,-7947,-251,-17858,1258,34479,29896,37592,19985,39101
56007,WY,6048,#N/A,6612,7382,4432,3971,3277,#N/A,7441.598395,9794,7382,34637,-8653,-957,-19092,552,31722,25984,33680,15545,35189
56009,WY,5664,#N/A,6612,7382,4432,3971,3233,#N/A,6943.911878,9794,7382,33755,-8653,-957,-19092,552,31294,25102,32798,14663,34307
56011,WY,6444,#N/A,6612,7382,4432,3971,3322,#N/A,7157.206099,9794,7382,34748,-8476,-780,-18783,729,32163,26272,33968,15965,35477
56013,WY,6408,#N/A,6612,7382,4432,3971,3318,#N/A,7346.800963,9794,7283,34803,-8476,-780,-18783,729,32123,26327,34023,16020,35532
56015,WY,5676,#N/A,6612,7382,4432,3971,3234,#N/A,6730.617656,9794,7382,33554,-8653,-957,-19092,552,31307,24901,32597,14462,34106
56017,WY,6444,#N/A,6612,7382,4432,3971,3322,#N/A,7252.003531,9794,7382,34843,-8476,-780,-18783,729,32163,26367,34063,16060,35572
56019,WY,6252,#N/A,6612,7382,4432,3971,3300,#N/A,7086.108026,9794,7382,34485,-8476,-780,-18783,729,31949,26009,33705,15702,35214
56021,WY,6996,#N/A,6612,7382,4432,3971,3386,#N/A,6683.218941,9794,7460,34905,-8476,-780,-18783,729,32779,26429,34125,16122,35634
56023,WY,7548,#N/A,6612,7382,4432,3971,3450,#N/A,6304.029213,9794,7382,34999,-8300,-604,-18475,905,33395,26699,34395,16524,35904
56025,WY,6912,#N/A,6612,7382,4432,3971,3376,#N/A,6872.813804,9794,7491,35040,-8476,-780,-18783,729,32685,26564,34260,16257,35769
56027,WY,6456,#N/A,6612,7382,4432,3971,3324,#N/A,6896.513162,9794,7382,34500,-8476,-780,-18783,729,32177,26024,33720,15717,35229
56029,WY,6288,#N/A,6612,7382,4432,3971,3305,#N/A,7133.506742,9794,7382,34569,-8476,-780,-18783,729,31990,26093,33789,15786,35298
56031,WY,6444,#N/A,6612,7382,4432,3971,3322,#N/A,6967.611236,9794,7382,34559,-8476,-780,-18783,729,32163,26083,33779,15776,35288
56033,WY,7752,#N/A,6612,7382,4432,3971,3473,#N/A,7488.997111,9794,7133,36139,-8300,-604,-18475,905,33622,27839,35535,17664,37044
56035,WY,9732,#N/A,6612,7382,4432,3971,3701,#N/A,7631.193258,9794,7382,38510,-7947,-251,-17858,1258,35830,30563,38259,20652,39768
56037,WY,8064,#N/A,6612,7382,4432,3971,3509,#N/A,7228.304173,9794,8095,37153,-8123,-427,-18166,1082,33970,29030,36726,18987,38235
56039,WY,9864,#N/A,6612,7382,4432,3971,3716,#N/A,9384.945746,9794,8200,41214,-7770,-74,-17549,1435,35977,33444,41140,23665,42649
56041,WY,5868,#N/A,6612,7382,4432,3971,3256,#N/A,6754.317014,9794,7730,34117,-8653,-957,-19092,552,31521,25464,33160,15025,34669
56043,WY,6444,#N/A,6612,7382,4432,3971,3322,#N/A,7086.108026,9794,7382,34677,-8476,-780,-18783,729,32163,26201,33897,15894,35406
56045,WY,5940,#N/A,6612,7382,4432,3971,3264,#N/A,6920.21252,9794,7382,34007,-8653,-957,-19092,552,31601,25354,33050,14915,34559
